sku,mfgn,qty,qtynj,qtyfl,price,map,mrp
10020,2228,64,39,25,4.70,,
10021,6001,9,5,4,74.81,,
10024,6003,0,0,0,74.81,,
10025,1928.3,4,4,0,137.93,,
10026,6002,2,0,2,41.15,,
10027,1927.3,4,2,2,312.64,,
10030,9283.3,2,2,0,358.40,,
10341,X-10-M,1,0,1,36.62,,
10342,SS-1002,5,0,5,243.92,,
10345,SS-2000,4,1,3,420.73,,
10348,FN-201,2,0,2,355.06,,
10349,BN-202,6,3,3,410.45,,
10350,SP-5-B,0,0,0,866.62,,
10351,F-50,5,4,1,72.69,,
10352,SS-5000,1,0,1,763.25,,
10353,F-50W,7,5,2,72.69,,
10354,B-51,11,6,5,71.48,,
10355,S-53,31,13,18,71.48,,
10357,V-57W.2,0,0,0,74.51,,
10360,HF-742,5,2,3,215.41,,
10361,HF-743,13,10,3,215.41,,
10366,B-80,1,0,1,154.19,,
10367,B-81,3,1,2,154.19,,
10368,F-82,6,2,4,147.53,,
10369,F-83,42,18,24,147.53,,
10373,RU-90,15,7,8,132.07,,
10374,DNB-200,1,1,0,514.45,,
10377,DNP-200,0,0,0,514.45,,
10378,YB-500,0,0,0,1158.00,,
10391,220SW,12,5,7,33.33,,
10394,MMB-84,49,24,25,12.00,,
10442,SP-80-3,0,0,0,2484.30,,
10446,SRA-1,1,1,0,449.99,,
10472,SP-70-3,0,0,0,2484.30,,
10532,X-11Y,7,3,4,44.79,,
10533,FNW-201,2,0,2,355.06,,
10534,HF-742W,2,0,2,215.41,,
10535,HF-743W,5,2,3,215.41,,
10536,F-82W,4,4,0,147.53,,
10537,F-83W,7,3,4,147.53,,
10539,RA-91,5,3,2,71.48,,
10540,RA-93,10,3,7,71.48,,
10541,BN-C,11,6,5,28.50,,
10545,LL-C,0,0,0,34.29,,
10548,N-203-C,1,0,1,26.40,,
10549,NC-20,0,0,0,34.29,,
10550,GM-5-C,8,5,3,54.96,,
10552,010-10117-02,0,0,0,11.69,,
10562,010-10082-00,0,0,0,19.57,,
10563,010-10085-00,0,0,0,12.81,,
10578,010-10083-00,4,3,1,16.31,,
10595,390,0,0,0,216.63,,
10596,393,3,1,2,322.37,,
10597,396-1,8,3,5,137.26,,
10599,399-1M,3,0,3,239.94,,
10601,4018,0,0,0,389.59,,
10602,4018-M,3,3,0,397.93,,
10609,4351,4,4,0,72.07,,
10612,476,0,0,0,850.05,,
10618,5018,9,2,7,506.81,,
10627,5206-N,95,47,48,62.64,,
10631,5215,10,5,5,55.85,,
10632,5215-C-X,15,10,5,116.97,,
10636,5225-XT,172,78,94,159.36,,
10637,5226-XT,27,16,11,159.36,,
10640,5230,6,3,3,412.63,,
10648,5911,0,0,0,54.19,,
10658,408-R,7,2,5,15.79,,
10660,410-R,11,8,3,71.78,,
10661,4186-BP,15,15,0,10.65,,
10662,4186-U,0,0,0,9.99,,
10663,4187,37,6,31,38.67,,
10668,4352,0,0,0,33.08,,
10673,4365,25,22,3,19.22,,
10676,495-B,2,2,0,23.99,,
10679,5228,2,0,2,174.36,,
10680,5228-4,9,1,8,125.25,,
10682,81-S,0,0,0,53.99,,
10840,2100,5,5,0,46.75,,
10841,2101,0,0,0,40.28,,
10842,2300A,10,7,3,108.17,,
10844,2303A,0,0,0,147.13,,
10850,84-2056-01,16,8,8,123.27,,
11123,740011-1,2,2,0,24.14,,
11161,730000-1,0,0,0,62.09,,
11188,SPC-15RP,13,7,6,22.86,,
11196,SPC-40RP,10,7,3,30.00,,
11197,SPC-5P,8,8,0,13.73,,
11224,MA4056W,7,3,4,56.41,,
11234,MA905W,3,0,3,124.65,,
11235,MB21W,58,18,40,17.59,,
11236,MB21B,65,40,25,17.59,,
11237,MB41W,28,17,11,24.65,,
11238,MB41B,49,24,25,24.65,,
11241,WC-3,10,10,0,21.19,,
11273,250/120ST,0,0,0,105.00,,
11280,250/50/200ST,1,1,0,105.00,,
11301,1700/50/200T,1,0,1,119.00,,
11793,525TID-TMD,0,0,0,688.89,,
11794,235DT-PSE,0,0,0,500.00,,
11799,001-410-540,0,0,0,295.45,,
11800,PG500R,0,0,0,805.95,,
11804,520-IHD,0,0,0,181.82,,
11805,AIR-033-270,0,0,0,72.73,,
11806,AIR-033-352,0,0,0,68.18,,
11814,AIR-033-391,0,0,0,227.27,,
11817,525T-BSD,1,1,0,204.44,,
12150,SS-1002W,4,0,4,243.92,,
12151,SS-2000W,1,0,1,303.77,,
12152,SS-5000W,0,0,0,763.25,,
12167,5241-R,0,0,0,82.24,,
12283,MA9060B,0,0,0,171.71,,
12284,MA840W,4,0,4,49.35,,
12285,MA7060,19,19,0,47.95,,
12743,M81120,5,2,3,790.75,,
12744,M81121,1,0,1,974.17,,
12745,M81105,22,8,14,245.82,,
13034,010-10121-00,0,0,0,17.50,,
13045,X-10-A,13,9,4,36.62,,
13048,5228-1,5,5,0,60.48,,
13049,5228-2,5,5,0,64.63,,
13109,000-159-702,0,0,0,40.91,,
13110,AIR-033-428,0,0,0,45.45,,
13112,525ST-PWC,0,0,0,173.33,,
13113,526ST-MSC,0,0,0,355.56,,
13153,008-526-360,0,0,0,72.73,,
13168,E26031,0,0,0,99.99,,
13169,M78713-PZ,0,0,0,104.16,,
13172,P19007,2,2,0,51.60,,
13173,P19001,1,0,1,51.60,,
13174,P19006,5,4,1,51.60,,
13176,5309-R,0,0,0,605.28,,
13253,AIR-033-226,0,0,0,68.18,,
13254,AIR-033-476,0,0,0,68.18,,
13255,AIR-033-073,0,0,0,68.18,,
13256,525STID-MSD,0,0,0,400.00,,
13267,5101,66,54,12,70.49,,
13292,525STID-PWD,1,0,1,173.33,,
13293,520-5PSD,0,0,0,168.89,,
13294,ST-02MSB,0,0,0,190.91,,
13295,ST-02PSB,0,0,0,118.18,,
13298,CA50/200-12M,0,0,0,871.11,,
13300,525T-BSC,0,0,0,204.44,,
13350,520-BLD,1,0,1,186.67,,
13362,000-041-405,0,0,0,76.36,,
13366,525T-PWD,3,1,2,106.67,,
13372,806-1000,1,1,0,730.50,,
13374,806-1800,1,0,1,1416.95,,
13390,CA28F-8,0,0,0,986.67,,
13473,010-10193-02,0,0,0,474.74,,
13474,010-10192-01,0,0,0,167.33,,
13478,526ST-MSC7,0,0,0,440.00,,
13479,YB-600,0,0,0,1384.01,,
13481,ST-01PTB,0,0,0,81.82,,
13483,AIR-033-203,0,0,0,77.27,,
13484,706/50/200T,0,0,0,560.00,,
13498,E26019-PZ,0,0,0,229.16,,
13500,A12005,25,8,17,497.36,,
13501,A12004,8,4,4,414.46,,
13542,LH3010,0,0,0,54.55,,
13544,CA50/200-1T,0,0,0,871.11,,
13560,000-158-002,0,0,0,31.82,,
13561,CA50B-9B,0,0,0,400.00,,
13593,010-10272-00,10,4,6,57.91,,
13598,AIR-033-204,0,0,0,63.64,,
13628,9004E,0,0,0,46.42,,
13629,2001,0,0,0,9.97,,
13630,GPA017,2,1,1,113.64,,
13643,000-159-695,0,0,0,90.00,,
13646,9282.3,4,2,2,149.36,,
13648,300/50/200T,1,0,1,109.99,,
13666,520-PLD,0,0,0,88.89,,
13667,000-135-397,4,2,2,45.45,,
13724,4187HD,19,19,0,44.63,,
13725,4353,2,2,0,38.45,,
13726,5120,13,13,0,82.80,,
13748,808-1800,6,3,3,52.16,,
13759,4357-S,1,0,1,63.94,,
13767,AIR-033-407,0,0,0,81.82,,
13770,AIR-033-333,0,0,0,50.00,,
13775,000-154-036,0,0,0,90.91,,
13776,FAX5,0,0,0,572.73,,
13792,SP-5-C,0,0,0,866.62,,
13815,MA5950,6,3,3,119.71,,
13827,525-5PWD,0,0,0,106.67,,
13828,000-154-053,0,0,0,111.36,,
13834,CA50B-6B,0,0,0,248.89,,
13846,CA200B-5S,0,0,0,266.67,,
13852,AIR-033-351,0,0,0,31.82,,
13856,P102938,3,1,2,53.36,,
13861,CA50B-6G,0,0,0,391.11,,
13876,4125,3,3,0,12.59,,
13877,7234,0,0,0,28.08,,
13878,7208,8,8,0,12.16,,
13879,9353,4,0,4,28.96,,
13880,8013,4,2,2,29.85,,
13881,1002,11,7,4,13.80,,
13882,8031,3,3,0,7.05,,
13902,E66008,0,0,0,174.98,,
13934,8067,7,6,1,29.53,,
13935,8030,0,0,0,7.05,,
13936,8039,12,7,5,29.53,,
13937,8065,11,6,5,15.33,,
13938,2304,0,0,0,9.65,,
13940,2305,0,0,0,10.71,,
13941,2701,1,1,0,12.70,,
13942,2709,7,2,5,10.03,,
13943,2710,9,4,5,11.48,,
13944,2301,35,19,16,12.87,,
13945,2303,28,3,25,16.75,,
13947,2302,0,0,0,20.01,,
13948,2105,18,3,15,42.05,,
13950,2003,16,16,0,9.97,,
13951,2002,10,0,10,9.97,,
13952,2103,7,3,4,18.92,,
13953,2104,41,14,27,82.66,,
13954,2708,5,5,0,17.66,,
13955,2506,52,6,46,6.24,,
13956,2508,4,0,4,7.29,,
13957,2510,20,15,5,8.27,,
13958,2512,30,11,19,9.49,,
13959,9217,19,18,1,2.99,,
13960,1001,10,5,5,13.32,,
13961,1003,22,3,19,15.25,,
13967,5018,7,3,4,26.54,,
13969,5005,1,1,0,19.43,,
13971,8068,3,1,2,482.22,,
13972,8082,4,3,1,379.47,,
13974,8080,1,1,0,178.20,,
13975,8079,4,2,2,86.92,,
13976,8051,0,0,0,205.96,,
13979,8061,4,2,2,173.68,,
13980,8081,3,1,2,306.27,,
13981,8015,2,0,2,87.57,,
13984,B-51W,2,1,1,71.48,,
13993,FN-203,2,1,1,371.76,,
13994,FNW-203,2,0,2,371.76,,
14021,520-5MSD,0,0,0,293.33,,
14037,5400-XT,0,0,0,151.76,,
14038,5401-XT,9,0,9,151.76,,
14042,5420-XT,4,1,3,120.24,,
14043,5421-XT,2,0,2,120.24,,
14065,010-10314-00,0,0,0,7.42,,
14066,010-10267-00,0,0,0,7.90,,
14067,D284,0,0,0,42.60,,
14068,D285,0,0,0,51.13,,
14069,D286,0,0,0,51.13,,
14070,D287,0,0,0,59.65,,
14071,D288,0,0,0,89.48,,
14073,D244,0,0,0,38.34,,
14085,M78717,0,0,0,183.32,,
14086,M78716,0,0,0,195.82,,
14100,528-VW,89,44,45,181.79,,
14106,531-AW,0,0,0,201.32,,
14125,2702,5,0,5,16.47,,
14165,7202,13,3,10,12.16,,
14166,7206,15,15,0,12.16,,
14177,5133,4,4,0,18.99,,
14235,SK135,0,0,0,181.81,,
14258,82-0123-01,8,4,4,123.13,,
14259,2404,13,7,6,3.35,,
14260,2406,10,10,0,4.59,,
14365,"307/50/200T 8P",1,1,0,164.99,,
14489,ARP11,0,0,0,590.91,,
14491,000-154-049,0,0,0,127.27,,
14494,000-154-052,0,0,0,281.82,,
14495,235DST-PWE,0,0,0,481.82,,
14497,010-10231-01,11,7,4,17.60,,
14521,000-144-463,0,0,0,59.09,,
14525,4700,7,6,1,20.48,,
14526,4700-1,1,0,1,33.30,,
14527,4700-2,7,4,3,45.49,,
14533,4190,6,6,0,35.69,,
14538,4710,6,0,6,15.01,,
14541,4720,0,0,0,19.73,,
14561,2011,2,2,0,6.65,,
14562,2101,12,7,5,18.92,,
14563,2102,10,6,4,18.92,,
14566,4100,62,2,60,2.65,,
14567,4126,0,0,0,13.57,,
14569,5015,0,0,0,31.25,,
14572,8086,4,2,2,1344.14,,
14573,8084,4,1,3,763.27,,
14574,8076,2,2,0,481.43,,
14575,8074,2,0,2,398.56,,
14576,8097,6,3,3,216.35,,
14577,8096,5,3,2,225.73,,
14578,8261,4,3,1,159.19,,
14579,8262,3,2,1,94.91,,
14580,9001E,8,3,5,35.23,,
14581,8184,0,0,0,763.38,,
14582,2402,21,3,18,2.73,,
14583,2408,10,5,5,5.32,,
14584,2410,6,5,1,7.20,,
14585,2502,19,19,0,3.61,,
14586,2504,4,0,4,4.49,,
14587,2602,0,0,0,6.18,,
14588,2604,5,4,1,8.81,,
14589,2608,7,7,0,16.67,,
14590,2610,15,5,10,19.20,,
14592,9216,21,17,4,2.99,,
14594,9218,27,18,9,2.99,,
14597,7218,8,0,8,12.16,,
14599,7226,6,2,4,12.16,,
14600,7230,5,0,5,12.16,,
14601,7233,9,3,6,28.08,,
14602,7235,13,7,6,28.08,,
14603,7260,3,0,3,28.08,,
14604,7238,15,7,8,28.08,,
14605,7240,8,1,7,28.08,,
14606,7242,8,5,3,28.08,,
14607,010-10300-00,0,0,0,24.49,,
14672,V-57.2,7,4,3,74.51,,
14673,K-TD.2,3,2,1,33.95,,
14768,8033,19,0,19,2.25,,
14769,8022,6,3,3,59.71,,
14771,8232,3,2,1,10.24,,
14847,8263,2,1,1,33.84,,
14860,010-10327-00,0,0,0,140.34,,
14882,AG226,0,0,0,349.08,,
14883,AG126,0,0,0,359.99,,
14884,TP125,0,0,0,145.44,,
14907,5235-XT,8,3,5,144.19,,
14908,4006,9,9,0,22.31,,
14909,414,0,0,0,7.84,,
14911,4188-SL,14,4,10,55.45,,
14934,SU-1,4,2,2,35.29,,
14941,ANCHORMAX,1,0,1,686.65,,
14960,CMP460,158,83,75,44.04,,
14968,22040A,15,7,8,464.22,,
15022,NET-DWN-CBL,0,0,0,54.55,,
15023,010-10305-01,0,0,0,12.59,,
15028,D031,3,1,2,76.69,,
15111,235DHT-MSE,0,0,0,627.27,,
15112,235DHT-LMSE,0,0,0,736.36,,
15125,000-159-686,4,2,2,45.45,,
15126,000-030-097,0,0,0,77.27,,
15198,FPHRC1002000C00,32,9,23,111.08,,
15204,FP900UB00000A00,9,0,9,21.79,,
15231,E66023,0,0,0,74.99,,
15232,M81131,1,0,1,2083.32,,
15243,"TRAWLPLOT 12",0,0,0,1959.30,,
15266,E66054,0,0,0,170.44,,
15273,4079,14,5,9,11.19,,
15274,4184,42,42,0,6.96,,
15278,4078-50,0,0,0,49.06,,
15307,PL-258-G,9,9,0,11.12,,
15309,PL-259-58-G,17,4,13,9.64,,
15310,PL-259-CP-G,21,0,21,10.84,,
15311,PL-259-G,30,12,18,9.64,,
15316,6152C,12,8,4,589.99,,
15317,PL-258-CP-G,4,4,0,15.97,,
15368,710161-1,2,2,0,75.89,,
15371,E66014,1,0,1,229.16,,
15374,PL-259-8X-G,17,17,0,9.64,,
15404,E22078,39,17,22,408.96,,
15433,E25024,0,0,0,46.86,,
15499,700030-1,6,6,0,25.51,,
15502,E26030,0,0,0,99.99,,
15512,SRC-35,1,1,0,40.71,,
15513,SRC-50,2,2,0,55.24,,
15514,SRC-90,1,0,1,75.42,,
15554,MR50W,12,8,4,24.71,,
15555,MR60W,20,11,9,30.56,,
15556,MR690,16,12,4,56.44,,
15599,802-1500,4,2,2,520.43,,
15665,6510USB,6,4,2,187.50,,
15685,010-10454-00,0,0,0,9.89,,
15701,2110A,5,2,3,28.60,,
15706,2111A,11,4,7,23.98,,
15797,250C/50/200ST,0,0,0,154.00,,
15841,E12093,12,1,11,615.48,,
15853,710166-1,2,2,0,325.78,,
15856,M81130,1,1,0,1795.82,,
15871,GP1060,0,0,0,349.08,,
15965,M81132,0,0,0,2149.99,,
16015,GP1061,0,0,0,363.62,,
16019,010-00351-00,22,3,19,202.49,,
16024,CT-100,11,2,9,19.06,,
16081,8197,0,0,0,216.35,,
16082,8072,0,0,0,15.52,,
16087,8066,22,0,22,2.25,,
16088,9003E,19,0,19,32.94,,
16105,S-53G,9,9,0,71.48,,
16123,MA840B,24,20,4,26.99,,
16136,PP5050,0,0,0,356.35,,
16137,PP5051,0,0,0,370.90,,
16152,240SW,18,10,8,39.13,,
16154,PP5061,0,0,0,399.99,,
16208,N108000,0,0,0,443.18,,
16209,N128000,2,2,0,399.99,,
16210,FP900DB00000A00,11,11,0,21.79,,
16211,DA645G,4,3,1,20.44,,
16213,N129000,0,0,0,451.70,,
16214,N189000,0,0,0,517.05,,
16215,N121100,0,0,0,491.48,,
16216,N141100,0,0,0,502.84,,
16218,N188000,0,0,0,508.52,,
16219,12700UNIV,3,3,0,289.77,,
16220,12641-12,0,0,0,78.75,,
16221,12701-12,1,1,0,78.75,,
16222,12612,1,1,0,15.75,,
16223,12728,195,155,40,4.50,,
16224,12727,4,4,0,105.00,,
16227,2900BWL,1,1,0,279.99,,
16228,2900WBL,0,0,0,303.75,,
16251,GP1040,0,0,0,319.99,,
16253,GP1050,0,0,0,312.72,,
16254,GP1051,0,0,0,327.26,,
16260,GP1170,0,0,0,370.90,,
16267,GP2050,0,0,0,312.72,,
16268,GP2051,0,0,0,327.26,,
16269,GP2060,0,0,0,349.08,,
16270,GP2061,0,0,0,363.62,,
16276,GP2170,0,0,0,370.90,,
16286,396-1-AIS,0,0,0,149.63,,
16386,9093,5,2,3,399.99,,
16387,8369,0,0,0,427.51,,
16435,010-10380-00,12,4,8,7.14,,
16507,5025,114,72,42,32.73,,
16508,5026,35,35,0,42.32,,
16509,2723,15,10,5,24.85,,
16523,809-0915,7,3,4,149.45,,
16532,E55060,0,0,0,34.08,,
16535,E55051,0,0,0,154.16,,
16536,E55052,0,0,0,238.63,,
16537,E55053,0,0,0,51.13,,
16577,E15023,2,1,1,585.15,,
16578,E15024,1,0,1,414.46,,
16600,P77746,3,1,2,877.81,1067.00,
16601,P77741,4,3,1,746.15,1027.00,
16602,P77736,2,0,2,703.71,934.00,
16604,P77727,0,0,0,637.86,787.00,
16607,P77712,1,1,0,477.35,610.00,
16608,P77912,0,0,0,522.98,653.00,
16609,P77915,4,2,2,761.37,950.00,
16610,P77726,1,0,1,629.09,,
16710,MR50B,0,0,0,24.71,,
16755,P77099,3,0,3,760.78,,
16790,010-10552-00,3,3,0,45.49,,
16791,010-10551-00,96,30,66,34.99,,
16850,129E,0,0,0,525.72,,
16851,189E,0,0,0,565.50,,
16852,249E,0,0,0,585.78,,
16853,309E,0,0,0,611.06,,
16854,369E,0,0,0,629.89,,
16855,429E,0,0,0,661.67,,
16856,549E,0,0,0,805.78,,
16857,1212E,0,0,0,566.22,,
16858,1812E,0,0,0,585.78,,
16859,2412E,0,0,0,605.28,,
16860,3012E,0,0,0,629.89,,
16861,3612E,0,0,0,661.67,,
16862,4212E,0,0,0,703.61,,
16863,4812E,0,0,0,840.28,,
16864,5412E,0,0,0,978.61,,
16865,489E,0,0,0,703.61,,
16866,6012E,0,0,0,1065.87,,
16867,6612E,0,0,0,1121.94,,
16868,7212E,0,0,0,1211.44,,
16869,129,0,0,0,459.22,,
16870,189,0,0,0,499.00,,
16871,249,0,0,0,519.22,,
16872,309,0,0,0,544.56,,
16873,369,0,0,0,563.33,,
16875,429,0,0,0,595.17,,
16876,549,0,0,0,733.22,,
16877,1212,0,0,0,499.72,,
16878,1812,0,0,0,519.22,,
16879,2412,0,0,0,538.72,,
16880,3012,0,0,0,563.33,,
16881,3612,0,0,0,595.17,,
16882,4212,0,0,0,637.11,,
16883,4812,0,0,0,773.78,,
16884,5412,0,0,0,744.80,,
16885,489,0,0,0,695.33,,
16887,6012,0,0,0,911.17,,
16888,6612,0,0,0,1071.78,,
16889,7212,0,0,0,1138.89,,
16890,M80,0,0,0,505.50,,
16891,M120,0,0,0,541.67,,
16892,ST9,0,0,0,613.94,,
16893,ST12,3,1,2,743.62,,
16894,ST16,1,0,1,806.64,,
16897,ES2000,23,11,12,66.56,,
16898,ES2000A,4,2,2,88.94,,
16913,A1101A,77,43,34,71.61,,
16915,A1103,3,1,2,13.78,,
16920,A1113,9,5,4,5.78,,
16921,A1114,12,6,6,6.56,,
16922,A1115,17,14,3,2.10,,
16923,A1200S,12,4,8,71.61,,
16925,AR512,1,1,0,57.89,,
16928,V351HPU1,528,311,217,224.95,,
16929,V351HPU2,4,2,2,277.00,,
16930,VP1135R,18,10,8,41.22,,
16931,VP1135G,27,18,9,41.22,,
16932,T1125-20,5,2,3,27.50,,
16957,P55950,2,2,0,530.60,625.00,
16958,P55750,8,6,2,482.45,540.00,
16968,"578-SW ",5,4,1,237.68,,
17029,DNW-200,0,0,0,514.45,,
17037,E26001-PZ,3,1,2,183.32,,
17039,E66066,0,0,0,83.32,,
17061,526TID-HDD,1,1,0,1244.44,,
17064,010-10603-00,83,47,36,10.48,,
17067,FMB321,36,25,11,9.38,,
17088,CA200B-12H,0,0,0,1511.11,,
17153,010-10570-00,0,0,0,21.99,,
17154,010-10571-00,10,10,0,13.74,,
17180,000-152-867,0,0,0,272.73,,
17185,PSU008,0,0,0,1177.27,,
19000,5001,16,1,15,17.62,,
19005,5138,15,6,9,4.19,,
19006,7198,21,10,11,4.24,,
19007,5139,7,3,4,4.19,,
19008,5140,1,0,1,4.19,,
19009,5141,6,6,0,4.19,,
19010,5142,9,5,4,4.32,,
19011,5143,11,6,5,4.32,,
19012,5101,8,2,6,7.27,,
19013,5102,5,5,0,7.27,,
19014,5103,8,0,8,7.27,,
19015,5104,5,3,2,7.27,,
19016,5105,0,0,0,7.27,,
19018,5107,22,9,13,7.27,,
19019,5112,4,2,2,33.15,,
19020,5113,9,5,4,33.15,,
19021,5114,10,4,6,33.15,,
19022,5115,0,0,0,33.15,,
19023,5116,14,0,14,33.15,,
19024,5117,7,2,5,33.15,,
19025,5118,19,0,19,33.15,,
19026,5119,25,1,24,33.15,,
19027,5120,40,38,2,33.15,,
19028,5121,19,5,14,33.15,,
19041,8023,5,3,2,191.18,,
19042,8025,5,3,2,127.97,,
19045,8054,0,0,0,77.82,,
19046,8053,3,1,2,125.89,,
19047,8058,5,3,2,131.73,,
19048,8059,3,0,3,188.59,,
19049,8027,3,1,2,197.04,,
19050,8043,4,2,2,234.90,,
19051,8032,7,3,4,170.99,,
19052,8029,5,2,3,105.84,,
19053,8077,4,0,4,86.92,,
19057,9002E,4,0,4,38.93,,
19059,7210,38,17,21,12.16,,
19060,7214,13,0,13,12.16,,
19061,7222,3,3,0,12.16,,
20208,2010,11,6,5,6.65,,
20209,2107,1,0,1,124.01,,
20210,2201,0,0,0,16.99,,
20211,2202,0,0,0,16.99,,
20212,2203,21,8,13,18.72,,
20213,2204,24,8,16,18.72,,
20218,2300,0,0,0,14.94,,
20219,2306,20,11,9,4.99,,
20220,2606,9,5,4,14.39,,
20222,2715,4,0,4,2.97,,
20224,2722,20,19,1,22.00,,
20231,3000,8,3,5,66.68,,
20232,3001,6,2,4,76.09,,
20233,3002,12,6,6,69.43,,
20234,3003,9,5,4,79.03,,
20377,4001,89,84,5,4.04,,
20378,4005,13,7,6,3.48,,
20379,4006,6,1,5,3.11,,
20380,4008,15,9,6,1.86,,
20381,4009,0,0,0,1.86,,
20382,4010,0,0,0,1.95,,
20383,4011,5,2,3,1.95,,
20384,4012,0,0,0,2.32,,
20385,4013,16,3,13,2.32,,
20386,4014,2,0,2,2.49,,
20387,4015,21,1,20,2.49,,
20388,4016,15,8,7,3.11,,
20389,4017,7,5,2,3.11,,
20390,4026,13,8,5,18.15,,
20391,4027,7,2,5,22.51,,
20392,4028,3,3,0,59.34,,
20393,4029,0,0,0,95.80,,
20396,4111,4,4,0,3.66,,
20397,4130,2,0,2,24.51,,
20398,4131,0,0,0,24.51,,
20399,4135,27,17,10,2.95,,
20400,4136,10,3,7,2.95,,
20401,4137,57,1,56,2.95,,
20402,4138,46,20,26,3.09,,
20404,4150,37,17,20,4.71,,
20405,4151,13,5,8,4.71,,
20406,4152,32,8,24,4.71,,
20407,4153,1,1,0,4.71,,
20408,4154,0,0,0,4.71,,
20409,4155,23,2,21,11.61,,
20410,4215,8,1,7,11.62,,
20411,4216,14,6,8,12.85,,
20412,4217,32,5,27,16.82,,
20413,4218,9,4,5,11.62,,
20414,4302,2,2,0,42.42,,
20415,4304,4,2,2,67.97,,
20416,4306,1,0,1,95.65,,
20417,4308,7,2,5,134.44,,
20422,4374,5,2,3,83.46,,
20423,4376,3,1,2,103.49,,
20428,5021,32,32,0,2.77,,
20429,5028,17,7,10,28.63,,
20430,5029,8,0,8,36.88,,
20431,5030,9,6,3,30.67,,
20432,5031,13,4,9,38.91,,
20433,5033,11,5,6,26.59,,
20434,5034,9,5,4,34.79,,
20435,5108,13,3,10,7.27,,
20436,5122,12,7,5,15.52,,
20437,5123,8,3,5,15.52,,
20438,5124,13,8,5,15.52,,
20439,5125,8,6,2,15.52,,
20440,5126,20,8,12,15.52,,
20441,5127,8,5,3,15.52,,
20442,5128,7,1,6,15.52,,
20443,5129,15,11,4,15.52,,
20445,5131,8,3,5,18.99,,
20448,5135,18,4,14,18.99,,
20449,5136,10,10,0,18.99,,
20450,5137,29,21,8,18.99,,
20451,5161,13,8,5,28.73,,
20453,5163,0,0,0,28.73,,
20454,5164,7,2,5,15.52,,
20455,5165,15,2,13,15.52,,
20491,5235,5,0,5,1.29,,
20492,5236,15,4,11,1.29,,
20493,5237,41,24,17,1.29,,
20494,5238,18,8,10,1.29,,
20495,5239,12,7,5,1.29,,
20496,5240,16,15,1,1.29,,
20497,5241,11,5,6,1.29,,
20498,5242,20,20,0,1.29,,
20499,5243,17,8,9,1.29,,
20500,5244,20,8,12,1.29,,
20501,5245,15,6,9,1.29,,
20502,5246,29,9,20,1.29,,
20505,6007,26,4,22,29.29,,
20506,6010,6,4,2,36.56,,
20507,6011,7,7,0,36.56,,
20508,6337,2,0,2,182.62,,
20520,7035,5,0,5,59.11,,
20521,7036,9,6,3,59.11,,
20523,7038,0,0,0,59.11,,
20524,7039,16,6,10,59.11,,
20525,7040,10,5,5,59.11,,
20526,7041,8,3,5,59.11,,
20527,7042,6,5,1,59.11,,
20528,7043,11,6,5,59.11,,
20529,7044,33,26,7,59.11,,
20531,7046,42,36,6,59.11,,
20532,7047,9,6,3,59.11,,
20533,7048,22,11,11,59.11,,
20534,7050,5,5,0,3.86,,
20536,7052,10,0,10,3.86,,
20537,7053,14,10,4,3.86,,
20538,7054,11,0,11,3.86,,
20540,7056,29,13,16,3.86,,
20541,7057,2,0,2,3.86,,
20542,7058,14,6,8,3.86,,
20543,7059,8,3,5,3.86,,
20545,7061,18,17,1,3.99,,
20555,7135,7,7,0,59.11,,
20556,7136,11,7,4,59.11,,
20558,7138,7,3,4,59.11,,
20559,7139,8,0,8,59.11,,
20560,7140,0,0,0,59.11,,
20561,7141,11,6,5,59.11,,
20562,7142,6,5,1,59.11,,
20563,7143,9,5,4,59.11,,
20564,7144,0,0,0,59.11,,
20566,7146,6,3,3,59.11,,
20568,7148,9,4,5,59.11,,
20569,7200,11,7,4,12.16,,
20570,7201,2,2,0,12.16,,
20571,7204,7,3,4,12.16,,
20572,7205,15,5,10,12.16,,
20573,7209,10,5,5,12.16,,
20574,7212,10,3,7,12.16,,
20575,7213,7,4,3,12.16,,
20576,7216,6,4,2,12.16,,
20577,7217,6,6,0,12.16,,
20578,7220,5,3,2,12.16,,
20579,7221,12,7,5,12.16,,
20580,7224,5,0,5,12.16,,
20581,7225,8,5,3,12.16,,
20582,7228,9,7,2,12.16,,
20583,7229,7,4,3,12.16,,
20584,7232,3,3,0,28.08,,
20585,7236,5,4,1,28.08,,
20586,7237,13,4,9,28.08,,
20587,7239,2,2,0,28.08,,
20588,7241,14,10,4,28.08,,
20589,7244,9,4,5,30.32,,
20590,7246,10,1,9,30.32,,
20591,7248,5,0,5,30.32,,
20592,7250,0,0,0,30.32,,
20593,7251,0,0,0,72.96,,
20594,7254,0,0,0,72.96,,
20595,7256,0,0,0,72.96,,
20596,7258,5,3,2,72.96,,
20601,7267,0,0,0,96.68,,
20602,7268,0,0,0,96.68,,
20603,7269,2,2,0,96.68,,
20604,7270,1,0,1,124.75,,
20605,7271,2,2,0,124.75,,
20606,7287,0,0,0,94.10,,
20607,7288,0,0,0,94.10,,
20608,7289,0,0,0,94.10,,
20609,7290,4,2,2,94.10,,
20613,7294,11,6,5,28.08,,
20614,7295,6,4,2,28.08,,
20615,7299,8,6,2,12.16,,
20633,7347,9,3,6,12.16,,
20634,7348,7,1,6,28.08,,
20635,7349,2,2,0,28.08,,
20636,7350,0,0,0,30.32,,
20637,7351,8,3,5,30.32,,
20638,7352,7,3,4,30.32,,
20639,7353,0,0,0,30.32,,
20640,7354,0,0,0,30.32,,
20641,7355,7,3,4,30.32,,
20642,7365,0,0,0,72.96,,
20645,7372,0,0,0,236.94,,
20649,7400,7,1,6,15.34,,
20650,7401,12,6,6,15.34,,
20651,7402,4,0,4,15.34,,
20652,7403,0,0,0,15.34,,
20653,7404,9,4,5,15.34,,
20654,7405,11,5,6,15.34,,
20655,7406,22,8,14,15.34,,
20656,7407,10,5,5,15.34,,
20657,7408,1,1,0,15.34,,
20658,7425,6,6,0,16.08,,
20660,7427,6,4,2,16.08,,
20661,7428,13,7,6,16.08,,
20662,7429,3,2,1,16.08,,
20663,7430,2,2,0,16.08,,
20666,7433,9,0,9,16.08,,
20670,7475,5,5,0,90.80,,
20671,7476,8,4,4,90.80,,
20672,7477,1,1,0,133.33,,
20678,7900,9,3,6,3.85,,
20679,7901,17,7,10,4.66,,
20680,7902,3,0,3,5.29,,
20681,8003,3,1,2,29.80,,
20682,8005,0,0,0,31.90,,
20685,8017,2,0,2,59.71,,
20686,8018,5,3,2,59.71,,
20687,8019,0,0,0,79.53,,
20688,8028,0,0,0,30.61,,
20689,8034,30,30,0,2.25,,
20690,8035,25,10,15,1.24,,
20691,8037,0,0,0,1.39,,
20693,8041,0,0,0,65.71,,
20694,8069,0,0,0,16.29,,
20695,8073,6,4,2,17.19,,
20696,8087,2,1,1,59.68,,
20697,8088,1,1,0,43.76,,
20698,8089,15,12,3,3.14,,
20699,8095,2,2,0,1216.05,,
20700,8099,4,2,2,227.53,,
20701,8127,0,0,0,196.95,,
20702,8129,0,0,0,105.84,,
20703,8132,0,0,0,174.41,,
20704,8134,20,14,6,2.25,,
20705,8143,0,0,0,234.90,,
20706,8158,1,1,0,131.73,,
20707,8159,0,0,0,188.57,,
20708,8161,0,0,0,173.68,,
20709,8165,0,0,0,575.47,,
20710,8166,12,2,10,2.25,,
20711,8167,0,0,0,2.25,,
20712,8169,0,0,0,2.25,,
20713,8171,45,18,27,2.25,,
20714,8172,0,0,0,2.25,,
20715,8173,4,3,1,19.28,,
20716,8174,0,0,0,398.56,,
20717,8176,0,0,0,481.47,,
20718,8177,0,0,0,86.92,,
20719,8179,0,0,0,86.92,,
20721,8186,0,0,0,1344.43,,
20722,8195,0,0,0,1216.05,,
20723,8199,0,0,0,227.53,,
20724,8200,4,2,2,5.20,,
20725,8204,5,0,5,4.77,,
20726,8205,0,0,0,7.85,,
20727,8206,0,0,0,6.72,,
20728,8207,0,0,0,9.66,,
20729,8208,0,0,0,10.10,,
20730,8209,0,0,0,9.66,,
20731,8210,5,0,5,7.13,,
20732,8211,9,3,6,7.42,,
20733,8212,0,0,0,15.66,,
20734,8214,0,0,0,7.13,,
20735,8216,0,0,0,10.24,,
20736,8217,5,4,1,7.13,,
20737,8218,5,5,0,10.00,,
20738,8219,3,1,2,10.00,,
20739,8220,7,5,2,13.59,,
20740,8221,6,0,6,14.28,,
20741,8222,6,3,3,13.59,,
20742,8230,0,0,0,8.13,,
20743,8231,0,0,0,8.13,,
20744,8233,0,0,0,6.99,,
20745,8234,0,0,0,10.24,,
20746,8235,1,1,0,149.47,,
20747,8236,4,3,1,176.92,,
20748,8237,3,2,1,176.92,,
20749,8238,2,2,0,215.68,,
20750,8239,1,1,0,176.92,,
20751,8240,0,0,0,29.80,,
20752,8242,4,2,2,56.22,,
20754,8244,6,3,3,31.23,,
20755,8245,3,1,2,31.23,,
20756,8246,4,3,1,55.46,,
20757,8247,0,0,0,251.71,,
20758,8248,4,2,2,228.62,,
20760,8251,0,0,0,167.70,,
20761,8252,0,0,0,65.95,,
20762,8253,0,0,0,65.95,,
20764,8255,0,0,0,48.96,,
20765,8256,0,0,0,19.56,,
20766,8257,7,5,2,18.61,,
20767,8258,4,2,2,48.77,,
20768,8259,0,0,0,5.72,,
20769,8260,0,0,0,9.20,,
20770,8264,0,0,0,586.05,,
20771,8265,0,0,0,564.19,,
20772,8266,4,4,0,2.24,,
20773,8267,3,3,0,2.24,,
20774,8268,9,4,5,2.42,,
20776,8271,4,2,2,189.53,,
20777,8272,4,2,2,110.84,,
20778,8273,2,0,2,147.11,,
20779,8274,0,0,0,91.87,,
20780,8275,8,5,3,13.59,,
20781,8278,0,0,0,2.42,,
20782,8280,4,2,2,188.77,,
20783,8282,17,0,17,8.13,,
20784,8283,7,5,2,10.24,,
20785,8284,8,4,4,10.24,,
20786,8285,8,5,3,10.24,,
20787,8286,12,3,9,13.59,,
20788,8287,10,7,3,10.00,,
20789,8288,10,6,4,10.00,,
20790,8289,5,2,3,13.59,,
20791,8290,9,6,3,13.59,,
20792,8291,2,1,1,10.24,,
20793,8292,9,6,3,8.13,,
20794,8293,12,3,9,1.84,,
20795,8294,8,8,0,1.56,,
20796,8295,20,4,16,1.56,,
20797,8296,17,6,11,1.56,,
20798,8297,9,4,5,1.56,,
20799,8298,7,5,2,1.56,,
20800,8299,6,3,3,1.56,,
20801,8357,0,0,0,309.75,,
20802,8358,0,0,0,209.48,,
20803,8359,0,0,0,199.73,,
20804,8361,2,0,2,451.27,,
20805,8363,0,0,0,367.11,,
20806,8365,2,1,1,309.75,,
20807,8366,4,2,2,209.48,,
20808,8367,4,2,2,199.73,,
20810,8371,3,1,2,189.53,,
20811,8372,6,3,3,110.84,,
20812,8373,4,2,2,147.11,,
20813,8374,0,0,0,91.87,,
20814,8375,0,0,0,429.39,,
20815,8376,4,1,3,346.97,,
20816,8377,2,2,0,407.84,,
20817,8378,0,0,0,674.52,,
20818,8379,2,2,0,886.25,,
20819,8380,5,3,2,730.65,,
20820,8381,0,0,0,985.22,,
20821,8382,4,2,2,1213.22,,
20822,8383,3,3,0,16.29,,
20823,8384,5,5,0,7.99,,
20824,8385,2,1,1,198.84,,
20825,8386,2,1,1,252.24,,
20826,8401,0,0,0,409.13,,
20827,8402,3,1,2,480.08,,
20828,8403,4,2,2,580.80,,
20829,8405,0,0,0,410.54,,
20830,8406,1,0,1,489.09,,
20831,8407,0,0,0,577.82,,
20832,8408,0,0,0,1117.78,,
20833,8409,0,0,0,322.13,,
20834,8410,0,0,0,138.89,,
20835,8411,4,2,2,188.59,,
20836,8412,4,2,2,197.04,,
20840,8461,0,0,0,399.56,,
20841,8462,0,0,0,453.85,,
20843,8464,0,0,0,413.94,,
20844,8465,0,0,0,573.62,,
20845,8466,0,0,0,376.01,,
20846,8467,0,0,0,241.70,,
20857,8478,0,0,0,333.61,,
20858,8479,0,0,0,423.82,,
20859,8480,0,0,0,347.10,,
20864,8485,0,0,0,366.84,,
20867,8488,0,0,0,346.46,,
20868,8489,0,0,0,362.59,,
20872,8498,0,0,0,287.38,,
20873,8499,0,0,0,241.70,,
20874,8505,0,0,0,410.54,,
20875,8506,0,0,0,489.09,,
20876,8507,0,0,0,577.82,,
20877,8508,0,0,0,1117.78,,
20878,8509,0,0,0,315.78,,
20879,8511,0,0,0,188.59,,
20880,8512,0,0,0,196.95,,
20883,8561,0,0,0,399.54,,
20884,8562,0,0,0,453.54,,
20886,8564,0,0,0,413.94,,
20887,8565,0,0,0,573.47,,
20888,8566,0,0,0,376.01,,
20889,8567,0,0,0,241.66,,
20902,8580,0,0,0,347.10,,
20907,8585,0,0,0,366.85,,
20910,8588,0,0,0,346.43,,
20911,8589,0,0,0,362.59,,
20915,8598,0,0,0,287.35,,
20916,8599,0,0,0,241.70,,
20943,8686,4,2,2,155.62,,
20945,8689,6,4,2,269.29,,
20946,8690,1,1,0,177.78,,
20948,8693,2,0,2,351.41,,
20949,9009,2,0,2,114.99,,
20950,9010,4,2,2,143.81,,
20951,9011,0,0,0,254.61,,
20952,9012,5,5,0,173.67,,
20953,9019,2,1,1,327.24,,
20954,9077,6,3,3,413.19,,
20955,9228,2,2,0,30.82,,
20957,9230,10,4,6,30.82,,
20959,9233,10,5,5,48.96,,
20960,9354,4,1,3,28.96,,
20961,9630,4,2,2,48.13,,
20963,5510e,3,3,0,44.93,,
20964,5511e,14,3,11,44.93,,
20965,7250I,4,2,2,30.32,,
21060,SG10,0,0,0,276.35,,
21062,AG127,0,0,0,359.99,,
25049,E26009,0,0,0,91.66,,
25050,E26008,0,0,0,104.16,,
25103,6005,15,5,10,21.96,,
25104,6006,81,21,60,21.96,,
25142,GPK-11,3,1,2,181.30,,
25238,010-10702-00,0,0,0,23.62,,
25241,FNB-83,8,5,3,28.24,,
25264,492/50/200ST-ES,0,0,0,210.00,,
25265,494/50/200-ES,1,1,0,94.99,,
25266,496/50/200ST-ES,0,0,0,210.00,,
25307,CAT460,20,16,4,12.71,,
25325,010-10550-00,98,98,0,24.49,,
25349,010-10723-01,6,3,3,11.24,,
25398,1368561,0,0,0,922.46,,
25436,1862016,0,0,0,121.96,,
25449,1810125,2,0,2,185.81,,
25453,1865003,16,16,0,15.09,,
25454,1865006,16,16,0,23.24,,
25456,1865017,14,10,4,23.24,,
25457,1865018,0,0,0,35.59,,
25458,1865010,13,3,10,6.53,,
25459,1865011,3,0,3,6.53,,
25489,526TID-HDN,0,0,0,1066.67,,
25524,E66079,0,0,0,1334.66,,
25525,E66082,0,0,0,852.26,,
25537,E26033,0,0,0,46.86,,
25550,1854021,25,17,8,65.38,,
25580,MA3013G,78,17,61,34.69,,
25582,MS56,4,3,1,103.39,,
25587,MA8506W,11,6,5,92.17,,
25594,P77769,8,6,2,614.46,,
25642,1459,24,3,21,39.38,,
25643,1458,112,11,101,50.63,,
25656,010-10617-02,0,0,0,13.22,,
25657,235DST-MSE,0,0,0,445.45,,
26221,000-154-054,2,2,0,50.00,,
26249,E66013,0,0,0,174.99,,
26250,E66085,2,1,1,295.82,,
26251,E66086,0,0,0,295.82,,
26252,525T-LTD/20,2,1,1,244.44,,
26253,525T-LTD/12,0,0,0,244.44,,
26256,B60-20-6G,0,0,0,280.68,,
26257,010-10982-01,0,0,0,280.68,,
26258,72-0151-01,1,0,1,131.63,,
26260,808-0232-01,9,4,5,29.90,,
26264,FX-7,20,0,20,107.02,149.99,
26265,FX-11,58,24,34,143.46,202.99,
26266,FX-16,8,4,4,207.54,289.99,
26267,FX-23,12,6,6,329.53,455.99,
26268,FX-37,7,3,4,490.55,699.99,
26269,FX-55,8,4,4,717.29,,
26270,FX-85,0,0,0,1100.49,,
26271,FX-125,0,0,0,1612.52,,
26272,SFX-7,1,0,1,62.84,,
26273,SFX-11,5,3,2,70.65,,
26274,SFX-16,5,1,4,75.34,,
26275,SFX-23,0,0,0,96.02,,
26276,SFX-37,5,2,3,99.54,,
26277,SFX-55,4,3,1,146.39,,
26278,SFX-85,1,1,0,181.52,,
26279,SFX-125,0,0,0,190.49,,
27077,531-AB,3,0,3,220.85,,
27204,528-VB,0,0,0,201.32,,
27206,E66010,0,0,0,98.00,,
27366,000-154-028,0,0,0,100.00,,
27976,FAPAR4502,0,0,0,377.78,,
27991,010-10725-00,2,2,0,7.42,,
28012,525STID-MSD7,0,0,0,488.89,,
28037,PT2004,1,0,1,320.06,,
28038,PT2005,0,0,0,320.06,,
28040,PT3010,8,3,5,95.06,,
28048,SC50,1,0,1,207.95,,
28049,SC102,0,0,0,1017.56,,
28050,SC104,0,0,0,1017.56,,
28051,SC110,1,1,0,137.25,,
28052,SC111,0,0,0,137.25,,
28053,SC112,1,1,0,137.25,,
28054,SC120,0,0,0,556.31,,
28055,SPT1001,0,0,0,320.06,,
28056,SPT1002,0,0,0,320.06,,
28057,SPT2010,0,0,0,87.19,,
28059,AG118,0,0,0,352.49,,
28061,010-10747-03,0,0,0,13.74,,
28096,010-10747-00,43,37,6,8.24,,
28115,525TID-BHD,0,0,0,800.00,,
28150,MB1100,0,0,0,355.56,,
28181,H-741-C,18,7,11,25.31,,
28202,A66089,0,0,0,1096.46,,
28234,2312,148,38,110,23.94,,
28235,2314,0,0,0,11.44,,
28236,2315,6,4,2,13.15,,
28348,1901250,16,8,8,150.39,,
28349,1901200,7,6,1,84.48,,
28350,2295002,5,1,4,34.36,,
28351,2295180,12,12,0,38.18,,
28352,2295182,11,11,0,45.81,,
28353,2295184,6,0,6,53.45,,
28354,2295190,6,6,0,61.09,,
28355,2207001,3,1,2,32.34,,
28356,2207002,0,0,0,25.15,,
28357,2207003,6,6,0,71.87,,
28361,2200693,2,2,0,32.34,,
28362,2250927,2,0,2,61.09,,
28363,2250928,9,4,5,61.09,,
28364,2250940,4,4,0,57.49,,
28365,2207327,26,1,25,57.49,,
28367,2250009,0,0,0,12.98,,
28368,2250105,11,9,2,14.50,,
28370,2250111,1,1,0,12.98,,
28373,2250119,0,0,0,15.26,,
28374,2250120-1,12,10,2,13.74,,
28375,2250106,0,0,0,16.79,,
28376,2250107,1,1,0,18.31,,
28377,2250109,2,2,0,16.79,,
28386,2450163,2,2,0,46.72,,
28389,2450169-1,30,0,30,13.61,,
28395,1491072,2,0,2,93.44,,
28447,1820087,0,0,0,12.34,,
28448,1854060,1,1,0,121.96,,
28449,1866150,0,0,0,125.16,,
28451,1852061,0,0,0,24.69,,
28455,1852068,1,1,0,25.41,,
28456,1852069,0,0,0,24.69,,
28457,1852060,2,2,0,25.41,,
28458,1852080,10,9,1,31.95,,
28468,HB-845,1,0,1,496.77,,
28513,PUMPHRP11-12,1,1,0,720.00,,
28534,528-EW,1,0,1,173.71,,
28555,2716,5,1,4,4.96,,
28657,MRWT69,0,0,0,91.90,,
28663,MRC5,0,0,0,14.38,,
28664,MRANT12,42,42,0,7.48,,
28668,710198-1,102,53,49,68.99,,
28690,A-24417P,0,0,0,33.57,,
28697,710160-1,6,3,3,75.89,,
28701,710205-1,5,0,5,188.32,,
28723,010-10714-00,35,18,17,5.49,,
28931,527ID-IHD,0,0,0,888.89,,
28949,PP4808,0,0,0,356.35,,
28957,010-10861-00,0,0,0,11.83,,
28995,883-CW,0,0,0,292.91,,
29006,826-VW,2,0,2,235.66,,
29019,578-SB,0,0,0,257.21,,
29020,876-SW,2,2,0,264.61,,
29021,876-SB,0,0,0,274.72,,
29025,518-EW,1,0,1,154.85,,
29033,340-100NM,0,0,0,182.54,,
29034,340-75NM,0,0,0,160.58,,
29061,5187,12,8,4,47.60,,
29062,5216,3,3,0,47.66,,
29063,5218,7,7,0,61.08,,
29064,5242-A,0,0,0,84.89,,
29070,5396-AIS,6,2,4,182.40,,
29071,5912,3,0,3,52.14,,
29087,53670A,56,13,43,57.78,99.99,
29088,53671A,51,30,21,47.68,99.99,
29089,53672A,95,57,38,47.68,99.99,
29090,53680CA,15,7,8,90.74,164.99,
29091,53681CA,22,13,9,90.74,164.99,
29092,53682CA,9,4,5,90.74,164.99,
29093,53674A,10,0,10,11.69,,
29095,53684A,3,1,2,13.01,,
29122,15054-001,7,1,6,181.11,,
29123,15061-001,4,1,3,218.91,,
29125,15055-001,0,0,0,219.63,,
29126,15056-001,4,0,4,219.63,,
29128,15062-001,0,0,0,256.73,,
29129,15063-001,6,3,3,256.73,,
29133,15059-001,10,4,6,219.63,,
29135,15060-001,5,2,3,243.18,,
29136,15067-001,0,0,0,278.13,,
29137,15085-001,5,4,1,9.76,,
29138,50225-001D,0,0,0,10.30,,
29139,50015-001D,0,0,0,9.26,,
29140,50015-002D,5,2,3,9.26,,
29141,50014-001D,3,0,3,9.26,,
29143,15087-001,4,1,3,7.60,,
29144,60101-001,0,0,0,10.11,,
29170,20140-001,1,0,1,85.20,,
29172,20157-001,0,0,0,96.55,,
29173,20141-001,6,2,4,91.59,,
29175,20158-001,0,0,0,97.98,,
29176,20142-001,0,0,0,115.01,,
29177,20143-001,0,0,0,146.25,,
29178,20144-001,0,0,0,206.60,,
29179,20145-001,0,0,0,230.74,,
29180,20146-001,0,0,0,256.30,,
29182,20159-001,2,0,2,97.98,,
29185,20149-001,3,0,3,102.95,,
29187,20160-001,10,1,9,125.66,,
29188,20150-001,1,0,1,132.05,,
29189,20161-001,3,1,2,138.44,,
29190,20151-001,0,0,0,190.98,,
29192,20152-001,0,0,0,230.74,,
29194,20153-001,0,0,0,261.26,,
29196,20154-001,0,0,0,290.38,,
29199,15064-001,2,0,2,289.94,,
29200,15065-001,0,0,0,311.00,,
29216,20760-001,0,0,0,274.64,,
29217,20762-001,0,0,0,281.76,,
29218,20766-001,0,0,0,292.46,,
29219,20764-001,0,0,0,292.46,,
29220,20770-001,0,0,0,311.01,,
29221,20768-001,0,0,0,311.01,,
29223,20776-001,0,0,0,345.96,,
29224,20774-001,0,0,0,345.96,,
29225,20780-001,0,0,0,376.64,,
29226,20778-001,0,0,0,376.64,,
29227,20784-001,0,0,0,408.74,,
29228,20782-001,0,0,0,408.74,,
29229,20786-001,0,0,0,437.99,,
29230,20788-001,0,0,0,437.99,,
29231,70381-001,4,2,2,43.13,,
29236,RT9X9,0,0,0,711.35,,
29237,RT9X9I,0,0,0,829.95,,
29238,15034-101,0,0,0,541.54,,
29239,RT9X12,0,0,0,745.44,,
29240,RT9X12I,0,0,0,864.03,,
29241,15035-101,0,0,0,575.63,,
29242,RT12X9,2,2,0,738.34,,
29243,RT12X9I,2,2,0,856.93,,
29244,15036-101,2,2,0,568.53,,
29245,RT12X12,2,2,0,768.86,,
29246,RT12X12HD,0,0,0,1077.69,,
29247,RT12X12HDI,0,0,0,1196.29,,
29248,15041-101,0,0,0,907.88,,
29249,RT12X12I,4,2,2,887.46,,
29250,15037-101,4,2,2,599.05,,
29251,RT16X12,0,0,0,848.38,,
29252,RT16X12HD,0,0,0,1168.56,,
29253,RT16X12HDI,4,0,4,1287.16,,
29254,15043-101,4,0,4,998.75,,
29255,RT16X12I,2,0,2,966.98,,
29256,15039-101,2,0,2,678.56,,
29257,RT17X12XD,0,0,0,1370.90,,
29258,RT17X12XDI,0,0,0,1489.50,,
29259,15045-101,0,0,0,1201.09,,
29260,RT18X14,0,0,0,945.64,,
29261,RT18X14HD,0,0,0,1211.88,,
29262,RT18X14HDI,1,0,1,1330.48,,
29263,15044-101,1,0,1,1042.06,,
29264,RT18X14I,2,0,2,1064.24,,
29265,15040-101,2,0,2,775.83,,
29266,RT19X14XDI,0,0,0,2233.54,,
29267,15046-101,0,0,0,1846.29,,
29281,TT9X9,0,0,0,639.65,,
29282,TT9X9E,0,0,0,666.63,,
29283,TT9X9EI,4,0,4,785.23,,
29284,15013-101,4,0,4,496.81,,
29285,TT9X9I,2,0,2,758.25,,
29286,15000-101,2,0,2,469.84,,
29287,15104-102,0,0,0,652.43,,
29288,15108-103,0,0,0,771.03,,
29289,15001-101,0,0,0,482.61,,
29290,TT9X18,0,0,0,686.50,,
29291,TT9X18I,0,0,0,805.10,,
29292,15002-101,0,0,0,516.69,,
29293,TT9X24,0,0,0,768.86,,
29294,TT9X24I,0,0,0,887.46,,
29295,15003-101,0,0,0,599.05,,
29296,TT9X30,0,0,0,832.76,,
29297,TT9X30I,0,0,0,951.35,,
29298,15004-101,0,0,0,662.94,,
29299,TT9X36,0,0,0,889.55,,
29300,TT9X36I,0,0,0,1008.15,,
29301,15005-101,0,0,0,719.74,,
29305,TT12X9E,0,0,0,680.11,,
29306,TT12X9EI,1,0,1,798.71,,
29307,15015-101,1,0,1,510.30,,
29308,15105-102,0,0,0,665.75,,
29309,15106-102,0,0,0,708.18,,
29310,15110-103,0,0,0,824.28,,
29311,15016-101,0,0,0,535.86,,
29312,15109-103,1,0,1,783.10,,
29313,15007-101,1,0,1,494.69,,
29314,TT12X18,0,0,0,720.59,,
29315,TT12X18E,0,0,0,774.54,,
29316,TT12X18EI,0,0,0,893.14,,
29317,15017-101,0,0,0,604.73,,
29318,TT12X18I,0,0,0,839.18,,
29319,15008-101,0,0,0,550.78,,
29320,TT12X18SS,0,0,0,1021.78,,
29322,15026-101,0,0,0,864.03,,
29323,TT12X18SSI,0,0,0,1140.36,,
29324,15018-101,0,0,0,851.96,,
29325,TT12X24,0,0,0,810.75,,
29326,TT12X24I,0,0,0,929.35,,
29327,15009-101,0,0,0,640.94,,
29328,TT12X24SS,0,0,0,1143.00,,
29330,15027-101,0,0,0,980.29,,
29331,TT12X24SSI,0,0,0,1261.59,,
29332,15019-101,0,0,0,973.19,,
29333,TT12X30,0,0,0,886.71,,
29334,TT12X30I,0,0,0,1005.31,,
29335,15010-101,0,0,0,716.90,,
29336,TT12X30SS,0,0,0,1260.66,,
29338,15028-101,0,0,0,1094.40,,
29339,TT12X30SSI,0,0,0,1379.26,,
29340,15020-101,0,0,0,1042.06,,
29343,15011-101,0,0,0,764.46,,
29346,15029-101,0,0,0,1218.46,,
29348,15021-101,0,0,0,1212.79,,
29353,15030-101,0,0,0,1415.56,,
29354,TT16X24SSI,0,0,0,1800.69,,
29355,15022-101,0,0,0,1413.44,,
29357,15031-101,0,0,0,1565.60,,
29359,15023-101,0,0,0,1486.34,,
29361,15032-101,0,0,0,1719.19,,
29363,15024-101,0,0,0,1702.85,,
29365,15033-101,0,0,0,1916.06,,
29367,15025-101,0,0,0,1903.28,,
29766,7650,2,0,2,124.93,,
29767,9972204B,1,1,0,103.93,,
29768,9972207B,3,2,1,69.24,,
29769,9972220B,1,1,0,238.26,,
29770,001-251,0,0,0,3.72,,
29771,9972222B,0,0,0,180.65,,
29772,001-330,1,0,1,6.92,,
29773,9972305B,10,5,5,124.11,,
29774,001-453,4,2,2,8.07,,
29775,001-675,1,1,0,5.71,,
29776,001-700,1,0,1,8.24,,
29777,9972313B,15,3,12,113.15,,
29778,9972320B,0,0,0,237.86,,
29779,004-178,1,1,0,6.09,,
29780,9972321B,4,2,2,168.51,,
29781,9972322B,3,2,1,155.31,,
29783,9973210B,4,2,2,382.95,,
29784,004-244,0,0,0,10.67,,
29785,004-246,2,0,2,5.76,,
29786,001-699,3,2,1,8.32,,
29787,001-455,0,0,0,8.32,,
29788,9982202B,0,0,0,97.46,,
29790,001-008,0,0,0,3.59,,
29791,001-009,0,0,0,5.53,,
29792,001-010,0,0,0,5.53,,
29793,001-011,0,0,0,5.53,,
29794,001-012,0,0,0,7.20,,
29795,001-013,0,0,0,7.20,,
29796,001-014,0,0,0,8.32,,
29797,001-017,0,0,0,7.20,,
29798,001-252,0,0,0,7.20,,
29800,001-015,0,0,0,7.20,,
29801,9982305B,0,0,0,115.59,,
29802,206-070S,0,0,0,8.64,,
29803,206-071S,8,0,8,8.64,,
29804,206-072S,4,4,0,8.64,,
29805,206-073S,26,16,10,8.64,,
29806,206-074S,0,0,0,8.64,,
29807,206-075S,11,4,7,8.64,,
29808,206-076S,1,1,0,8.64,,
29809,206-077S,5,4,1,8.64,,
29810,9960002B,0,0,0,67.76,,
29811,206-078S,1,0,1,19.95,,
29812,9960005B,0,0,0,46.84,,
29814,206-080S,3,2,1,19.95,,
29815,9960007B,0,0,0,70.49,,
29816,206-081S,0,0,0,19.95,,
29818,206-082S,3,2,1,19.95,,
29819,9960013B,0,0,0,98.84,,
29820,206-083S,24,12,12,19.95,,
29821,9960015B,0,0,0,92.46,,
29822,206-084S,5,2,3,19.95,,
29823,206-085S,7,3,4,19.95,,
29824,9960019B,0,0,0,55.81,,
29826,9960020B,1,0,1,94.03,,
29827,9960024B,4,2,2,109.03,,
29828,206-051S,4,2,2,18.87,,
29829,206-052S,0,0,0,18.87,,
29830,206-053S,0,0,0,18.87,,
29831,206-054S,0,0,0,18.87,,
29832,206-055S,0,0,0,18.87,,
29833,206-056S,3,2,1,18.87,,
29834,206-057S,4,0,4,18.87,,
29835,206-058S,0,0,0,18.87,,
29837,010-005,3,1,2,2.29,,
29838,048-003,0,0,0,1.98,,
29839,048-004,9,4,5,1.98,,
29840,048-005,0,0,0,1.98,,
29842,048-011,7,7,0,1.98,,
29843,048-016,36,0,36,1.98,,
29844,048-017,2,0,2,1.98,,
29845,048-027,9,0,9,1.98,,
29846,048-028,10,4,6,1.98,,
29847,048-021,0,0,0,1.98,,
29848,048-022,0,0,0,1.98,,
29849,048-023,0,0,0,1.98,,
29851,048-024,0,0,0,1.53,,
29854,048-026,0,0,0,1.53,,
29856,001-156,13,4,9,1.98,,
29857,001-203,1,1,0,1.98,,
29858,001-204,1,0,1,1.98,,
29859,111-176,0,0,0,1.98,,
29860,111-177,0,0,0,1.98,,
29862,001-308,0,0,0,2.73,,
29863,048-006,0,0,0,3.21,,
29865,048-008,2,0,2,4.08,,
29872,100-880,4,0,4,3.28,,
29873,100-881,10,4,6,5.48,,
29878,206-087,4,4,0,34.32,,
29879,206-353,7,4,3,34.32,,
29881,206-254,0,0,0,18.91,,
29883,001-158,0,0,0,3.75,,
29884,570-001B,2,2,0,90.49,,
29887,570-003B,2,0,2,99.69,,
29888,570-004B,0,0,0,106.83,,
29895,289-009,2,0,2,28.53,,
29896,150-061,5,5,0,5.48,,
29897,150-062,4,4,0,5.48,,
29904,9490.1,0,0,0,93.99,,
29929,PUMPHRP17-12,2,0,2,720.00,,
30089,P100019,57,43,14,18.00,,
30092,P102944,2,2,0,604.13,,
30130,1854017,47,5,42,64.62,,
30193,340-25NE,0,0,0,90.87,,
30231,53680SA,20,0,20,106.69,214.99,
30232,53681SA,13,5,8,106.69,214.99,
30233,53682SA,8,0,8,106.69,214.99,
30358,010-C0690-00,19,10,9,262.49,,
30359,010-C0691-00,19,10,9,262.49,,
30360,010-C0726-00,19,10,9,262.49,,
30361,010-C0708-00,19,10,9,262.49,,
30362,010-C0709-00,19,10,9,262.49,,
30363,010-C0727-00,19,10,9,262.49,,
30364,010-C0710-00,19,10,9,262.49,,
30365,010-C0692-00,19,10,9,262.49,,
30366,010-C0711-00,19,10,9,262.49,,
30367,010-C0712-00,19,10,9,262.49,,
30368,010-C0713-00,19,10,9,262.49,,
30369,010-C0728-00,19,10,9,262.49,,
30370,010-C0714-00,19,10,9,262.49,,
30371,010-C0715-00,19,10,9,262.49,,
30375,010-C0730-00,19,10,9,262.49,,
30379,010-C0731-00,19,10,9,262.49,,
30380,010-C0721-00,19,10,9,262.49,,
30381,010-C0722-00,19,10,9,262.49,,
30382,010-C0732-00,19,10,9,262.49,,
30385,010-C0693-00,19,10,9,262.49,,
30386,010-C0733-00,19,10,9,262.49,,
30387,010-C0725-00,19,10,9,262.49,,
30388,010-C0694-00,19,10,9,262.49,,
30389,010-C0734-00,19,10,9,262.49,,
30393,010-C0698-00,19,10,9,262.49,,
30394,010-C0736-00,19,10,9,262.49,,
30399,010-C0739-00,3,2,1,337.49,,
30400,010-C0701-00,3,2,1,337.49,,
30401,010-C0740-00,3,2,1,337.49,,
30402,010-C0702-00,19,10,9,262.49,,
30403,010-C0703-00,19,10,9,262.49,,
30404,010-C0704-00,19,10,9,262.49,,
30405,010-C0705-00,19,10,9,262.49,,
30406,010-C0741-00,3,2,1,337.49,,
30408,010-C0742-00,3,2,1,337.49,,
30411,010-C0744-00,3,2,1,337.49,,
30426,HB-740,0,0,0,238.82,,
30428,010-10447-03,0,0,0,17.49,,
30554,ART-3,2,2,0,131.58,,
30594,7610,0,0,0,83.13,,
30617,710147-1,5,3,2,75.89,,
30636,SEAMINI2,0,0,0,8.76,,
30645,1368560,0,0,0,796.67,,
30647,1810140,10,8,2,254.64,,
30665,010-10930-00,0,0,0,31.50,,
30668,010-10918-00,2,0,2,20.99,,
30729,010-C0760-00,0,0,0,187.49,,
30730,010-C0761-00,0,0,0,187.49,,
30731,010-C0762-00,0,0,0,187.49,,
30732,010-C0763-00,0,0,0,187.49,,
30733,010-C0764-00,0,0,0,187.49,,
30734,010-C0765-00,0,0,0,187.49,,
30735,010-C0766-00,0,0,0,187.49,,
30736,010-C0767-00,0,0,0,187.49,,
30737,010-C0768-00,0,0,0,187.49,,
30739,010-C0770-00,0,0,0,187.49,,
30740,010-C0771-00,0,0,0,187.49,,
30741,010-C0772-00,0,0,0,187.49,,
30742,010-C0773-00,0,0,0,187.49,,
30743,010-C0774-00,0,0,0,187.49,,
30744,010-C0775-00,0,0,0,187.49,,
30745,010-C0776-00,0,0,0,187.49,,
30746,010-C0777-00,0,0,0,187.49,,
30747,010-C0778-00,0,0,0,187.49,,
30748,010-C0779-00,0,0,0,187.49,,
30749,010-C0780-00,0,0,0,187.49,,
30750,010-C0782-00,0,0,0,187.49,,
30751,010-C0783-00,0,0,0,187.49,,
30754,010-C0786-00,0,0,0,187.49,,
30755,010-C0787-00,0,0,0,187.49,,
30756,010-C0788-00,0,0,0,187.49,,
30757,010-C0789-00,0,0,0,187.49,,
30758,010-C0790-00,0,0,0,187.49,,
30759,010-C0791-00,0,0,0,187.49,,
30762,010-C0794-00,0,0,0,131.23,,
30763,010-C0795-00,0,0,0,131.23,,
30764,010-C0796-00,0,0,0,131.23,,
30765,010-C0797-00,0,0,0,131.23,,
30766,010-C0798-00,0,0,0,131.23,,
30767,010-C0799-00,0,0,0,131.23,,
30768,010-C0800-00,0,0,0,131.23,,
30769,010-C0801-00,0,0,0,131.23,,
30770,010-C0802-00,0,0,0,131.23,,
30771,010-C0803-00,0,0,0,131.23,,
30772,010-C0804-00,0,0,0,131.23,,
30773,010-C0805-00,0,0,0,131.23,,
30775,010-C0807-00,0,0,0,131.23,,
30776,010-C0808-00,0,0,0,131.23,,
30777,010-C0809-00,0,0,0,131.23,,
30778,010-C0810-00,0,0,0,131.23,,
30779,010-C0811-00,0,0,0,131.23,,
30780,010-C0812-00,0,0,0,131.23,,
30781,010-C0813-00,0,0,0,131.23,,
30782,010-C0814-00,0,0,0,131.23,,
30783,010-C0815-00,0,0,0,131.23,,
30784,010-C0816-00,0,0,0,131.23,,
30785,010-C0817-00,0,0,0,131.23,,
30786,010-C0818-00,0,0,0,131.23,,
30791,010-C0823-00,0,0,0,131.23,,
30794,010-C0826-00,0,0,0,131.23,,
30795,010-C0827-00,0,0,0,131.23,,
30796,010-C0828-00,0,0,0,131.23,,
30797,010-C0829-00,0,0,0,131.23,,
30798,010-C0830-00,0,0,0,131.23,,
30800,010-C0832-00,0,0,0,131.23,,
30801,010-C0833-00,0,0,0,131.23,,
30802,010-C0834-00,0,0,0,131.23,,
30803,010-C0835-00,0,0,0,131.23,,
30804,010-C0836-00,0,0,0,131.23,,
30812,010-C0844-00,0,0,0,131.23,,
30814,010-C0846-00,0,0,0,131.23,,
30817,010-C0849-00,0,0,0,187.49,,
30818,010-C0850-00,0,0,0,131.23,,
30843,010-10917-00,15,4,11,16.10,,
30863,B260-BL,0,0,0,1274.12,,
30871,010-10856-00,0,0,0,10.99,,
30872,010-10931-00,40,0,40,23.99,,
30874,010-10888-00,0,0,0,14.99,,
30888,710200-1,1,0,1,142.86,,
30907,T100-916,0,0,0,962.49,,
30908,T101-916,0,0,0,1124.99,,
30909,T103-916,0,0,0,951.91,,
30912,T106-916,0,0,0,482.13,,
30914,T122,0,0,0,399.71,,
30917,2713,19,14,5,2.68,,
30918,010-C0753-00,0,0,0,187.49,,
30919,010-C0754-00,0,0,0,187.49,,
30920,010-C0756-00,0,0,0,187.49,,
30921,010-C0757-00,0,0,0,187.49,,
30922,010-C0868-00,0,0,0,142.49,,
30923,010-C0869-00,0,0,0,142.49,,
30924,010-C0870-00,0,0,0,142.49,,
30925,010-C0871-00,0,0,0,142.49,,
30926,010-C0872-00,0,0,0,142.49,,
30927,010-C0873-00,0,0,0,142.49,,
30928,010-C0874-00,0,0,0,142.49,,
30929,010-C0875-00,0,0,0,142.49,,
30939,MP420,0,0,0,363.62,,
30947,1854019,1,0,1,79.91,,
30976,010-C0749-00,0,0,0,187.49,,
30982,010-10920-00,3,1,2,20.30,,
31021,010-C0755-00,0,0,0,187.49,,
31028,010-C0877-00,0,0,0,262.49,,
31029,010-C0878-00,0,0,0,262.49,,
31030,010-C0879-00,0,0,0,262.49,,
31031,010-C0881-00,0,0,0,262.49,,
31034,010-C0884-00,0,0,0,262.49,,
31035,010-C0865-00,0,0,0,187.49,,
31036,010-C0866-00,0,0,0,187.49,,
31037,010-C0758-00,2,2,0,131.23,,
31038,010-C0759-00,0,0,0,131.23,,
31039,010-C0750-00,0,0,0,131.23,,
31040,010-C0751-00,0,0,0,131.23,,
31041,010-C0752-00,0,0,0,131.23,,
31042,010-C0747-00,0,0,0,187.49,,
31043,010-C0748-00,0,0,0,187.49,,
31059,010-10921-00,2,0,2,20.30,,
31081,MX7000CR,0,0,0,418.85,,
31082,MX8000CR,0,0,0,430.27,,
31090,MX8716CR,0,0,0,483.58,,
31091,MX8718CR,2,2,0,429.16,,
31092,AL7211CR,2,2,0,90.00,,
31093,AL7001CR,0,0,0,183.46,,
31094,AO8712CR,2,2,0,236.08,,
31095,AO8715CR,0,0,0,319.85,,
31096,SW9300,1,1,0,1166.79,,
31097,SW9901,0,0,0,62.31,,
31098,SX3916XS,0,0,0,970.96,,
31101,AP3916XS,0,0,0,696.81,,
31106,AP3918,0,0,0,757.73,,
31108,AP3716XS,0,0,0,715.85,,
31110,"AP3718 -1 3/4",0,0,0,757.73,,
31111,RK0322RK,0,0,0,80.13,,
31112,RK0322RK/CR,0,0,0,43.27,,
31113,RK0337CR,0,0,0,32.38,,
31115,RK0322LS,0,0,0,54.49,,
31116,RK0337LS,0,0,0,60.90,,
31117,RK0337LS/MO,0,0,0,60.90,,
31118,RK0337LD,0,0,0,118.59,,
31119,RK0337LD/MO,0,0,0,118.59,,
31123,RH525SS,18,9,9,73.08,,
31124,RH527VS,8,3,5,73.08,,
31125,RH529HS,10,10,0,73.08,,
31126,RH530SS,8,4,4,92.95,,
31127,RH532VS,4,0,4,92.95,,
31128,RH534HS,0,0,0,92.95,,
31129,RH525SS/XS,2,1,1,81.09,,
31130,RH527VS/XS,0,0,0,81.09,,
31131,RH529HS/XS,1,1,0,81.09,,
31132,RH530SS/XS,6,0,6,105.77,,
31133,RH532VS/XS,4,4,0,105.77,,
31134,RH534HS/XS,4,4,0,93.75,,
31155,SR-2,0,0,0,224.94,,
31160,RH570,0,0,0,175.00,,
31161,RH570XL,0,0,0,192.31,,
31162,RH575,4,2,2,135.58,,
31163,RH575XL,6,4,2,135.06,,
31164,RH577V,0,0,0,135.58,,
31165,RH577XL,7,6,1,150.64,,
31166,RH579H,0,0,0,135.58,,
31167,RH579XL,4,2,2,150.64,,
31168,RH5165,4,4,0,107.37,,
31169,RH5167V,16,7,9,107.37,,
31170,RH5169H,9,6,3,107.05,,
31172,RH5999-0003,0,0,0,14.42,,
31174,RH5930,0,0,0,25.32,,
31175,RH5931,0,0,0,18.91,,
31176,RH511,5,3,2,9.62,,
31178,RH516,5,0,5,14.42,,
31179,RH526,8,8,0,9.62,,
31180,RH528,4,4,0,9.62,,
31181,RH531,4,4,0,14.42,,
31182,RH535,6,5,1,14.42,,
31184,MC0075-1012,0,0,0,52.88,,
31185,MC0075-1016,0,0,0,52.88,,
31191,010-11029-00,0,0,0,8.24,,
31222,MC0075-1030,2,1,1,44.84,,
31224,MC0075-1033,0,0,0,52.88,,
31225,MC0075-1050,0,0,0,52.88,,
31226,MC0075-1051,0,0,0,52.88,,
31227,MC0075-1052,0,0,0,52.88,,
31228,MC0075-1053,2,1,1,52.88,,
31229,MC0075-1071,0,0,0,52.88,,
31230,MC0075-1080,0,0,0,52.88,,
31231,MC0075-1081,0,0,0,52.88,,
31233,MC0075-1083,0,0,0,52.88,,
31234,MC0075-1130,1,1,0,52.88,,
31235,MC0075-1131,0,0,0,52.88,,
31236,MC0075-3016,0,0,0,52.88,,
31237,MC0075-3020,0,0,0,52.88,,
31238,MC0075-3030,1,0,1,44.84,,
31239,MC0075-3031,0,0,0,52.88,,
31240,MC0075-3050,0,0,0,52.88,,
31241,MC0075-3051,1,0,1,52.88,,
31242,MC0075-3081,0,0,0,52.88,,
31243,MC0075-4020,0,0,0,52.88,,
31244,MC0075-4025,0,0,0,52.88,,
31245,MC0075-4026,1,0,1,45.83,,
31246,MC70,6,6,0,21.64,,
31247,MC70GL,7,3,4,34.62,,
31248,MC70SL,5,1,4,31.09,,
31249,LT5201,0,0,0,70.51,,
31250,LT5202,0,0,0,70.51,,
31251,LT5203,0,0,0,70.51,,
31252,LT5204,0,0,0,70.51,,
31253,AT5101,0,0,0,62.15,,
31254,AT5102,1,0,1,53.87,,
31255,AT5103,0,0,0,62.15,,
31256,AT5104,0,0,0,62.15,,
31259,AL7301CR,0,0,0,86.54,,
31260,AL7302CR,0,0,0,86.54,,
31261,AL7303CR,0,0,0,86.54,,
31262,AL7304CR,0,0,0,86.54,,
31263,AO8716CR,0,0,0,354.12,,
31264,AO8718CR,0,0,0,388.38,,
31265,OH2016F,0,0,0,688.85,,
31266,OH2018S,0,0,0,671.63,,
31267,OH219F,0,0,0,726.92,,
31268,OH2020S,0,0,0,726.92,,
31270,AP3719XS/SK,0,0,0,864.35,,
31272,AP3722SK,0,0,0,929.08,,
31273,RA5001SL,0,0,0,123.40,,
31274,RA5001GL,0,0,0,137.82,,
31275,RA5002SL,2,0,2,103.49,,
31276,RA5002GL,4,2,2,122.16,,
31277,RA5003SL,0,0,0,123.40,,
31278,RA5003GL,5,3,2,119.44,,
31279,RA5004SL,1,1,0,106.94,,
31280,RA5004GL,2,0,2,137.82,,
31281,RA5005SL,0,0,0,123.40,,
31282,RA5005GL,0,0,0,137.82,,
31283,RA5201SL,2,2,0,123.40,,
31284,RA5201GL,2,1,1,137.82,,
31285,RA5202SL,2,2,0,123.40,,
31286,RA5202GL,2,2,0,137.82,,
31287,RA5203SL,2,0,2,123.40,,
31288,RA5203GL,0,0,0,137.82,,
31289,RA5204SL,0,0,0,123.40,,
31290,RA5204GL,3,1,2,116.85,,
31291,RA5205SL,1,1,0,106.94,,
31292,RA5205GL,0,0,0,137.82,,
31293,526TID-LTD/12,0,0,0,884.44,,
31294,526TID-LTD/20,0,0,0,884.44,,
31295,010-11010-01,0,0,0,917.61,,
31296,010-11010-00,0,0,0,917.61,,
31297,A102112,0,0,0,993.34,,
31298,A102113,0,0,0,989.35,,
31304,RC10812V,2,2,0,1728.64,2525.00,
31305,RC101012V,2,1,1,1728.64,2525.00,
31308,OH226S,0,0,0,1407.69,,
31309,AP3519,0,0,0,769.15,,
31310,AP3519XS,0,0,0,832.33,,
31311,010-10922-00,2,0,2,24.49,,
31320,A25062,0,0,0,237.49,,
31345,15052-101,0,0,0,483.33,,
31346,15048-101,0,0,0,1259.36,,
31347,15049-101,0,0,0,1312.73,,
31348,15050-101,1,1,0,1847.44,,
31349,15051-101,0,0,0,2210.12,,
31357,806-1010,2,2,0,361.32,,
31358,806-1810,0,0,0,441.81,,
31388,1903002,9,5,4,136.56,,
31390,1903005,6,4,2,93.44,,
31391,1903006,3,2,1,93.44,,
31393,1821031,2,0,2,73.11,,
31394,1821032,3,0,3,106.35,,
31395,1821033,7,3,4,139.59,,
31415,17215-0000,5,3,2,44.31,,
31416,17800-2000,8,5,3,251.93,,
31418,18590-2092,39,16,23,177.65,,
31419,18660-0121,8,0,8,167.44,,
31420,29015-0000,8,2,6,25.75,,
31421,29015-0010,10,2,8,37.16,,
31422,29015-0020,5,3,2,45.44,,
31423,29040-3000,7,0,7,95.74,,
31424,29045-0000,1,1,0,59.99,,
31427,29200-0120,0,0,0,421.48,,
31428,29295-1011,0,0,0,16.90,,
31429,30573-0000,15,14,1,76.48,,
31436,31610-0092,12,10,2,149.31,,
31440,31705-0092,14,6,8,184.26,,
31443,33799-0000,8,7,1,74.28,,
31444,34060-0010,5,3,2,49.53,,
31445,34060-0130,2,0,2,53.90,,
31446,35400-0000,9,5,4,164.30,,
31447,35440-0000,5,3,2,168.58,,
31448,35760-0092,2,2,0,239.09,,
31449,35770-0092,6,2,4,240.81,,
31451,36740-0000,4,0,4,145.00,,
31452,36770-0115,3,2,1,347.43,,
31460,37202-2012,5,3,2,258.56,,
31465,38110-0092,1,1,0,899.99,,
31466,45490-1000,22,10,12,72.16,,
31468,46400-0000,0,0,0,16.53,,
31469,50880-1000,5,3,2,213.40,,
31470,50890-1000,7,3,4,265.84,,
31479,140,7,5,2,32.73,,
31480,240,15,8,7,35.81,,
31481,41,11,8,3,30.72,,
31482,43,15,6,9,31.47,,
31483,39,2,2,0,57.59,,
31484,33ALA,16,6,10,68.17,,
31486,20A,7,3,4,42.36,,
31489,04,10,4,6,110.38,,
31490,51S,7,3,4,173.38,,
31491,02,42,14,28,89.28,,
31492,09,12,3,9,145.52,,
31493,53S,8,5,3,236.75,,
31494,10,63,22,41,125.25,,
31496,710201-1,15,8,7,188.32,,
31498,13A,3,2,1,245.02,,
31499,17A,12,10,2,230.15,,
31500,14A,12,4,8,206.64,,
31505,20F,8,5,3,41.15,,
31507,40A,41,10,31,41.16,,
31508,35A,65,23,42,32.09,,
31509,35FA,9,7,2,34.40,,
31516,70,23,13,10,4.24,,
31517,37A,46,18,28,47.77,,
31518,37FA,10,2,8,49.77,,
31519,403STC,13,4,9,52.85,,
31520,405STC,4,2,2,56.02,,
31521,401STC,6,4,2,49.33,,
31539,B60-20-BL,0,0,0,290.59,,
31650,A53S-24,0,0,0,202.84,,
31656,11200800,1,1,0,23.80,,
31657,21211310,1,0,1,55.69,,
31658,11200200,1,0,1,23.80,,
31659,11200500,7,5,2,23.80,,
31672,21310810,2,1,1,65.31,,
31673,21311010,2,1,1,65.31,,
31683,21201110,2,0,2,55.69,,
31684,21201310,5,3,2,55.69,,
31685,21211110,0,0,0,55.69,,
31686,11500600,6,1,5,36.45,,
31687,11200100,5,3,2,23.80,,
31689,11500000,24,14,10,36.45,,
31690,11500500,49,27,22,36.45,,
31693,21301110,3,1,2,59.24,,
31694,21301410,1,1,0,59.24,,
31695,21301510,4,2,2,59.24,,
31696,21300810,2,2,0,59.24,,
31697,21301010,0,0,0,59.24,,
31698,21311710,3,1,2,65.31,,
31699,21311310,0,0,0,65.31,,
31700,21311510,3,2,1,65.31,,
31701,21432111,3,1,2,75.44,,
31702,21431111,3,2,1,75.44,,
31703,21431311,3,2,1,75.44,,
31713,11500700,2,2,0,39.49,,
31714,21301210,4,2,2,59.24,,
31715,21431911,4,3,1,75.44,,
31716,21501511,1,1,0,82.01,,
31721,21301310,1,0,1,59.24,,
31722,21431511,9,5,4,75.44,,
31723,21502311,6,4,2,82.01,,
31724,11500200,26,14,12,36.45,,
31725,11500400,17,7,10,36.45,,
31726,21431711,0,0,0,75.44,,
31727,21501711,7,4,3,82.01,,
31728,21501911,14,9,5,82.01,,
31729,21502111,7,4,3,82.01,,
31730,11300101,4,1,3,26.84,,
31731,11300200,5,2,3,26.84,,
31732,11500300,19,9,10,36.45,,
31733,11500100,0,0,0,36.45,,
31741,USB100-01,4,3,1,156.00,,
31743,J2K100-01,9,5,4,280.00,,
31745,RAA100-01,0,0,0,247.20,,
31746,TLA100-01,3,2,1,210.40,,
31777,M33-100,0,0,0,100.00,,
31779,33-398-04PW,6,4,2,25.20,,
31786,FA-CF-ST,42,19,23,15.68,,
31787,FA-CM-ST,44,14,30,15.68,,
31788,BHF-CM-CF,6,5,1,25.44,,
31789,CM-CF-CF,64,59,5,19.68,,
31791,M000101,16,12,4,2.00,,
31792,M000102,10,6,4,2.00,,
31793,TR-CM,14,13,1,10.00,,
31794,TR-CF,20,19,1,10.00,,
31795,IT-CM-CF,1,0,1,16.80,,
31797,CM-CG1-CF-00.5,13,9,4,20.80,,
31798,CM-CG1-CF-01.0,11,11,0,21.92,,
31799,CM-CG1-CF-03.0,3,2,1,26.56,,
31800,CM-CG1-CF-06.0,9,6,3,33.20,,
31801,CM-CG1-CF-10.0,6,6,0,41.52,,
31807,CF-SPWR05-CF,8,4,4,40.32,,
31810,FA-NF-ST,3,0,3,27.36,,
31811,FA-NM-ST,5,0,5,27.36,,
31812,BHF-NM-NF,0,0,0,25.44,,
31813,NM-NF-NF,4,2,2,27.44,,
31815,NM-CF-NF,7,1,6,28.80,,
31816,M65-0085,0,0,0,12.80,,
31817,M65-0086,0,0,0,9.60,,
31818,TR-NM,0,0,0,10.08,,
31819,TR-NF,2,0,2,10.08,,
31820,TRL-NM,4,1,3,22.64,,
31821,TRL-NF,0,0,0,22.64,,
31822,NM-NB1-NF-00.5,0,0,0,33.28,,
31823,NM-NG1-NF-01.0,1,0,1,35.44,,
31824,NM-NG1-NF-03.0,2,0,2,48.40,,
31825,NM-NG1-NF-06.0,0,0,0,58.40,,
31826,NM-NG1-NF-08.0,0,0,0,73.92,,
31827,NM-NG1-NF-10.0,0,0,0,77.60,,
31828,NF-NM4P-NF,3,1,2,198.16,,
31829,NM4P-01,1,1,0,31.52,,
31835,220003,5,0,5,23.17,,
31839,150110,5,2,3,31.13,,
31841,151510,1,1,0,54.89,,
31842,142610,4,3,1,32.14,,
31843,142410,1,1,0,40.76,,
31849,131510,8,1,7,54.29,,
31850,131110,11,3,8,106.90,,
31851,124110,17,3,14,81.66,,
31852,124310,6,4,2,52.85,,
31853,124510,18,6,12,37.32,,
31854,124710,5,2,3,29.29,,
31855,151525,4,0,4,128.66,,
31856,111502,9,4,5,20.57,,
31857,111902,4,2,2,20.57,,
31858,112502,12,1,11,25.45,,
31860,112002,10,4,6,25.45,,
31861,113002,10,0,10,35.54,,
31862,113502,4,0,4,35.54,,
31863,113902,1,0,1,35.54,,
31864,114002,11,3,8,54.02,,
31865,114502,9,2,7,54.02,,
31866,114902,2,0,2,54.02,,
31867,102010,8,3,5,11.09,,
31868,102810,6,2,4,11.09,,
31869,103010,11,4,7,11.09,,
31870,102410,2,2,0,11.09,,
31871,104010,15,5,10,15.95,,
31872,104810,15,11,4,15.95,,
31873,105010,3,1,2,15.95,,
31874,106010,8,4,4,21.43,,
31875,106810,8,4,4,21.43,,
31876,107010,3,2,1,21.43,,
31877,106310,2,2,0,21.43,,
31878,702033,2,0,2,16.60,,
31887,010-11082-00,0,0,0,22.49,,
31889,010-11084-00,0,0,0,10.48,,
31890,010-11076-03,16,14,2,17.49,,
31891,010-11076-00,145,28,117,22.49,,
31892,010-11076-01,15,11,4,24.49,,
31893,010-11076-02,17,10,7,27.99,,
31894,010-11078-00,19,10,9,17.49,,
31895,010-11080-00,27,8,19,10.48,,
31896,010-11081-00,64,38,26,10.48,,
31897,010-11094-00,17,10,7,24.49,,
31898,010-11095-00,19,5,14,24.49,,
31899,010-11096-00,3,1,2,13.99,,
31902,010-00671-00,4,0,4,157.49,,
31903,010-00701-00,0,0,0,157.49,,
31905,010-00703-00,1,1,0,157.49,,
31906,010-00701-01,4,2,2,157.49,,
31915,010-11089-00,6,6,0,20.99,,
31917,010-11091-00,0,0,0,25.20,,
31921,A66091,1,1,0,412.48,,
31928,010-C0887-00,3,2,1,337.49,,
31937,6316,3,1,2,195.83,,
31938,6316C,0,0,0,156.67,,
31945,215,0,0,0,37.50,,
31951,250/50/200ST-CX,1,1,0,119.00,,
31952,307/50/200T-CX,1,1,0,199.50,,
31997,M81202,0,0,0,2962.49,,
32001,P102939,0,0,0,401.06,,
32002,806-1020,6,4,2,462.99,,
32003,806-1840,10,6,4,597.89,,
32022,A66092,0,0,0,520.82,,
32038,010-11023-00,0,0,0,5.50,,
32039,010-11031-00,0,0,0,16.49,,
32040,010-11029-01,3,0,3,10.99,,
32048,010-10823-03,0,0,0,7.70,,
32049,010-10729-00,0,0,0,6.00,,
32050,"POWER 760",6,3,3,108.06,139.99,
32060,740093-1,13,12,1,31.04,,
32079,010-C0924-00,0,0,0,187.49,,
32149,1865106,1501,961,540,24.17,,
32154,DA-2330,0,0,0,103.00,,
32164,SW45650,17,12,5,25.33,,
32165,SW45660,21,5,16,34.77,,
32166,SW77345,11,6,5,24.48,,
32167,SW77350,11,6,5,21.89,,
32168,SW77355,6,3,3,21.89,,
32169,SW77340,12,4,8,24.48,,
32170,SW21215,8,4,4,8.19,,
32171,SW21414,4,4,0,23.29,,
32172,SW21514,0,0,0,23.29,,
32174,SW19140,2,2,0,21.37,,
32175,SW61865,0,0,0,8.01,,
32178,SW81000,1,1,0,105.67,,
32195,HS1500HP,35,11,24,22.74,,
32235,8110,3,1,2,134.27,,
32244,A55078D,0,0,0,204.16,,
32402,SW66650,11,5,6,8.56,,
32437,MA8505W,8,2,6,76.41,,
32446,UFM-100-BL,0,0,0,9.20,19.99,
32449,PHV-200-BL,4,2,2,7.32,14.99,
32452,PHW-203-BL,4,4,0,9.72,14.99,
32469,11500900,3,0,3,39.49,,
32476,XP-98W,6,4,2,87.38,,
32479,HUB101,2,1,1,764.44,,
32485,11100101,0,0,0,18.23,,
32486,11200600,0,0,0,25.39,,
32487,11100201,5,3,2,18.23,,
32488,11100501,4,2,2,18.23,,
32489,11100601,2,2,0,18.23,,
32490,11100701,2,2,0,18.23,,
32491,11100801,1,0,1,18.23,,
32492,21221110,0,0,0,55.69,,
32494,21221310,3,1,2,55.69,,
32495,21100910,2,2,0,48.10,,
32496,21101010,1,0,1,48.10,,
32497,21110910,4,1,3,48.10,,
32498,21111010,0,0,0,51.31,,
32522,A55077D,0,0,0,174.99,,
32529,2250141,2,0,2,6.10,,
32533,2250002,21,7,14,26.73,,
32541,1015,5,5,0,14.70,,
32543,2016,15,4,11,16.41,,
32544,2017,18,8,10,16.41,,
32545,2018,4,0,4,16.41,,
32546,5175,11,5,6,11.85,,
32547,5176,21,14,7,11.85,,
32548,5177,5,3,2,11.85,,
32549,5178,41,14,27,11.85,,
32550,5180,13,11,2,11.85,,
32551,5181,19,11,8,11.85,,
32552,5182,41,6,35,11.85,,
32553,5183,4,4,0,11.85,,
32554,5184,19,12,7,11.85,,
32555,5185,20,5,15,11.85,,
32556,5186,7,5,2,11.85,,
32557,5187,21,0,21,11.85,,
32559,5189,24,5,19,11.85,,
32560,5190,22,8,14,11.85,,
32561,5191,25,25,0,17.91,,
32562,7620,6,3,3,178.53,,
32563,7621,0,0,0,178.53,,
32564,7700,0,0,0,163.86,,
32565,7701,1,1,0,151.76,,
32566,7702,5,3,2,163.86,,
32567,7703,0,0,0,151.76,,
32568,9159,13,6,7,11.24,,
32570,1810150,13,9,4,43.58,,
32571,150CCI,8,1,7,13.88,,
32605,PP4802,0,0,0,356.35,,
32644,010-11079-00,51,30,21,17.49,,
32645,010-C0880-00,0,0,0,262.49,,
32765,E22079,2,0,2,554.34,,
32772,010-11105-00,4,0,4,243.74,,
32879,SW81400,0,0,0,47.85,,
32880,B60-12-BL,0,0,0,290.59,,
32887,D003,0,0,0,29.82,,
32889,D005,0,0,0,29.82,,
32890,D006,5,5,0,29.82,,
32891,D007,0,0,0,29.82,,
32892,D009,0,0,0,46.86,,
32893,D010,0,0,0,46.86,,
32894,D011,0,0,0,46.86,,
32895,D159,0,0,0,46.86,,
32896,D160,0,0,0,46.86,,
32897,D026,0,0,0,76.69,,
32898,D027,0,0,0,76.69,,
32899,D028,0,0,0,76.69,,
32900,D029,0,0,0,76.69,,
32901,D030,0,0,0,76.69,,
32903,D008,0,0,0,29.82,,
32907,000-149-054,0,0,0,136.36,,
32908,CBL-DVI-10M,0,0,0,113.64,,
32909,PSU012,0,0,0,756.82,,
32913,713,0,0,0,8.53,,9.98
32914,730,0,0,0,10.96,,12.98
32915,730FG,0,0,0,10.96,,12.98
32916,740,4,0,4,15.64,,19.48
32917,760,15,1,14,16.89,,25.98
32918,760FG,9,0,9,16.89,,25.98
32919,833,21,6,15,27.93,,39.98
32920,855,75,41,34,34.26,,48.98
32921,950,4,4,0,23.77,,32.98
32922,955,36,22,14,23.77,,32.98
32923,960,32,10,22,25.60,,35.98
32924,970,14,4,10,27.76,,39.98
32925,980,25,5,20,31.74,,44.98
32926,985,36,15,21,31.74,,44.98
32927,990,37,20,17,31.74,,44.98
32928,308,23,0,23,26.23,,38.98
32929,310,33,23,10,28.84,,39.98
32930,50,10,10,0,24.34,,34.98
32931,2110,3,1,2,22.29,,29.98
32932,1700,12,0,12,21.63,,29.98
32933,1701,12,0,12,6.51,,8.98
32934,1702,1,1,0,6.44,,8.98
32935,1703,0,0,0,6.44,,8.98
32936,1710,2,0,2,10.60,,15.98
32937,1710C,0,0,0,27.53,,39.98
32940,112,0,0,0,15.73,,22.98
32941,113,21,5,16,28.91,,42.98
32942,117,0,0,0,56.25,,69.98
32946,1412,0,0,0,20.54,,29.98
32947,1416,16,6,10,23.07,,32.98
32948,1424,0,0,0,39.10,,56.98
32949,260,29,24,5,21.29,,29.98
32950,265,37,17,20,10.81,,14.98
32951,130,20,2,18,10.80,,15.98
32952,1901,0,0,0,22.63,,32.98
32953,1804,2,2,0,47.56,,67.98
32954,1820,0,0,0,30.73,,43.48
32955,1822,3,3,0,19.39,,28.98
32956,1825,19,0,19,37.49,,55.98
32957,101,25,1,24,6.80,,9.98
32958,102CH,20,2,18,11.30,,16.98
32960,KITMB,0,0,0,81.64,,119.98
32961,KITMI,13,6,7,122.14,,174.98
32972,A25004-P,66,18,48,25.56,,
32973,E06055,0,0,0,93.74,,
32974,VP1138,1,0,1,14.39,,
33049,A06041,1,0,1,51.13,,
33066,A06028,35,30,5,27.62,,
33067,A06030,0,0,0,25.56,,
33068,A06031,20,14,6,21.30,,
33069,A06032,9,1,8,17.03,,
33070,A06033,27,3,24,34.08,,
33071,A06034,4,4,0,38.34,,
33072,A06035,12,6,6,42.60,,
33073,A06036,3,1,2,51.13,,
33074,A06037,0,0,0,76.69,,
33075,A06038,2,2,0,34.08,,
33076,A06039,6,2,4,38.34,,
33077,0170BTWDP3,0,0,0,256.71,,
33078,A06040,1,0,1,42.60,,
33081,0170BM0DP3,0,0,0,340.79,,
33082,0170BP0DP3,1,1,0,166.40,,
33083,0170BSDDP3,0,0,0,166.40,,
33085,0170MP0DP3,1,1,0,226.59,,
33086,0170MSDDP3,1,1,0,226.59,,
33087,0170MSNDP3,0,0,0,326.66,,
33089,0170WP0DP3,3,1,2,171.14,,
33090,0170WSDDP3,6,3,3,171.14,,
33091,0170WSNDP3,0,0,0,256.71,,
33092,0602DP1BLK,4,4,0,128.30,,
33093,0602DP1CHR,0,0,0,153.76,,
33094,0602DP1WHT,0,0,0,153.80,,
33095,0602DP2BLK,0,0,0,128.30,,
33096,0602DP2CHR,3,2,1,153.76,,
33097,0602DP2WHT,0,0,0,153.80,,
33100,1045P00DP,5,0,5,27.01,,
33101,1045P0SDP,12,7,5,26.48,,
33103,1046P0SDP,10,5,5,29.37,,
33105,1047P0SDP,0,0,0,29.37,,
33106,1048P00DP,2,1,1,27.01,,
33107,1048P0SDP,11,5,6,26.48,,
33108,1060PB0DP,10,5,5,26.00,,
33110,1074DP2WHT,0,0,0,19.01,,
33111,1263DP1WHT,0,0,0,61.67,,
33112,1343DP4CHR,5,4,1,96.55,,
33114,1348DP6CHR,1,1,0,109.79,,
33115,1348DP8CHR,4,2,2,111.70,,
33116,8503DP,8,3,5,62.40,,
33117,8504DP,9,4,5,67.40,,
33118,8511DP,5,0,5,51.87,,
33119,8512DP,2,0,2,61.28,,
33120,8603DP,0,0,0,155.81,,
33121,9602DP,5,0,5,59.27,,
33122,9604DP,3,3,0,69.88,,
33123,9611DP,0,0,0,49.91,,
33124,9612DP,0,0,0,59.27,,
33125,9703DP,0,0,0,148.26,,
33166,A06042,3,2,1,34.08,,
33167,A06043,0,0,0,38.34,,
33168,A06044,0,0,0,42.60,,
33169,A06045,13,13,0,38.34,,
33170,A06046,0,0,0,38.34,,
33171,A06047,6,0,6,34.08,,
33172,A06048,0,0,0,34.08,,
33173,A06049,6,3,3,29.16,,
33174,A06061,17,10,7,29.82,,
33175,A06064,82,18,64,38.34,,
33180,HB-741,3,2,1,238.82,,
33182,PP4804,0,0,0,356.35,,
33202,010-10194-01,0,0,0,167.33,,
33225,E26028-PZ,0,0,0,191.66,,
33261,825-WLW,0,0,0,274.72,,
33291,51060,17,2,15,40.34,,
33294,79018,7,2,5,28.31,,
33295,87710,3,1,2,8.57,,
33312,R28170,64,33,31,292.49,,
33314,05505,2,1,1,339.99,,
33327,05121,1,0,1,18.99,,
33330,22034,88,24,64,214.21,,
33331,22074,46,3,43,288.75,,
33332,01-70-2,5,2,3,64.99,,
33333,01-70-3,7,2,5,79.99,,
33335,02-70-3,4,4,0,139.99,,
33338,2-130-2,2,1,1,184.99,,
33339,2-130-3,2,0,2,269.99,,
33343,ACM100-01,3,2,1,324.00,,
33344,DCM100-01,3,2,1,396.00,,
33345,FC01,0,0,0,32.00,,
33346,LEMHTA200-S,0,0,0,79.20,,
33347,M000630,2,2,0,60.00,,
33348,ELB-NM-NF,1,0,1,35.28,,
33349,MCF-2M-D12,0,0,0,44.00,,
33350,MCF-2M-D12CAT,0,0,0,98.40,,
33351,MCF-2M-D4,1,1,0,51.20,,
33352,NM-NG1-NF-02.0,0,0,0,40.96,,
33353,NM-NG1-NF-04.0,0,0,0,49.04,,
33354,NM-NG1-NF-05.0,2,2,0,49.04,,
33357,CM-CG1-CF-02.0,20,14,6,24.24,,
33358,CM-CG1-CF-04.0,9,7,2,29.44,,
33359,CM-CG1-CF-05.0,2,2,0,31.20,,
33360,CM-CG1-CF-08.0,3,3,0,38.24,,
33368,TR3K,1,1,0,26.40,,
33370,010-10182-01,0,0,0,232.10,,
33376,CVS-126,4,1,3,559.30,,
33377,010-11010-03,0,0,0,917.61,,
33378,A102137,0,0,0,1033.32,,
33473,17850-1012,18,11,7,167.52,,
33474,17820-0012,3,2,1,504.68,,
33475,MH-73A4B,27,3,24,42.35,,
33494,010-10850-20,0,0,0,19.80,,
33496,010-10851-11,0,0,0,16.49,,
33508,137500,0,0,0,175.39,,
33509,137501,4,4,0,133.63,,
33550,84-2031-00,5,1,4,240.38,,
33552,ST780-20,2,2,0,86.05,,
33555,ST780-30,3,0,3,86.05,,
33556,ST980-30,1,1,0,96.80,,
33557,ST980-40,2,0,2,96.80,,
33558,ST1290-60,8,6,2,129.07,,
33559,ST1290-80,1,1,0,129.07,,
33560,SX9510-30,1,0,1,95.60,,
33561,SX9510-40,0,0,0,95.60,,
33562,SX9510-60,0,0,0,95.60,,
33563,SX9510-80,1,1,0,95.60,,
33564,ST1610-120,0,0,0,188.23,,
33565,ST1610-160,1,0,1,188.23,,
33566,PT980-40,6,4,2,118.32,,
33567,PT1290-60,0,0,0,150.59,,
33568,PT9510-40,2,1,1,118.32,,
33569,PT9510-60,4,4,0,118.32,,
33570,PR500,1,1,0,26.87,,
33579,9368,0,0,0,36.68,,
33595,804-1210,8,5,3,173.70,,
33611,FI5001,1,0,1,462.22,,
33612,000-010-511,2,0,2,113.64,,
33615,000-010-618,0,0,0,136.36,,
33617,DST-800PWF,0,0,0,311.11,,
33618,DT-800PSF,0,0,0,266.67,,
33634,1363640,4,0,4,1266.71,,1499.99
33636,1363425,2,0,2,801.19,,
33637,1363445,0,0,0,1212.20,,
33680,1904000,3,3,0,24.66,,
33686,1904015,7,7,0,27.08,,
33690,1904025,0,0,0,38.69,,
33691,1904026,0,0,0,46.44,,
33692,1904027,19,15,4,54.18,,
33693,1904028,14,14,0,61.92,,
33694,1904029,29,19,10,77.40,,
33695,1904030,11,1,10,61.92,,
33696,1904031,13,10,3,69.66,,
33697,1904032,19,11,8,92.88,,
33698,1904033,8,8,0,100.62,,
33700,1907001,0,0,0,73.53,,
33701,1907002,279,149,130,85.14,,
33706,1903012,51,23,28,12.98,,
33707,1903013,44,39,5,12.98,,
33711,84-2030-00,2,2,0,216.32,,
33712,9479,0,0,0,99.95,,
33713,172001,3,1,2,977.27,,
33714,172011,1,0,1,1135.80,,
33715,171211,8,4,4,1046.24,,
33716,171201,1,0,1,890.17,,
33717,170611,2,0,2,994.22,,
33719,1790010,3,3,0,43.59,,
33720,1790610,3,3,0,44.87,,
33721,1510012,0,0,0,445.12,,
33722,1203BW,4,2,2,19.51,,
33723,1211PL,8,5,3,18.29,,
33724,1212W,2,1,1,46.47,,
33725,1214A,1,1,0,8.01,,
33726,1222AW,1,1,0,10.58,,
33727,1222B,4,3,1,15.38,,
33728,1228CW,4,4,0,23.08,,
33732,160HI012,3,2,1,546.61,,
33741,160MI012,0,0,0,557.94,,
33748,21SRP1512,0,0,0,3232.56,,
33749,21SR1512,0,0,0,3302.33,,
33750,220HF012,2,1,1,935.98,,
33751,220HR012,0,0,0,1118.90,,
33752,31-102,0,0,0,19.23,,
33753,31-3001,1,0,1,118.75,,
33756,32-601RFK,0,0,0,355.77,,
33757,AVHWR01202,0,0,0,1059.52,,
33758,AVHAR01202,0,0,0,1097.56,,
33762,AVHAR01203,1,0,1,1069.99,,
33763,AVHWF01203,0,0,0,1048.78,,
33764,AVHWR01203,2,2,0,1149.99,,
33765,AVHWR01201,0,0,0,1134.15,,
33766,AVHWF01201,0,0,0,951.22,,
33767,AVLAR01202,0,0,0,1170.73,,
33768,AVLWR01201,0,0,0,1207.32,,
33769,ATDISRK,0,0,0,60.90,,
33770,C253,15,7,8,16.03,,
33771,C254,9,9,0,16.03,,
33785,CDRK,4,2,2,121.79,,
33790,CDS12,0,0,0,46.15,,
33791,CH102MW,8,5,3,173.72,,
33793,CH18W,2,0,2,34.62,,
33794,CHRK,2,2,0,105.77,,
33799,CSRK,2,2,0,94.99,,
33825,206-131,0,0,0,41.73,,
33827,206-132,0,0,0,41.73,,
33832,206-136,0,0,0,59.45,,
33870,DIAPUMPRK,1,1,0,43.59,,
33873,EST12,2,1,1,2032.35,,
33874,ESTDC,0,0,0,105.00,,
33876,G13W,12,3,9,28.13,,
33877,WH1A-S,4,4,0,28.13,,
33884,PHIIPUMP,12,6,6,240.38,,
33885,WH3,10,7,3,37.18,,
33896,RWS,3,2,1,131.25,,
33898,SEADISRK,0,0,0,33.33,,
33903,WH16,3,3,0,63.46,,
33904,048-001,10,6,4,2.02,,
33906,048-002,10,6,4,2.02,,
33908,048-015,19,12,7,2.02,,
33911,048-034,0,0,0,2.02,,
33932,100-159-TP,0,0,0,10.66,,
33950,289-003,2,2,0,37.77,,
33954,289-007,2,1,1,37.77,,
33966,289-054,1,0,1,27.71,,
34011,HS-2774-1-R,0,0,0,445.68,,
34029,15096-001,2,0,2,43.10,,
34046,407020-1,9,9,0,320.24,,
34047,407030-1,40,40,0,356.36,,
34048,407040-1,43,43,0,419.17,,
34050,740105-1,1,1,0,22.14,,
34051,780015-1,6,6,0,37.09,,
34085,T5E231,0,0,0,41.48,,
34150,1854023,0,0,0,79.91,,
34156,FBA-38,20,5,15,18.75,,
34158,RIM100-01,2,1,1,240.00,,
34159,SIM100-01,4,1,3,276.00,,
34166,Z195,1,0,1,245.82,,
34176,MHS75,23,5,18,77.71,,
34184,FCV295,1,1,0,2587.95,,
34191,PSU013,0,0,0,927.27,,
34203,010-11204-00,0,0,0,112.49,,
34229,XTRQRS,3,3,0,38.36,45.00,
34230,XTRQRL,3,3,0,39.73,47.00,
34279,1050DPR,2,2,0,151.44,,
34280,1050MP,1,1,0,192.01,,
34281,1060DPR,3,3,0,180.56,,
34282,1071DP,5,5,0,76.20,,
34283,1073DP,1,1,0,63.70,,
34285,1085,2,2,0,239.50,,
34287,1091,2,2,0,324.63,,
34290,1101,1,1,0,496.50,,
34291,1106,0,0,0,547.43,,
34293,1116,0,0,0,599.77,,
34297,370,13,13,0,8.35,,
34299,1000K,11,9,2,18.49,,
34300,1001K,10,10,0,25.28,,
34301,1002K,12,12,0,30.19,,
34303,1010,16,12,4,14.71,,
34305,1021,2,2,0,49.76,,
34306,1023,4,4,0,14.33,,
34307,1025,1,1,0,35.71,,
34308,1026,0,0,0,67.66,,
34309,1028,3,3,0,60.51,,
34310,1029,0,0,0,66.34,,
34311,1036,0,0,0,11.58,,
34313,1170,18,18,0,8.10,,
34314,1171,12,12,0,8.36,,
34315,1172,12,12,0,8.43,,
34316,1173,0,0,0,8.46,,
34317,1179,0,0,0,8.91,,
34318,1190,12,12,0,10.11,,
34319,1180,1,1,0,6.09,,
34320,1181,0,0,0,5.33,,
34321,2125,0,0,0,34.38,,
34322,2126,0,0,0,20.98,,
34323,2127,0,0,0,15.31,,
34329,3015,0,0,0,20.15,,
34333,230-BK,1,1,0,17.65,,
34334,230-WH,13,9,4,17.65,,
34335,231-BK,12,0,12,18.78,,
34337,240,0,0,0,36.78,,
34339,241-BK,3,0,3,5.43,,
34340,241L-BK,9,9,0,7.58,,
34341,241-GR,10,10,0,5.43,,
34343,241-WH,4,0,4,5.43,,
34344,243-BK,0,0,0,7.68,,
34345,244-BK,12,11,1,6.54,,
34346,244L-BK,0,0,0,8.74,,
34348,245,8,0,8,11.91,,
34354,256,0,0,0,79.95,,
34355,257,0,0,0,33.76,,
34360,264,5,5,0,21.25,,
34361,265,0,0,0,20.04,,
34362,280-BK,19,9,10,15.88,,
34363,280-WH,12,5,7,15.88,,
34364,281-BK,0,0,0,16.96,,
34365,287,11,11,0,12.50,,
34369,344-BK,10,10,0,8.18,,
34370,350,2,2,0,16.45,,
34371,351,0,0,0,17.59,,
34372,355,0,0,0,20.04,,
34373,358,8,8,0,19.08,,
34375,362,2,2,0,21.88,,
34378,400-BK,0,0,0,32.89,,
34379,CM-CF-4,8,8,0,77.04,,
34380,401-BK,3,3,0,32.90,,
34382,444-BK,13,13,0,8.38,,
34385,459,0,0,0,12.64,,
34418,854-2021-01,1,1,0,100.22,,
34424,1608DP0BLK,1,1,0,59.63,,
34425,1608DP1BLK,4,2,2,58.64,,
34426,1609DP0CHR,0,0,0,68.61,,
34427,1636DP0CHR,1,1,0,70.00,,
34428,1639DP0CHR,1,0,1,70.00,,
34429,1642DP0CHR,2,0,2,78.43,,
34430,0300DP0CHR,4,4,0,36.20,,
34431,0300DP1CHR,1,1,0,39.68,,
34432,0300DP2CHR,3,3,0,46.47,,
34433,0870DP0CHR,0,0,0,31.19,,
34434,1312DP0CHR,8,3,5,25.64,,
34436,0420006CHR,0,0,0,509.55,,
34439,0499DP0CHR,13,3,10,80.99,,
34440,0504DP0CHR,7,4,3,65.68,,
34443,1356DP0CHR,0,0,0,96.65,,
34444,1356DP0WHT,0,0,0,93.83,,
34449,0599DPDCHR,1,0,1,52.87,,
34450,0599DPGCHR,1,0,1,55.52,,
34451,GP330B,3,0,3,344.25,,
34452,1399DP0CHR,5,5,0,42.65,,
34457,0525DP0BLK,8,5,3,30.00,,
34458,1324DP0BLK,17,12,5,26.35,,
34459,1324DP1BLK,16,7,9,28.99,,
34460,1188DP4CHR,0,0,0,25.67,,
34461,1188DP6CHR,5,2,3,17.52,,
34462,1188DP8CHR,3,0,3,36.35,,
34463,1252DP0CHR,3,0,3,35.13,,
34468,1230DP0CHR,1,0,1,21.25,,
34469,0750DP0CHR,3,0,3,130.99,,
34470,0757DP0CHR,1,1,0,26.67,,
34473,0175DP3CHR,0,0,0,300.65,,
34478,1347DP4CHR,2,2,0,85.61,,
34479,1347DP6CHR,4,2,2,99.50,,
34480,1349DP6CHR,2,2,0,127.83,,
34481,1349DP8CHR,2,2,0,131.69,,
34488,1049P00DPB,3,0,3,26.60,,
34490,1049P00DPC,6,1,5,17.99,,
34492,1611DP2CHR,4,2,2,40.52,,
34514,11,2,0,2,137.49,,
34515,47DR,19,6,13,38.44,,
34516,A26043,0,0,0,379.16,,
34517,405FC,13,10,3,51.96,,
34518,401C,24,3,21,49.33,,
34519,401FC,18,6,12,45.73,,
34520,403C,0,0,0,52.63,,
34521,18220-1127,3,1,2,295.10,,
34522,34744-0000,5,3,2,171.12,,
34523,35115-0020,0,0,0,79.90,,
34524,35515-0010,5,3,2,92.89,,
34525,34739-0020,1,1,0,159.57,,
34526,35400-0010,2,0,2,193.12,,
34527,36740-0010,8,4,4,170.53,,
34528,35770-0094,1,0,1,243.96,,
34529,02840100A,4,2,2,458.84,,
34531,50840-0012,1,1,0,340.68,,
34532,31911-0000,27,11,16,102.96,,
34533,37010-0092,4,3,1,425.99,,
34535,IL500PK,4,2,2,82.67,,
34536,50070-0040,2,0,2,110.23,,
34537,50070-0200,4,2,2,121.65,,
34538,6050-0003,3,1,2,754.21,,
34539,11860-0005,6,4,2,691.58,,
34540,11810-0003,3,1,2,734.70,,
34541,18370-0000,0,0,0,1070.78,,
34542,37072-0092,19,10,9,202.81,,
34545,12210-0001,0,0,0,378.15,,
34550,209B,13,2,11,161.89,,
34551,10-6UL,12,7,5,136.96,,
34552,15A,4,2,2,214.53,,
34553,403FC,44,21,23,48.43,,
34554,18590-2094,8,5,3,188.41,,
34555,03,3,0,3,101.22,,
34556,55S,4,3,1,315.75,,
34557,16A,13,11,2,216.85,,
34558,56D,6,4,2,220.00,,
34564,40FA,11,5,6,42.94,,
34571,45,4,2,2,22.68,,
34572,18680-0920,4,4,0,334.37,,
34573,18680-1000,4,2,2,339.19,,
34574,18670-0123,4,2,2,292.85,,
34575,18670-0943,0,0,0,292.85,,
34576,010-11156-00,0,0,0,20.99,,
34601,220AHF012,0,0,0,948.17,,
34602,220AHR012,0,0,0,1131.10,,
34603,220HF01201,0,0,0,865.85,,
34604,220AHF01201,0,0,0,878.05,,
34605,220HR01201,0,0,0,1048.78,,
34606,220AHR01201,0,0,0,1060.98,,
34607,220HF01202,1,0,1,789.63,,
34608,220AHF01202,0,0,0,801.83,,
34609,220HR01202,0,0,0,972.56,,
34610,220AHR01202,0,0,0,984.76,,
34612,760FS,0,0,0,70.70,,89.98
34613,833FS,9,0,9,64.27,,94.98
34614,855FS,0,0,0,77.13,,109.98
34692,T210,0,0,0,1170.32,,
34706,T215,0,0,0,951.91,,
34762,LMM-1,1,1,0,815.06,,
34764,LMM-2,0,0,0,815.06,,
34767,LM-GPS,1,0,1,78.19,,
34768,9502,2,0,2,73.73,,
34769,SC18,0,0,0,246.94,,
34770,SC12,0,0,0,252.56,,
34772,SC20,3,2,1,280.69,,
34773,SC21,0,0,0,314.44,,
34774,M92722,0,0,0,306.56,,
34775,M92698,0,0,0,348.19,,
34776,50100,2,1,1,143.44,,
34781,SC35,0,0,0,233.44,,
34782,SC45,0,0,0,261.56,,
34783,SC45R,0,0,0,269.44,,
34792,SPH-4I-W,0,0,0,280.69,,
34848,AIR-339-101,1,0,1,113.64,,
34849,AIR-339-102,0,0,0,145.45,,
34899,5502,20,9,11,39.56,,
34905,PP4805,0,0,0,356.35,,
34910,1413020134,0,0,0,251.52,,
34911,1413040134,0,0,0,242.95,,
34915,"XP15 0101",3,1,2,123.48,,
34918,XPD15L0101,3,0,3,146.34,,
34947,A55076D,0,0,0,124.99,,
34948,A55079D,0,0,0,308.32,,
34949,A55080D,0,0,0,133.32,,
34950,A55081D,0,0,0,174.99,,
34959,WS20HD0600,3,3,0,17.86,,
34960,"WC325 0100",27,1,26,22.50,,
34961,"WC750 0100",3,2,1,38.08,,
34962,2019,18,9,9,17.85,,
34963,5503,8,4,4,39.56,,
34964,"OML 0127",3,1,2,35.45,,
34965,4378,2,0,2,144.53,,
34967,7622,13,10,3,190.13,,
34968,7623,4,2,2,190.13,,
34969,11001,0,0,0,38.93,,
34970,11003,0,0,0,79.03,,
34971,2145,13,5,8,17.06,,
34972,2146,11,7,4,15.73,,
34973,1811,1,1,0,88.75,,
34974,1810,3,0,3,88.75,,
34978,2151,10,6,4,26.30,,
34979,1011,0,0,0,7.92,,
34980,1010,10,5,5,8.37,,
34983,2138,10,2,8,35.68,,
34984,2139,9,4,5,35.68,,
34986,2140,9,5,4,35.68,,
34987,2141,6,2,4,35.68,,
34988,2142,6,6,0,35.68,,
34989,2143,7,2,5,35.68,,
35008,1413230134,4,3,1,265.24,,
35059,T5E011,84,84,0,11.20,,
35097,81167,2,0,2,419.99,,
35098,SP-80-1,0,0,0,2029.30,,
35109,FW20000101,12,7,5,169.21,,
35120,707261,3,2,1,24.61,,
35151,1027,0,0,0,41.93,,
35157,1363641,2,2,0,1308.94,,1549.99
35162,1363420,5,0,5,721.78,,
35164,1363421,3,0,3,770.79,,
35168,1363447,2,0,2,1168.91,,
35169,1363446,1,0,1,1255.49,,
35177,1129,0,0,0,13.83,,
35192,T16012,0,0,0,89.48,,
35194,010-10781-00,0,0,0,16.31,,
35195,TLM100-01,0,0,0,180.00,,
35196,TMP100-01,3,2,1,244.00,,
35197,TA-5H-1.5NPT,4,2,2,49.60,,
35198,TA-5H-1.25BSP,1,0,1,29.60,,
35199,TFT-5H,4,0,4,43.20,,
35200,TFT-1.5NPT,2,1,1,40.00,,
35201,TFT-1.25BSP,3,1,2,67.20,,
35205,TP-AAP-1,1,1,0,20.40,,
35206,TP-EGT-1,2,2,0,125.60,,
35207,TP-IP-1,0,0,0,100.00,,
35252,1177,12,12,0,6.04,,
35253,1182,5,5,0,9.58,,
35254,E26027-PZ,0,0,0,112.49,,
35265,B164-12-BL,0,0,0,950.00,,
35281,5250,0,0,0,63.59,,
35313,000-156-405,1,0,1,86.36,,
35379,1182-BUCKET,0,0,0,234.36,,
35421,27740,13,6,7,88.25,164.99,
35422,TPK300,20,10,10,19.99,,
35423,GP1030,0,0,0,349.08,,
35424,GP1031,0,0,0,363.62,,
35426,GP2030,0,0,0,349.08,,
35427,GP2031,0,0,0,363.62,,
35428,GP2033,0,0,0,363.62,,
35429,PP5030,0,0,0,385.44,,
35430,PP5031,0,0,0,399.99,,
35431,PP5033,0,0,0,399.99,,
35432,GP1052,0,0,0,327.26,,
35433,GP2052,0,0,0,327.26,,
35434,PP5052,0,0,0,370.90,,
35435,GP1173,0,0,0,385.44,,
35465,1153,0,0,0,5.58,,
35468,311-BK,10,10,0,11.83,,
35470,590-BK,11,0,11,7.08,,
35471,253,12,12,0,23.29,,
35472,254,5,5,0,22.20,,
35473,259,14,12,2,10.53,,
35476,254M,0,0,0,13.64,,
35492,104,0,0,0,12.19,,
35494,222,3,3,0,34.38,,
35498,247,0,0,0,64.68,,
35499,248,6,6,0,11.59,,
35501,266,0,0,0,16.15,,
35502,267,12,12,0,31.38,,
35504,269,0,0,0,14.76,,
35507,276,6,6,0,24.43,,
35508,277,23,23,0,26.05,,
35509,750,11,11,0,32.78,,
35510,797,7,0,7,25.94,,
35520,1041,4,4,0,8.74,,
35524,1047,13,13,0,6.30,,
35526,1049,10,10,0,8.84,,
35527,1176,5,5,0,9.29,,
35528,1178,8,8,0,8.74,,
35529,1183,0,0,0,7.33,,
35531,3025,10,10,0,15.53,,
35557,010-C0722-20,18,7,11,112.49,,
35559,010-C0728-20,18,7,11,112.49,,
35561,010-C0730-20,18,7,11,112.49,,
35563,010-C0731-20,18,7,11,112.49,,
35565,010-C0732-20,18,7,11,112.49,,
35566,010-C0735-00,19,10,9,262.49,,
35576,010-C0747-20,2,0,2,97.49,,
35578,010-C0748-20,2,0,2,97.49,,
35580,010-C0749-20,2,0,2,97.49,,
35588,010-C0755-20,2,0,2,97.49,,
35594,010-C0760-20,2,0,2,97.49,,
35596,010-C0761-20,2,0,2,97.49,,
35598,010-C0762-20,2,0,2,97.49,,
35600,010-C0763-20,2,0,2,97.49,,
35602,010-C0764-20,2,0,2,97.49,,
35604,010-C0765-20,2,0,2,97.49,,
35606,010-C0766-20,2,0,2,97.49,,
35608,010-C0767-20,2,0,2,97.49,,
35610,010-C0768-20,2,0,2,97.49,,
35614,010-C0770-20,2,0,2,97.49,,
35616,010-C0771-20,2,0,2,97.49,,
35618,010-C0772-20,2,0,2,97.49,,
35620,010-C0773-20,2,0,2,97.49,,
35622,010-C0774-20,2,0,2,97.49,,
35624,010-C0775-20,2,0,2,97.49,,
35626,010-C0776-20,2,0,2,97.49,,
35628,010-C0777-20,2,0,2,97.49,,
35630,010-C0778-20,2,0,2,97.49,,
35632,010-C0779-20,2,0,2,97.49,,
35634,010-C0780-20,2,0,2,97.49,,
35636,010-C0782-20,2,0,2,97.49,,
35638,010-C0783-20,2,0,2,97.49,,
35644,010-C0786-20,2,0,2,97.49,,
35646,010-C0787-20,2,0,2,97.49,,
35648,010-C0788-20,2,0,2,97.49,,
35650,010-C0789-20,2,0,2,97.49,,
35652,010-C0790-20,2,0,2,97.49,,
35654,010-C0791-20,2,0,2,97.49,,
35730,010-C0849-20,2,0,2,97.49,,
35754,010-C0865-20,0,0,0,119.99,,
35756,010-C0866-20,0,0,0,119.99,,
35758,010-C0868-20,0,0,0,63.74,,
35760,010-C0869-20,0,0,0,63.74,,
35762,010-C0870-20,0,0,0,63.74,,
35764,010-C0871-20,0,0,0,63.74,,
35766,010-C0872-20,0,0,0,63.74,,
35768,010-C0873-20,0,0,0,63.74,,
35770,010-C0874-20,0,0,0,63.74,,
35772,010-C0875-20,0,0,0,63.74,,
35776,010-C0877-20,9,0,9,119.99,,
35778,010-C0878-20,9,0,9,119.99,,
35780,010-C0879-20,9,0,9,119.99,,
35782,010-C0880-20,9,0,9,119.99,,
35784,010-C0881-20,9,0,9,119.99,,
35798,010-C0924-20,2,0,2,97.49,,
35799,010-C1001-00,0,0,0,187.49,,
35801,010-C1001-20,2,0,2,97.49,,
35805,010-C1003-00,19,10,9,262.49,,
35806,010-C1004-00,19,10,9,262.49,,
35811,010-C1018-20,7,7,0,164.99,,
35812,010-C1019-20,7,7,0,164.99,,
35814,010-C1020-20,0,0,0,119.99,,
35818,010-C1024-00,19,10,9,262.49,,
35820,010-C1024-20,18,7,11,112.49,,
35833,010-10580-00,8,8,0,31.49,,
35834,FA-CF-90,3,2,1,15.68,,
35835,FA-CM-90,2,0,2,15.68,,
35881,220HS012,0,0,0,1265.24,,
35882,220AHS012,0,0,0,1277.44,,
35894,F08893,44,36,8,61.21,,
35895,F14256,10,8,2,90.78,,
35896,F14220,2,0,2,40.35,,
35897,F14393,20,12,8,62.02,,
35898,F14221,22,14,8,77.69,,
35899,F14254,10,8,2,10.73,,
35903,F13109,7,7,0,15.33,,
35904,F13110,6,6,0,17.43,,
35906,F13111,9,9,0,16.19,,
35908,F13112,1,1,0,20.53,,
35910,F14207,8,4,4,25.25,,
35911,F14208,9,3,6,25.08,,
35912,F13114,6,6,0,12.39,,
35913,F13116,0,0,0,16.61,,
35914,F10972BK,22,11,11,8.99,,
35915,F14264,12,12,0,17.88,,
35916,F15437,6,2,4,15.88,,
35919,F13274,12,12,0,5.17,,
35920,F13180,0,0,0,5.17,,
35925,T71FC,42,24,18,72.56,,
35927,X34,47,26,21,19.88,,
35928,M66X08,6,3,3,100.41,,
35929,M66X09,8,5,3,100.41,,
35930,M66X10,12,3,9,100.41,,
35931,M66X11,8,4,4,100.41,,
35932,M66X12,8,7,1,100.41,,
35933,M66X13,3,2,1,100.41,,
35934,M66X14,7,5,2,100.41,,
35935,M66X15,7,5,2,100.41,,
35936,M66X16,7,4,3,100.41,,
35937,M66X17,8,6,2,100.41,,
35938,M66X18,14,8,6,100.41,,
35939,M66X19,8,5,3,100.41,,
35940,A62245,0,0,0,72.43,,
35941,M66X20,11,4,7,100.41,,
35943,ROTECH08FC,4,2,2,147.58,,
35944,ROTECH09FC,5,3,2,147.58,,
35945,ROTECH10FC,1,0,1,147.58,,
35946,ROTECH11FC,4,0,4,147.58,,
35947,ROTECH12FC,3,1,2,147.58,,
35948,ROTECH13FC,2,1,1,147.58,,
35949,ROTECH14FC,1,0,1,147.58,,
35950,ROTECH15FC,1,1,0,147.58,,
35951,ROTECH16FC,1,0,1,147.58,,
35952,ROTECH17FC,3,1,2,147.58,,
35953,ROTECH18FC,2,2,0,147.58,,
35954,ROTECH19FC,1,1,0,147.58,,
35955,ROTECH20FC,1,1,0,147.58,,
35986,793,17,6,11,18.83,,
35988,5250-AIS,4,4,0,63.59,,
36015,2215397,5,5,0,39.53,,
36040,APT6002,0,0,0,299.12,,
36043,LMB-F1,0,0,0,1293.19,,
36044,LMB-F2,0,0,0,1293.19,,
36045,LMB-A1,0,0,0,1293.19,,
36046,LMB-A2,0,0,0,1293.19,,
36048,LMP-1,0,0,0,1689.70,,
36049,LMP-2,0,0,0,1731.94,,
36060,401586KIT,0,0,0,13.12,,
36063,B164-0-10F,0,0,0,917.61,,
36065,806-1850,1,1,0,1353.83,,
36066,F18800,0,0,0,60.31,,
36090,UP28FM,2,2,0,535.03,,
36092,"OIL 15",73,47,26,17.07,,
36095,KITOB-10',2,2,0,118.26,,
36096,KITOB-12',2,2,0,118.26,,
36097,KITOB-14',0,0,0,118.26,,
36098,KITOB-16',0,0,0,118.26,,
36099,KITOB-18',1,1,0,118.26,,
36100,KITOB-20',5,1,4,121.50,,
36101,KITOB-22',1,1,0,169.07,,
36102,KITOB-24',0,0,0,183.50,,
36103,KITOB-26',2,1,1,197.91,,
36104,KITOB-28',0,0,0,212.37,,
36105,KITOB-30',1,1,0,241.24,,
36139,PP4800,0,0,0,341.81,,
36146,72-0409,2,1,1,114.99,,
36176,SC101,0,0,0,955.69,,
36177,SC103,0,0,0,955.69,,
36180,6009C,0,0,0,13.07,,
36181,6010C,0,0,0,21.91,,
36182,6011C,1,0,1,36.79,,
36183,6012,0,0,0,56.15,,
36184,6110,3,0,3,50.88,,
36185,6111,0,0,0,66.44,,
36186,6112,0,0,0,138.69,,
36187,S-1520P,6,0,6,5.08,,
36188,S-1521,0,0,0,10.80,,
36189,S-1522P,0,0,0,15.83,,
36190,S-1523,0,0,0,22.23,,
36191,6804,0,0,0,57.39,,
36192,6804BP,0,0,0,5.79,,
36193,6809,5,3,2,75.01,,
36194,6809BP,0,0,0,5.79,,
36195,6810,0,0,0,140.79,,
36196,6810BP,0,0,0,5.79,,
36197,6904D,0,0,0,4.63,,
36198,6909D,0,0,0,4.80,,
36199,6910D,1,0,1,4.83,,
36200,6704,0,0,0,39.24,,
36201,6709,1,0,1,55.59,,
36202,6710,0,0,0,84.95,,
36207,S-114C,0,0,0,51.03,,
36208,S-112C,2,2,0,23.36,,
36209,6008HC,2,0,2,73.86,,
36210,6113C,1,1,0,28.26,,
36211,6073C,3,1,2,62.66,,
36212,6013C,0,0,0,38.69,,
36213,6030C,0,0,0,60.71,,
36215,6082C,0,0,0,38.49,,
36216,6083C,0,0,0,39.50,,
36217,AR-6480,0,0,0,34.51,,
36218,AR-6481,0,0,0,66.89,,
36219,AR-6482,0,0,0,30.13,,
36220,AR-6483,0,0,0,44.74,,
36221,AR-6484,0,0,0,48.50,,
36222,AR-6485,0,0,0,138.29,,
36223,AR-6486,0,0,0,288.33,,
36224,AR-6487,0,0,0,116.05,,
36225,AR-6488,0,0,0,168.10,,
36226,AR-6489,0,0,0,189.28,,
36227,AR-6490C,2,0,2,34.53,,
36228,AR-6495C,0,0,0,38.91,,
36238,S-5020P,2,0,2,12.56,,
36239,S-5021P,4,0,4,13.55,,
36240,S-5022P,0,0,0,14.35,,
36241,S-5023P,6,3,3,22.87,,
36242,S-5024P,4,2,2,25.28,,
36243,S-5025C,0,0,0,10.64,,
36244,S-5028P,2,0,2,12.65,,
36245,S-5029P,1,1,0,18.63,,
36246,6260C,4,2,2,26.48,,
36247,6261C,0,0,0,36.39,,
36248,6262C,0,0,0,45.13,,
36249,6959,2,1,1,114.76,,
36250,6960CBLUE,0,0,0,59.81,,
36251,S-1462C,1,1,0,18.76,,
36252,6993CBLUE,0,0,0,48.63,,
36253,6994CBLUE,0,0,0,48.63,,
36254,6995CBLUE,4,2,2,48.63,,
36255,6996CBLUE,0,0,0,48.63,,
36257,6894CBLUE,0,0,0,52.45,,
36258,6895CBLUE,2,2,0,52.45,,
36259,6004C,4,2,2,17.28,,
36260,6023C,3,1,2,20.43,,
36261,S-7031C,0,0,0,7.35,,
36262,S-7032C,0,0,0,12.00,,
36263,S-7033C,0,0,0,15.81,,
36264,6001,0,0,0,55.59,,
36265,6002,2,0,2,21.56,,
36266,6123C,0,0,0,33.80,,
36267,6124C,4,2,2,30.13,,
36268,6125C,3,2,1,33.80,,
36269,6126C,1,1,0,33.80,,
36270,6129C,4,1,3,35.10,,
36271,6394C,4,2,2,45.11,,
36272,6395C,3,3,0,45.13,,
36273,6060C,1,1,0,8.00,,
36274,6061C,5,3,2,16.63,,
36275,S-7041P,4,2,2,7.56,,
36294,806-1206,4,1,3,192.27,,
36295,806-1210,7,6,1,288.95,,
36296,806-1220,19,14,5,434.67,,
36297,S-9001B,3,2,1,95.25,,
36298,S-9002B,0,0,0,106.71,,
36299,S-9003B,0,0,0,120.79,,
36300,S-9004B,0,0,0,113.41,,
36302,S-9005C,0,0,0,36.68,,
36305,010-11022-10,21,11,10,8.00,,
36310,010-11345-00,0,0,0,8.24,,
36313,302,0,0,0,238.95,,
36371,H-AWHT,14,11,3,12.54,,
36372,H-ABLK,11,4,7,12.54,,
36382,CVS-128,3,2,1,1294.30,,
36402,32-5000,5,3,2,484.76,,
36405,1866120,0,0,0,43.58,,
36406,E15017,0,0,0,42.60,,
36418,S-7004CBLUE,0,0,0,71.39,,
36419,6174CBLUE,1,0,1,49.06,,
36420,S-096,0,0,0,19.49,,
36421,S-1957CBLUE,2,2,0,49.36,,
36422,S-7009,0,0,0,196.63,,
36423,S-7007CBLUE,4,2,2,124.39,,
36425,S-1958CBLUE,2,0,2,60.44,,
36427,S-6241,15,4,11,49.84,,
36428,S-6242,7,4,3,161.21,,
36429,S-3541C,0,0,0,9.46,,
36430,P-2456C,10,2,8,40.43,,
36431,P-2452C,3,2,1,22.70,,
36432,P-2453C,0,0,0,34.10,,
36433,P-2454C,5,2,3,20.99,,
36434,P-2455C,0,0,0,30.33,,
36477,5149,8,2,6,141.99,,199.00
36488,2151,6,2,4,187.51,,239.00
36517,S-1388C,23,6,17,2.33,,
36519,S-1390C,9,9,0,3.30,,
36520,3421BP,0,0,0,6.25,,
36521,3439BP,0,0,0,13.98,,
36522,86000C,0,0,0,40.38,,
36523,P100084,0,0,0,18.00,,
36524,P100085,2,0,2,19.29,,
36525,X-10B-M,12,6,6,36.62,,
36526,X-10W-M,0,0,0,36.62,,
36527,X-11Y-TD,1,1,0,54.99,,
36536,V-527,5,3,2,78.21,,
36537,V-537B,7,0,7,78.21,,
36538,V-537,4,3,1,78.21,,
36539,V-537W,6,2,4,78.21,,
36540,S-53W,4,2,2,71.48,,
36541,XP-99,7,3,4,72.69,,
36542,XP-99W,5,3,2,72.69,,
36543,SS-PR2,3,1,2,224.94,,
36544,S-87,15,6,9,147.53,,
36545,S-87W,2,1,1,147.53,,
36546,B-200P,0,0,0,838.88,,
36547,FB-500,0,0,0,749.77,,
36620,T10-526,4,2,2,56.25,,
36625,3100,5,4,1,120.00,,159.98
36626,3101,9,4,5,135.29,,194.98
36627,3151,18,10,8,19.00,,27.52
36628,3152,14,6,8,19.00,,27.52
36637,A10-240,5,0,5,47.81,,
36640,A10-902,10,9,1,47.81,,
36668,T108-916,0,0,0,1903.84,,
36671,T909,1,1,0,242.89,,
36673,10,211,126,85,1.60,,
36674,30,9,9,0,35.57,,
36675,31,40,38,2,7.49,,
36677,75,24,14,10,11.37,,
36678,A-0-RED,0,0,0,31.31,,
36679,A-1-RED,3,0,3,38.34,,
36680,A-2-RED,7,6,1,53.07,,
36681,A-3-RED,18,11,7,71.04,,
36682,A-4-RED,1,1,0,100.09,,
36683,A-5-RED,0,0,0,201.47,,
36685,EFC-1,1,0,1,21.99,,
36686,EFC-2,0,0,0,39.71,,
36687,EFC-3,0,0,0,43.79,,
36688,EFC-4,1,0,1,51.51,,
36742,0904DP0CHR,0,0,0,64.83,,
36745,0227DP0CHR,5,0,5,32.55,,
36754,1400DP4CHR,0,0,0,32.75,,
36757,1400DP7CHR,0,0,0,54.28,,
36761,0939DP1STS,0,0,0,83.13,,
36767,"FF-F1/G4 BLACK",0,0,0,23.37,,
36768,"FF-F1/G4 GREEN",0,0,0,23.37,,
36769,"FF-F1/G4 NVY BL",0,0,0,23.37,,
36770,"FF-F3/G5 BLK",2,0,2,29.03,,
36771,"FF-F3/G5 GRN",0,0,0,29.03,,
36772,"FF-F3/G5 NVY BL",0,0,0,29.03,,
36774,"FF-HTM-2 GRN",5,4,1,22.20,,
36775,"FF-HTM-2 NVY BL",1,1,0,22.20,,
36776,"FF-HTM-3 BLK",0,0,0,48.10,,
36777,"FF-HTM-3 GRN",0,0,0,48.10,,
36778,"FF-HTM-3 NVY BL",0,0,0,48.10,,
36779,"FF-HTM-4 BLK",0,0,0,56.73,,
36780,"FF-HTM-4 GRN",6,6,0,56.73,,
36781,"FF-HTM-4 NVY BL",3,0,3,56.73,,
36782,G-1-BLACK,0,0,0,13.46,,
36783,G-1-BLUE,8,2,6,8.99,,
36784,G-1-WHITE,11,1,10,9.99,,
36785,G-2-BLACK,2,2,0,10.99,,
36786,G-2-BLUE,1,0,1,9.99,,
36787,G-2-WHITE,0,0,0,15.73,,
36788,G-3-BLACKWO,0,0,0,18.94,,
36789,G-3-BLUEWO,0,0,0,18.94,,
36790,G-3-WHITEWO,0,0,0,18.94,,
36792,G-3-BLUE,0,0,0,19.40,,
36793,G-3-WHITE,0,0,0,19.40,,
36794,G-4-BLACKWO,12,6,6,28.71,,
36795,G-4-BLUEWO,5,0,5,19.99,,
36796,G-4-WHITEWO,6,0,6,28.71,,
36797,G-4-BLACK,12,6,6,29.17,,
36798,G-4-BLUE,5,0,5,29.17,,
36799,G-4-WHITE,6,0,6,29.17,,
36800,G-5-BLACKWO,0,0,0,55.39,,
36801,G-5-BLUEWO,0,0,0,55.39,,
36802,G-5-WHITEWO,0,0,0,55.39,,
36803,G-5-BLACK,0,0,0,55.84,,
36804,G-5-BLUE,0,0,0,55.84,,
36805,G-5-WHITE,0,0,0,55.84,,
36806,G-6-BLACKWO,2,2,0,73.13,,
36807,G-6-BLUEWO,0,0,0,73.13,,
36808,G-6-WHITEWO,0,0,0,73.13,,
36809,G-6-BLACK,2,2,0,73.59,,
36810,G-6-BLUE,0,0,0,73.59,,
36811,G-6-WHITE,0,0,0,73.59,,
36812,HTM-1-BLACKWO,2,0,2,27.99,,
36813,HTM-1-BLUEWO,2,2,0,31.99,,
36814,HTM-1-WHITEWO,0,0,0,39.11,,
36815,HTM-1-BLACK,2,0,2,29.99,,
36816,HTM-1-BLUE,2,2,0,32.31,,
36817,HTM-1-WHITE,0,0,0,39.53,,
36818,HTM-2-BLACKWO,10,5,5,51.40,,
36819,HTM-2-BLUEWO,0,0,0,51.40,,
36820,HTM-2-WHITEWO,0,0,0,51.40,,
36821,HTM-2-BLACK,10,5,5,51.86,,
36822,HTM-2-BLUE,0,0,0,51.86,,
36823,HTM-2-WHITE,0,0,0,51.86,,
36824,HTM-3-BLACKWO,2,2,0,91.23,,
36825,HTM-3-BLUEWO,0,0,0,91.23,,
36826,HTM-3-WHITEWO,4,4,0,91.23,,
36827,HTM-3-BLACK,2,2,0,91.69,,
36828,HTM-3-BLUE,0,0,0,91.69,,
36829,HTM-3-WHITE,4,4,0,91.69,,
36830,HTM-4-BLACKWO,7,1,6,134.63,,
36831,HTM-4-BLUEWO,0,0,0,134.63,,
36832,HTM-4-WHITEWO,0,0,0,134.63,,
36833,HTM-4-BLACK,7,1,6,135.09,,
36834,HTM-4-BLUE,0,0,0,135.09,,
36835,HTM-4-WHITE,0,0,0,135.09,,
36836,WS-1-RED,18,18,0,9.75,,
36837,WS-1-YELLOW,111,55,56,9.75,,
36838,WS-1-GREEN,43,43,0,9.75,,
36839,CM-2-RED,0,0,0,159.71,,
36840,"CM-2 WH-STR",0,0,0,159.71,,
36841,CM-2SS-RED,1,0,1,216.47,,
36842,"CM-2SS W-STR",0,0,0,216.47,,
36843,CM-3-RED,0,0,0,186.71,,
36844,"CM-3 WH-STR",0,0,0,186.71,,
36845,CM-3SS-RED,0,0,0,243.43,,
36846,"CM-3SS W-STR",0,0,0,243.43,,
36851,35983,14,14,0,23.04,,
36853,36103,0,0,0,2.24,,
36855,65501,0,0,0,35.23,,
36902,010-11419-00,0,0,0,82.49,,
36941,1820089,14,5,9,29.05,,
36942,1865108,0,0,0,12.34,,
36943,1865110,62,51,11,12.34,,
36945,1820175,11,3,8,72.64,,
36953,1865101,0,0,0,8.71,,
36954,1865107,3,3,0,29.05,,
36955,1840201,0,0,0,15.98,,
36957,1810126,0,0,0,220.22,,
36958,1865002,27,0,27,12.34,,
36960,1865014,0,0,0,6.53,,
36961,1865019,59,43,16,6.53,,
36962,1865260,2,2,0,36.32,,
36963,1865261,0,0,0,43.58,,
36964,1865262,0,0,0,29.05,,
36988,1907030,0,0,0,5.99,,
36989,1907040,92,44,48,11.71,,
36990,1907050,0,0,0,8.45,,
36991,1907060,3,0,3,5.88,,
37010,7716,11,5,6,140.63,,
37029,FW32000101,33,18,15,228.66,,
37030,TJ12000101,3,3,0,68.60,,
37037,2523073,1,1,0,10.79,,
37040,2523074,5,5,0,10.39,,
37220,58500-0012,4,3,1,634.99,,
37221,58500-1012,7,4,3,687.94,,
37224,T10-327,4,0,4,45.00,,
37241,6074C,2,2,0,22.93,,
37256,560-1110-7,18,6,12,25.71,,
37258,560-1112-7,9,6,3,25.71,,
37259,560-2110-7,21,13,8,25.71,,
37260,560-2112-7,7,3,4,25.71,,
37261,560-2113-7,0,0,0,25.71,,
37292,A10-650,6,3,3,28.13,,
37293,21501730,17,6,11,92.14,,
37294,21501930,17,5,12,92.14,,
37322,A10-492PB,6,2,4,48.00,,
37324,A10-1290PB,8,1,7,56.25,,
37325,A10-1291PB,6,0,6,61.88,,
37327,CL-D,1,1,0,191.37,,
37328,CL-W,2,2,0,296.43,,
37329,CL-DS,1,1,0,254.57,,
37333,CL-S,0,0,0,182.25,,
37337,012-2500-7,0,0,0,13.68,,
37339,012-5500-7,2,2,0,13.68,,
37340,CL-C,1,1,0,223.81,,
37341,BM-1,0,0,0,132.29,,
37347,CL-GR,0,0,0,141.09,,
37348,CL-CHR,0,0,0,89.53,,
37349,CL-EL,0,0,0,96.42,,
37350,CL-DR,1,1,0,96.42,,
37351,CL-SLR,0,0,0,96.42,,
37352,CL-CR,0,0,0,120.10,,
37353,CL-WR,0,0,0,96.42,,
37355,CL-AIS,0,0,0,169.23,,
37357,CLZ-SXD,0,0,0,37.82,,
37358,CLZ-PS,1,1,0,9.78,,
37359,CLZ-DXD,0,0,0,56.72,,
37360,CLZ-DX,0,0,0,18.43,,
37362,CLZ-WC,1,1,0,21.54,,
37363,CLZ-WXC,3,3,0,8.30,,
37365,CLZ-PWU,1,1,0,52.68,,
37366,CLZ-IHK,0,0,0,32.42,,
37367,CLZ-WEXT,0,0,0,23.40,,
37368,CLZ-WV,0,0,0,21.54,,
37370,P79-BL,1,1,0,145.29,,
37378,RC612V,2,0,2,725.63,1064.00,
37379,RC8812V,5,2,3,1247.38,1823.00,
37388,449-BK,0,0,0,26.30,,
37414,ARM2502B,0,0,0,98.01,,
37424,P10293,0,0,0,251.00,272.00,
37425,P10294,0,0,0,301.23,326.00,
37426,P10295,0,0,0,348.91,378.00,
37427,P10297,2,2,0,493.52,534.00,
37428,P10299,0,0,0,624.82,676.00,
37431,PRO510XL,33,11,22,48.90,,
37432,PRO520XL,12,0,12,57.05,,
37440,27656A,23,12,11,17.63,,
37474,808-9001,0,0,0,19.72,,
37476,288-PW,0,0,0,94.92,,
37477,295-PW,0,0,0,113.09,,
37482,GPS200-01,4,2,2,236.00,,
37525,010-11215-01,0,0,0,25.99,,
37683,250C/50/200ST-CX,1,1,0,150.50,,
37684,707/50/200T-CX,1,0,1,367.50,,
37705,311096402,5,1,4,94.24,,
37713,311196402,0,0,0,108.74,,
37714,311196406,0,0,0,108.74,,
37716,311096502,1,1,0,108.74,,
37718,311196502,3,1,2,123.24,,
37719,311196506,4,4,0,123.24,,
37725,301197406,0,0,0,152.24,,
37730,301197506,0,0,0,173.99,,
37765,010-11442-00,39,15,24,73.49,,
37769,TM260-10F,0,0,0,987.78,,
37775,010-11324-00,0,0,0,149.99,,
37776,010-11325-00,0,0,0,149.99,,
37777,010-11326-00,5,3,2,157.49,,
37778,010-11327-00,0,0,0,149.99,,
37779,010-11328-00,0,0,0,157.49,,
37791,EFC-A4,8,8,0,103.93,,
37792,EFC-A5,0,0,0,163.83,,
37793,EFC-A6,0,0,0,239.39,,
37800,HF3/W,0,0,0,324.18,,
37809,242-BK,0,0,0,7.15,,
37811,130-BK,1,1,0,18.61,,
37812,405-BK,9,9,0,35.11,,
37982,MK212,0,0,0,587.21,,
37987,TLM150-01,0,0,0,208.00,,
38041,SC105,0,0,0,974.25,,
38046,SC65,0,0,0,297.56,,
38047,DS16-P,3,3,0,16.85,,
38048,DS21A-P,5,3,2,18.85,,
38049,DS21B-P,5,3,2,18.85,,
38050,DS30-P,14,6,8,20.23,,
38051,DS40-P,3,3,0,22.48,,
38052,DS16-S,7,4,3,32.20,,
38053,DS21A-S,3,2,1,38.23,,
38054,DS21B-S,2,2,0,38.23,,
38055,DS30-S,2,2,0,46.98,,
38056,DS40-S,0,0,0,51.19,,
38072,1820,3,2,1,12.09,,
38128,101040,1,1,0,119.99,,
38177,DAC,2,1,1,35.00,,
38186,3022-BK,3,3,0,13.74,,
38191,T45181,0,0,0,32.25,,
38196,T46681,2,2,0,33.33,,
38197,T47852,0,0,0,29.56,,
38198,T48042,0,0,0,29.56,,
38199,T48061,0,0,0,29.56,,
38200,T49101,0,0,0,26.88,,
38208,T5E901,0,0,0,32.25,,
38211,T5E961,0,0,0,32.25,,
38252,T5K410,0,0,0,32.25,,
38255,T5K413,2,2,0,32.25,,
38299,T104-916,0,0,0,2336.53,,
38301,T110-916,0,0,0,478.01,,
38302,T111-916,0,0,0,564.55,,
38304,T112-916,0,0,0,564.55,,
38306,T113-916,0,0,0,478.01,,
38309,T120,0,0,0,659.33,,
38312,T121,1,1,0,399.71,,
38315,T908,0,0,0,387.49,,
38317,T221,0,0,0,717.02,,
38318,T138,0,0,0,108.32,,
38319,T911,0,0,0,158.32,,
38320,T912,0,0,0,161.92,,
38321,T914,0,0,0,483.32,,
38322,T915,0,0,0,195.82,,
38323,T910,0,0,0,245.82,,
38324,T075-916,0,0,0,1298.07,,
38325,T070-916,1,1,0,692.30,,
38326,T061,3,3,0,412.08,,
38329,T10-471JB,4,1,3,67.50,,
38334,135200-701-999-12,170,141,29,15.50,,
38335,135000-701-999-12,0,0,0,11.88,,
38389,1854107,0,0,0,25.41,,
38390,1854108,1,0,1,36.32,,
38391,1854100,0,0,0,29.05,,
38392,1854101,1,1,0,21.79,,
38471,544K,2,2,0,28.09,,
38488,1150-F,16,8,8,50.08,,
38490,1151-F,10,7,3,29.23,,
38491,1152-F,10,8,2,21.00,,
38492,1132-F,8,5,3,20.23,,
38493,1190-F,6,3,3,47.72,,
38494,1135-F,4,4,0,19.20,,
38495,1006-F,2,2,0,17.72,,
38496,1060-W-F,16,8,8,24.75,,
38497,1062-W-F,3,3,0,60.87,,
38498,1064-W-F,8,2,6,40.57,,
38499,95-078-F,0,0,0,57.71,,
38500,95-072-F,1,0,1,103.05,,
38504,96-250-F,0,0,0,70.11,,
38505,96-258-F,1,1,0,51.68,,
38506,3200-F,0,0,0,213.00,,
38507,3400-F,1,0,1,319.57,,
38508,3600-F,0,0,0,369.80,,
38509,3800-F,0,0,0,420.01,,
38513,91-110-F,2,2,0,21.93,,
38514,3100-F,2,1,1,178.04,,
38515,3120-F,1,0,1,283.05,,
38516,2606W-F,15,8,7,17.80,,
38517,2608W-F,6,1,5,29.37,,
38518,2606P-F,22,10,12,17.80,,
38519,2608P-F,8,4,4,29.37,,
38540,CL-BAR,1,1,0,170.49,,
38547,B-60-12-CX,0,0,0,315.00,,
38548,B-60-20-CX,1,1,0,315.00,,
38571,"XP10 0101",6,3,3,91.46,,
38572,"XP15L 0101",10,1,9,124.52,,
38573,HD25000101,3,0,3,123.48,,
38574,EJ10000101,17,11,6,55.31,,
38575,HD50000101,0,0,0,214.94,,
38640,MGA087M,1,1,0,39.99,,
38643,MGA089G,10,2,8,38.57,,
38646,MGA507A1,8,2,6,11.57,,
38648,MGA501A2,2,1,1,124.99,,
38649,MGA515A2,4,2,2,124.99,,
38651,8M4000953,13,10,3,16.65,,
38652,8M4000954,21,7,14,17.63,,
38653,MM5870,6,6,0,7.99,,
38654,MM309922T,5,1,4,16.07,,
38655,MGA503A1,9,6,3,18.00,,
38657,8M4001959,3,0,3,27.78,,
38659,8M4001961,1,0,1,31.94,,
38660,8M4001962,4,2,2,32.49,,
38744,272,1,1,0,12.86,,
38746,428,3,0,3,10.98,,
38747,429,5,5,0,21.69,,
38748,388-BK,3,3,0,39.71,,
38819,010-11430-00,6,1,5,6.04,,
38848,87730,1,0,1,20.20,,
38853,ALM100-01,3,2,1,215.20,,
38855,MK5,0,0,0,579.27,,
38888,P7702101AJ,2,2,0,58.26,,
38906,500-0393-00,0,0,0,1084.58,,
38907,500-0394-00,0,0,0,931.09,,
38951,32503,19,5,14,23.41,,
38952,32703,14,9,5,30.12,,
38953,32903,11,0,11,33.95,,
38954,42123,25,16,9,36.30,,
38955,16004-00,5,5,0,79.01,,
38956,22004,9,6,3,98.15,,
38957,40004,2,2,0,148.15,,
38958,07503-00,43,21,22,59.88,,
38959,05503-00,6,5,1,61.73,,
38960,07703-00,0,0,0,66.05,,
38961,05703-00,7,1,6,67.90,,
38962,07903-00,11,4,7,71.60,,
38963,08203-00,0,0,0,75.31,,
38964,32-47258-003,0,0,0,61.73,,
38965,32-47259-003,0,0,0,67.90,,
38966,32-47260-003,0,0,0,74.07,,
38967,32-47261-002,2,1,1,76.54,,
38968,26014,0,0,0,12.64,,
38969,36303,4,2,2,35.80,,
38970,36152,8,4,4,37.23,,
38971,28552,86,27,59,19.14,,
38972,28572,1,1,0,24.81,,
38973,28512,0,0,0,31.46,,
38975,57151,10,5,5,93.83,,
38976,10-24453-01,0,0,0,113.58,,
38979,64534,5,3,2,227.16,,
38980,64634,0,0,0,308.64,,
38981,10-24728-03,0,0,0,85.00,,
38982,10-13399-03,0,0,0,135.80,,
38983,10-13407-07,0,0,0,160.49,,
38984,10-13329-103,2,0,2,218.12,,
38985,80-47229-01,1,1,0,135.80,,
38986,80-47230-01,0,0,0,155.56,,
38987,80-47435-01,0,0,0,253.09,,
38988,80-47436-01,1,0,1,281.48,,
39079,27575,29,18,11,216.16,399.99,
39082,A3120Z-11HAE,8,0,8,89.63,,
39083,A3120Z-31HAE,2,0,2,89.63,,
39086,P1120Z-11HAE,6,2,4,102.44,,
39087,P1120Z-31HAE,8,6,2,102.44,,
39090,LL-101,7,2,5,67.07,,
39091,55150A,12,0,12,9.95,,
39097,010-11441-00,3,2,1,22.49,,
39098,010-11441-01,0,0,0,14.99,,
39105,F05848,10,10,0,11.80,,
39106,F07674,7,4,3,9.99,,
39107,F05343,8,0,8,11.82,,
39108,F05351,2,2,0,8.09,,
39109,F05352,5,5,0,8.32,,
39111,F14200,28,16,12,22.07,,
39114,F14086,0,0,0,13.83,,
39115,F18804,0,0,0,61.76,,
39129,OT-0441BKA15,9,2,7,399.99,,
39130,OT-0441VEL15,0,0,0,399.99,,
39132,0063DP5PLB,5,0,5,14.08,,
39133,OT-0541BKA15-HD,5,3,2,449.99,,
39134,OT-0541VEL15-HD,6,2,4,449.99,,
39135,OT-0542VEL15-HD,4,2,2,616.05,,
39139,OT-0552VEL186,5,2,3,778.47,,
39140,0063DP6PLB,3,1,2,18.00,,
39141,0063DP7PLB,3,3,0,25.20,,
39142,0063DP8PLB,0,0,0,31.81,,
39143,0063009PLB,0,0,0,54.36,,
39144,0065DP4PLB,1,0,1,33.08,,
39145,0065DP5PLB,4,4,0,41.95,,
39146,0065DP6PLB,1,1,0,51.71,,
39147,0065DP7PLB,7,6,1,60.25,,
39148,0066DP1PLB,4,0,4,14.31,,
39149,0066DP2PLB,9,4,5,27.55,,
39150,0066DP3PLB,8,3,5,39.16,,
39151,0066DP4PLB,3,0,3,51.21,,
39153,0076DP5PLB,0,0,0,9.64,,
39154,0076DP6PLB,0,0,0,11.89,,
39155,0076DP7PLB,0,0,0,18.20,,
39156,0076DP8PLB,25,20,5,24.99,,
39157,0076009PLB,2,0,2,31.20,,
39161,0086DP3PLB,8,5,3,15.29,,
39162,0086DP4PLB,5,5,0,20.03,,
39163,0086DP5PLB,0,0,0,33.04,,
39164,0086006PLB,3,0,3,37.67,,
39167,0322DP4PLB,2,0,2,23.31,,
39168,0322DP5PLB,5,5,0,24.08,,
39169,0322DP6PLB,5,0,5,32.84,,
39170,0322DP7PLB,6,2,4,49.55,,
39171,0322DP8PLB,6,3,3,60.27,,
39172,0322009PLB,0,0,0,74.49,,
39173,0328DP4,27,24,3,2.90,,
39174,0328DP4A,0,0,0,4.59,,
39175,0328DP5,30,20,10,3.22,,
39176,0328DP6,22,20,2,3.49,,
39177,0328DP6A,30,10,20,3.29,,
39178,0328DP8,4,4,0,5.60,,
39179,0350004DPC,1,0,1,23.61,,
39180,0350004DPP,2,2,0,20.07,,
39181,0350005DPC,0,0,0,32.37,,
39182,0350005DPP,0,0,0,28.76,,
39183,0350006DPC,7,1,6,42.48,,
39184,0350006DPP,4,0,4,37.88,,
39186,0350007DPP,2,0,2,44.95,,
39187,0350008DPC,12,5,7,62.96,,
39188,0350008DPP,0,0,0,57.76,,
39189,035006ADPC,2,2,0,42.48,,
39190,035006ADPP,0,0,0,37.88,,
39195,0493004PLB,3,0,3,193.76,,
39196,0493005PLB,0,0,0,209.64,,
39197,0493006PLB,11,5,6,293.19,,
39198,0493007PLB,3,2,1,296.18,,
39199,0493008PLB,9,1,8,466.84,,
39200,0493009PLB,0,0,0,579.14,,
39201,0493010PLB,0,0,0,600.28,,
39202,0714DP1PLB,6,0,6,22.47,,
39203,0805005PLB,4,2,2,99.15,,
39204,0805006PLB,0,0,0,136.10,,
39205,0805007PLB,2,2,0,169.81,,
39206,0805008PLB,0,0,0,211.16,,
39207,0805009PLB,0,0,0,361.89,,
39208,0805010PLB,0,0,0,558.31,,
39211,1310DP0CHR,4,0,4,28.60,,
39212,EFC-5,0,0,0,51.51,,
39271,010-11526-00,0,0,0,10.99,,
39306,010-11270-00,0,0,0,17.49,,
39313,MR652C,1,0,1,57.47,,
39314,MR752C,2,2,0,66.09,,
39318,MRANT10,10,0,10,3.31,,
39325,010-10856-20,0,0,0,12.99,,
39328,010-10854-21,0,0,0,8.24,,
39331,2104-F,0,0,0,168.51,,
39332,2105-F,0,0,0,202.20,,
39336,96-252-F,0,0,0,91.36,,
39341,ELB-CM-CF,6,4,2,29.92,,
39350,010-11478-01,0,0,0,8.24,,
39351,010-11478-02,0,0,0,16.49,,
39354,T060,15,7,8,370.87,,
39399,ZDIGUSBNMEA,7,3,4,48.71,,
39400,ZDIGHSC100,3,2,1,284.96,,
39401,BM-1CW,0,0,0,131.63,,
39402,BM-1CG,0,0,0,131.63,,
39409,27610,1,1,0,113.54,,
39410,27620,25,10,15,61.57,114.99,
39411,27670,18,10,8,58.85,109.99,
39415,13109,7,1,6,37.80,,
39418,13311,27,20,7,43.65,,
39419,13511,9,9,0,45.30,,
39420,27660,57,42,15,67.95,124.99,
39437,1082DP3WHT,0,0,0,30.79,,
39472,SP-70-8,0,0,0,2869.30,,
39473,SP-70-7,0,0,0,2729.30,,
39474,SP-80-8,0,0,0,2869.30,,
39475,SP-80-7,0,0,0,2729.30,,
39495,CO-CO1224T,4,2,2,156.00,,
39519,010-11595-00,0,0,0,84.99,,
39576,P7810500AJ,10,6,4,13.56,,
39577,P7810300AJ,20,1,19,12.31,,
39578,P7830201AJ,3,3,0,70.13,,
39579,P7160901AJ,0,0,0,50.21,,
39580,P7837200AJ,0,0,0,12.31,,
39582,P7811700AJ,4,2,2,41.54,,
39584,P5594700AJ,4,3,1,26.17,,
39585,P5591000AJ,4,2,2,11.83,,
39587,P7837300AJ,0,0,0,19.71,,
39590,P7816100AJ,0,0,0,19.71,,
39593,585-RAM-MNT,2,2,0,50.00,,
39600,YBP-0101,17,4,13,28.17,,34.98
39601,YBP-0202,0,0,0,16.67,,19.98
39602,251,74,64,10,6.41,,9.98
39627,1148,3,3,0,9.08,,
39628,S-500,14,0,14,2.08,,
39629,S-501,5,4,1,2.23,,
39641,1902300,14,7,7,417.77,,
39642,1902305,0,0,0,566.10,,
39643,1902310,14,10,4,751.99,,
39650,1904040,10,10,0,28.74,,
39651,1904045,2,2,0,71.87,,
39652,1907024,2,0,2,309.64,,
39653,1903020,11,7,4,26.59,,
39654,1903030,16,10,6,32.34,,
39655,1903031,7,7,0,32.34,,
39656,1907070,5,5,0,35.93,,
39694,720073-2,22,10,12,41.39,,
39695,720073-3,63,45,18,48.29,,
39696,720074-1,134,45,89,22.06,,
39699,407860-1,58,46,12,112.16,,
39708,710226-1,0,0,0,106.63,,
39710,2250135,0,0,0,10.78,,
39711,2215392,4,4,0,21.55,,
39712,2215396,4,4,0,28.74,,
39713,2250122,16,0,16,12.21,,
39715,011-5540-7,1,0,1,8.61,,
39718,011-2540-7,12,6,6,8.61,,
39738,1352255,0,0,0,223.39,,
39744,1865022,4,4,0,23.24,,
39749,1810220,0,0,0,50.85,,
39766,1822105,7,0,7,116.99,,
39767,1823155,13,0,13,162.49,,
39777,010-11572-00,0,0,0,1612.49,,
39782,010-11156-30,3,1,2,24.49,,
39783,010-11156-31,5,3,2,38.50,,
39784,010-11156-32,0,0,0,52.49,,
39785,29310,12,8,4,44.44,,
39786,29210,16,12,4,53.08,,
39788,MR60B,12,4,8,31.61,,
39791,010-11053-30,1,1,0,637.49,,
39793,010-11057-30,1,1,0,55.99,,
39795,010-11532-00,3,2,1,10.48,,
39796,010-11533-00,7,2,5,20.99,,
39797,010-11056-00,0,0,0,56.24,,
39798,010-11170-01,18,15,3,1.05,,
39803,CVS-1410,0,0,0,1749.30,,
39806,1700/50/200T-CX,3,1,2,140.00,,
39808,500/50/200ST-CX,0,0,0,280.00,,
39809,B-164-0-CX,0,0,0,1050.00,,
39810,B-164-12-CX,0,0,0,1050.00,,
39811,B-164-20-CX,0,0,0,1050.00,,
39822,B-60-12-ES,0,0,0,350.00,,
39823,B-60-20-ES,2,1,1,244.99,,
39837,09-808B-1,1,1,0,17.28,,
39838,09-810B-1,6,3,3,18.72,,
39839,09-1028BT-1,3,0,3,26.42,,
39840,09-1026B-1,0,0,0,18.52,,
39843,61123,5,1,4,79.01,,
39845,43210-0001,2,2,0,698.33,,
39846,50410-1201,5,3,2,442.28,,
39918,68010,0,0,0,241.50,,
39919,68020,0,0,0,280.50,,
39920,68030,0,0,0,398.25,,
39921,68040,0,0,0,447.75,,
39922,68050,0,0,0,586.50,,
39924,68120,0,0,0,453.00,,
39925,68730,0,0,0,219.00,,
39926,68740,0,0,0,263.25,,
39929,68200,0,0,0,778.89,,
39930,68250,0,0,0,1259.21,,
39931,68300,0,0,0,1377.00,,
39932,68350,0,0,0,1377.00,,
39933,68670,0,0,0,403.50,,
39934,68500,0,0,0,118.50,,
39936,68510,0,0,0,118.50,,
39937,68560,0,0,0,118.50,,
39938,68520,0,0,0,118.50,,
39939,68540,0,0,0,118.50,,
39940,68530,0,0,0,118.50,,
39943,GP1056,0,0,0,327.26,,
39944,GP2056,0,0,0,327.26,,
39945,PP5056,0,0,0,370.90,,
39946,GP1057,0,0,0,327.26,,
39947,GP2057,0,0,0,327.26,,
39948,PP5057,0,0,0,370.90,,
39949,GP2055,0,0,0,327.26,,
39950,PP5055,0,0,0,370.90,,
39979,GP1032,0,0,0,363.62,,
39980,GP2032,0,0,0,363.62,,
39981,PP5032,0,0,0,399.99,,
39982,GP1034,0,0,0,363.62,,
39983,GP2034,0,0,0,363.62,,
39984,PP5034,0,0,0,399.99,,
39991,GP1080,0,0,0,370.90,,
39992,GP1081,0,0,0,385.44,,
39993,GP2080,0,0,0,370.90,,
39994,GP2081,0,0,0,385.44,,
39996,68570,0,0,0,118.50,,
39998,68580,0,0,0,118.50,,
39999,68600,0,0,0,118.50,,
40000,68590,0,0,0,118.50,,
40001,68610,0,0,0,167.25,,
40002,68720,1,1,0,89.99,,
40003,68680,0,0,0,118.50,,
40007,68630,0,0,0,42.75,,
40008,68650,0,0,0,162.00,,
40009,68660,0,0,0,174.75,,
40010,68640,0,0,0,342.00,,
40012,67500,3,2,1,60.75,,
40013,67400,0,0,0,153.75,,
40014,67550,0,0,0,87.00,,
40016,967-18BL,7,3,4,83.86,,
40017,969ST-18,0,0,0,110.60,,
40019,969ST-18CG,9,5,4,123.75,,
40026,010-11480-00,0,0,0,59.49,,
40074,010-C1048-20,2,0,2,97.49,,
40088,2106,2,2,0,695.01,,
40089,2116,2,0,2,760.02,,
40104,49114500,0,0,0,146.99,,
40105,49070800,0,0,0,107.91,,
40106,49060700,0,0,0,89.92,,
40120,SM81,2,1,1,14.12,,
40169,TX3916SL/SL,0,0,0,875.77,,
40176,L006UCL040ABB,0,0,0,2163.33,,
40177,L004U00741AME,0,0,0,3080.77,,
40178,L004U00741AM3,0,0,0,2818.89,,
40179,L006U00741AME,0,0,0,3343.33,,
40180,L006U00741AM5,0,0,0,3047.25,,
40181,L008U00741AMD,0,0,0,3527.17,,
40182,L008U00741AM5,0,0,0,3343.33,,
40183,L004US0241AME,0,0,0,4019.78,,
40184,L004US0241AM3,0,0,0,3783.70,,
40185,L006US0241AMD,0,0,0,4279.12,,
40186,L006US0241AM5,0,0,0,4040.22,,
40187,L008US0241AME,0,0,0,4489.13,,
40188,L008US0241AM4,0,0,0,4296.74,,
40189,1017759,0,0,0,125.00,,
40190,1031221,0,0,0,210.00,,
40334,813-1000-UL,3,3,0,136.53,,
40335,813-1500-UL,0,0,0,190.56,,
40336,813-3000-UL,6,3,3,420.97,,
40337,813-5000-UL,10,9,1,655.80,,
40367,010-11029-02,0,0,0,10.99,,
40368,010-11666-00,0,0,0,15.40,,
40413,V11-0809BBK50-2,1,0,1,206.62,,
40414,V11-0809BWK50-2,3,1,2,225.23,,
40415,V11-2423BBK50-2,3,2,1,422.83,,
40416,V11-2423BBK70-2,5,2,3,505.71,,
40417,V11-3426BBK70-2,3,1,2,588.32,,
40418,V11-3447BBK50-2,3,1,2,304.23,,
40419,V11-3447BWK50-2,3,1,2,307.85,,
40420,V11-4135BKA30-3,4,2,2,218.10,,
40421,V11-9795BBK50D-2,6,4,2,333.21,,
40422,V11-9811WCM70-2,3,3,0,466.13,,
40437,FPM100-01,8,6,2,336.00,,
40487,T49831,2,2,0,29.56,,
40510,HX400,314,154,160,200.27,,
40524,15098-001,0,0,0,57.24,,
40568,010-11677-00,0,0,0,8.99,,
40569,010-11679-00,0,0,0,6.99,,
40571,010-10249-20,16,10,6,48.99,,
40572,010-11615-00,0,0,0,13.99,,
40574,010-11676-00,7,2,5,14.69,,
40575,010-11682-00,0,0,0,8.24,,
40579,2155,7,4,3,17.06,,
40580,4018,13,0,13,4.04,,
40581,5060,22,12,10,1.68,,
40582,5061,13,3,10,4.09,,
40583,5063,30,19,11,2.65,,
40584,5064,13,9,4,2.59,,
40585,5065,184,58,126,5.65,,
40586,5250,0,0,0,4.96,,
40587,5251,0,0,0,4.96,,
40588,5252,4,0,4,4.96,,
40589,5253,8,5,3,4.96,,
40590,5254,3,3,0,4.96,,
40591,5255,9,5,4,4.96,,
40592,5256,16,10,6,4.96,,
40593,5257,30,12,18,4.96,,
40594,5258,34,22,12,4.96,,
40595,5259,12,5,7,4.96,,
40596,5260,22,6,16,4.96,,
40597,7049,0,0,0,77.48,,
40598,7149,0,0,0,77.48,,
40599,7720,15,1,14,23.80,,
40600,7721,21,7,14,23.80,,
40601,7748,3,2,1,101.28,,
40605,8100,4,0,4,202.61,,
40606,8101,1,1,0,287.10,,
40607,8102,0,0,0,315.16,,
40608,7080,12,5,7,37.43,,
40609,7081,13,2,11,37.43,,
40610,7082,7,3,4,37.43,,
40611,7083,4,2,2,37.43,,
40612,7084,5,3,2,37.43,,
40613,7085,7,4,3,37.43,,
40614,7086,6,2,4,37.43,,
40624,ME-60,11,7,4,49.99,,
40627,7087,7,3,4,37.43,,
40628,7088,9,3,6,37.43,,
40629,7089,14,6,8,37.43,,
40631,7180,10,5,5,37.43,,
40632,7181,45,4,41,37.43,,
40633,7182,26,2,24,37.43,,
40634,7183,2,0,2,37.43,,
40635,7184,66,0,66,37.43,,
40636,7185,15,4,11,37.43,,
40637,7186,16,12,4,37.43,,
40638,7187,21,11,10,37.43,,
40640,7188,8,3,5,37.43,,
40641,7189,14,7,7,37.43,,
40643,7506,0,0,0,53.01,,
40644,7507,0,0,0,59.65,,
40645,7508,3,1,2,66.29,,
40752,T10-540,32,8,24,56.25,,
40787,F14087,0,0,0,17.11,,
40789,F16777,5,5,0,15.83,,
40790,F18816,0,0,0,89.02,,
40794,F103745,2,0,2,45.53,,
40797,SST-110,3,1,2,279.30,,
40798,TM200-30,0,0,0,52.50,,
40799,TS200-30,2,1,1,85.87,,
40808,229-BK,2,0,2,13.79,,
40809,239-BK,15,10,5,32.43,,
40810,260,2,2,0,16.33,,
40811,279,21,7,14,12.00,,
40812,349-BK,4,4,0,12.59,,
40813,469,0,0,0,23.94,,
40814,470,6,6,0,33.29,,
40817,476,0,0,0,16.68,,
40820,479,0,0,0,12.68,,
40821,340,4,4,0,10.26,,
40822,720057-1,134,58,76,15.16,,
40832,ZDIGAIS100,4,3,1,224.96,,
40833,ZDIGAISNET,3,1,2,712.46,,
40840,PT-0-3PSI-01,0,0,0,128.00,,
40841,PT-0-5PSI-01,0,0,0,151.20,,
40844,T137,1,1,0,108.32,,
40845,TA065,45,25,20,25.56,,
40846,TA100,0,0,0,59.65,,
40848,TA101,0,0,0,25.56,,
40849,TA118,13,0,13,59.65,,
40851,C5-A,3,2,1,125.95,,
40852,TA119,23,15,8,55.25,,
40856,TA122,4,3,1,80.95,,
40857,TA125,34,21,13,59.65,,
40858,TA900,1,0,1,34.08,,
40860,T005,0,0,0,68.17,,
40867,TA070,2,2,0,25.56,,
40904,010-11541-00,0,0,0,9.00,,
40922,10222-211D,7,2,5,74.19,,
40932,013-00005-00,6,6,0,1.27,,
40991,68860,0,0,0,108.63,,
41034,MMB-97,27,13,14,11.72,,
41046,854-2022-01,0,0,0,56.53,,
41047,808-9003,0,0,0,27.84,,
41048,809-0940,3,1,2,21.51,,
41049,809-0942,4,2,2,32.01,,
41050,808-8040-01,12,6,6,72.24,,
41051,804-1220-02,4,1,3,260.55,,
41052,804-1240-02,22,11,11,329.06,,
41056,101075,10,6,4,76.95,,
41057,101076,14,8,6,76.95,,
41058,101077,0,0,0,71.01,,
41059,101078,21,11,10,30.19,,
41060,101079,6,3,3,30.19,,
41061,101080,7,3,4,30.19,,
41062,101081,9,3,6,102.85,,
41063,101082,6,0,6,102.85,,
41065,101084,12,6,6,12.18,,
41066,101085,30,6,24,12.18,,
41067,101086,9,9,0,12.18,,
41070,1031219,0,0,0,327.78,,
41071,1031482,0,0,0,327.78,,
41092,S-233,9,4,5,8.21,,
41094,808-0915,8,3,5,57.07,,
41142,63110,15,2,13,211.19,,263.99
41143,63115,8,6,2,259.19,,323.99
41144,63120,9,7,2,326.39,,407.99
41145,63130,18,12,6,393.59,,491.99
41146,63140,40,34,6,422.39,,527.99
41147,63150,8,2,6,547.19,,683.99
41148,63160,13,6,7,671.99,,839.99
41149,63170,8,3,5,431.99,,539.99
41150,63180,17,9,8,671.99,,839.99
41166,HRCFF612V,0,0,0,865.06,1226.00,
41167,HRCFF812V,2,1,1,838.43,1226.00,
41170,T10-780,6,0,6,73.13,,
41198,PTM-R1-1,0,0,0,1361.25,,
41199,IPG100-01,1,0,1,567.20,,
41203,010-00957-00,3,0,3,562.49,,
41207,010-C1062-20,18,7,11,112.49,,
41208,010-C1063-20,18,7,11,112.49,,
41211,010-C0884-20,9,0,9,119.99,,
41213,010-C1062-00,19,10,9,262.49,,
41214,010-C1063-00,19,10,9,262.49,,
41292,DS-MULTI,3,0,3,48.35,,
41294,SC30,0,0,0,168.19,,
41295,F40-0030BKA-1,18,12,6,33.69,,
41297,RK-0001PB,16,3,13,87.05,,
41300,010-C1064-00,0,0,0,187.49,,
41301,010-C1064-20,2,0,2,97.49,,
41302,CLZ-THMK,0,0,0,32.42,,
41326,010-11131-10,0,0,0,27.50,,
41331,701S-00616,0,0,0,201.94,,
41333,701S-00608,0,0,0,61.46,,
41376,2401K,3,3,0,28.36,,
41377,2402K,0,0,0,34.95,,
41420,ZDIGAIS100USB,5,3,2,224.96,,
41421,MS-RA200MP,7,4,3,10.22,,
41450,23121,5,3,2,115.18,,
41451,23122,3,1,2,131.63,,
41452,23124,4,2,2,123.47,,
41453,23123,3,2,1,149.25,,
41454,23125,2,2,0,158.07,,
41455,23126,0,0,0,181.25,,
41456,23127,9,3,6,227.58,,
41485,LTM-MS-525,127,70,57,105.72,154.99,
41487,UCH-101-BL,10,5,5,9.62,14.99,
41489,HS-01,0,0,0,406.13,,
41490,SPH-SYSTEM-W,0,0,0,463.76,,
41494,SX10512-70,2,1,1,113.52,,
41495,SX10512-90,5,5,0,113.52,,
41506,10009,8,4,4,62.30,,
41507,10012,8,5,3,124.71,,
41509,10027,11,8,3,74.26,,
41510,10028,7,2,5,139.55,,
41511,10036,33,30,3,33.35,,
41512,10002,9,5,4,64.61,,
41519,10035,25,18,7,23.45,,
41521,10050,4,0,4,32.86,,
41522,10051,0,0,0,32.86,,
41523,10055,25,11,14,65.35,,
41524,10001,32,18,14,42.87,,
41525,11031,38,22,16,18.57,,
41526,11032,33,20,13,30.90,,
41527,854-2019-01,0,0,0,180.00,,
41528,12427,3,1,2,80.25,,
41529,12428,6,4,2,152.06,,
41533,31991,0,0,0,90.51,,
41534,30991,0,0,0,92.22,,
41535,32991,21,11,10,98.08,,
41544,31001,3,3,0,61.92,,
41545,31011,19,7,12,73.90,,
41549,010-C1058-00,0,0,0,42.49,,
41578,81783,1,0,1,542.50,,
41590,GP1055,0,0,0,327.26,,
41592,010-C1057-00,0,0,0,79.98,,
41631,PP40-916,0,0,0,5200.54,,
41632,PP50-916,0,0,0,6498.62,,
41638,DCR100-01,1,0,1,284.80,,
41639,DST110-01,1,1,0,399.20,,
41646,FDEBSN010000A00,2,2,0,91.48,,
41647,FDEBSN015000A00,4,0,4,103.81,,
41648,FDEBSN020000A00,1,1,0,113.99,,
41655,HRC101012V,1,0,1,2024.49,2969.00,
41656,HRC101012VLP,0,0,0,2095.94,2969.00,
41658,P104370,1,0,1,48.00,,
41659,P104371,0,0,0,60.80,,
41660,P102981,1,1,0,960.75,,
41661,P103864,3,0,3,46.93,,
41704,22209,7,3,4,56.85,,
41711,96-264-F,2,0,2,68.23,,
41712,96-288-F,4,0,4,24.60,,
41727,53502,16,0,16,64.51,164.99,
41737,102,20,20,0,57.56,,
41738,104,0,0,0,125.96,,
41739,105,2,2,0,68.36,,
41740,106,0,0,0,181.14,,
41741,108,2,2,0,75.56,,
41747,E32157,0,0,0,473.67,,
41763,BF30,0,0,0,76.73,107.10,
41765,C30253,0,0,0,202.18,282.20,
41766,C30503,0,0,0,273.44,381.65,
41767,A1001,2,2,0,14.62,20.40,
41772,010-11376-00,0,0,0,6.99,,
41783,82044,0,0,0,30.86,,
41784,82004,0,0,0,27.16,,
41797,CLZ-POD,0,0,0,51.92,,
41806,103,4,4,0,6.88,,
41810,101-BK,1,1,0,7.83,,
41814,010-11654-00,1,1,0,51.99,,
41815,010-11654-01,3,3,0,51.99,,
41816,010-11654-06,0,0,0,32.49,,
41817,010-11654-03,0,0,0,22.49,,
41818,010-11654-04,0,0,0,64.99,,
41819,010-11654-05,0,0,0,10.48,,
41820,0348DP5PLB,5,5,0,52.49,,
41827,SB-8-5,0,0,0,20.81,,
41828,SB-8-10,6,4,2,30.94,,
41829,SB-2G,3,3,0,9.00,,
41843,010-11602-00,0,0,0,31.99,,
41844,010-11734-20,64,51,13,5.99,,
41845,010-10279-04,2,2,0,21.75,,
41847,BPKT0801,0,0,0,1250.00,,
41849,RST755,0,0,0,133.06,,
41850,090-1100-4,0,0,0,145.76,,
41851,090-2100-4,0,0,0,145.76,,
41854,NBE100-01,1,1,0,270.40,,
41861,010-11598-00,16,3,13,22.19,,
41864,010-11733-00,0,0,0,11.99,,
41865,010-11600-00,14,14,0,29.98,,
41869,135600-701-999-12,1,1,0,16.99,,
41870,135400-701-999-12,12,6,6,12.67,,
41881,010-10856-30,0,0,0,19.49,,
41886,1710ST-13-KIT,0,0,0,484.29,,
41887,1710ST-14-KIT,1,0,1,501.43,,
41889,P104809,9,0,9,34.20,,
41890,P104810,2,0,2,34.20,,
41891,SDD-110,1,1,0,289.99,,
41893,1700/120,0,0,0,121.22,,
41894,408P/120,1,1,0,84.00,,
41981,MEK-4,14,4,10,36.82,,
42009,T222,0,0,0,1784.33,,
42027,341-BK,11,6,5,8.41,,
42029,9601DP,1,0,1,49.91,,
42040,RH5365,4,4,0,112.18,,
42041,RH5367V,17,13,4,112.18,,
42042,RH5369H,10,10,0,112.18,,
42045,010-11054-00,1,0,1,314.99,,
42068,FFM100-01,5,2,3,316.00,,
42083,010-C1066-20,18,7,11,112.49,,
42084,010-C1067-20,7,7,0,164.99,,
42086,309299,1,0,1,39.07,,
42087,309199,1,0,1,28.29,,
42089,309099,5,2,3,28.29,,
42090,315299,8,5,3,42.13,,
42091,314299,3,1,2,32.34,,
42092,312299,9,2,7,38.28,,
42093,311299,2,2,0,27.78,,
42094,310299,6,3,3,27.78,,
42095,317899,2,2,0,74.33,,
42096,316899,2,2,0,70.51,,
42097,317999,4,2,2,44.22,,
42098,316999,4,2,2,44.22,,
42099,319899,2,2,0,38.28,,
42100,318899,2,1,1,36.31,,
42101,319999,2,1,1,38.28,,
42102,318999,2,1,1,36.31,,
42105,BP-150BSY-320-1,6,3,3,95.13,,
42123,WIF-RK30880-E,0,0,0,200.80,,
42375,CVS2500A,8,6,2,85.35,,
42376,FNB-110LI,4,2,2,33.75,,
42425,1355946,2,1,1,387.49,,
42426,1355947,5,0,5,432.54,,
42429,1355956,1,0,1,549.69,,
42430,1355957,0,0,0,576.72,,
42432,1355970,6,0,6,621.78,,
42433,1355971,5,0,5,675.85,,
42458,1866350,7,0,7,123.49,,
42466,710234-1,3,3,0,136.36,,
42467,710235-1,0,0,0,136.36,,
42471,720075-1,3,3,0,34.60,,
42476,720073-5,16,7,9,44.84,,
42496,199119,29,23,6,80.79,,
42516,44411-0045,14,12,2,33.12,,
42517,44411-1045,14,11,3,38.25,,
42518,44411-2045,13,9,4,41.54,,
42530,32601-0092,7,5,2,142.75,,
42536,T2N647,2,2,0,27.95,,
42538,T2N651,0,0,0,27.95,,
42539,T2N654,0,0,0,29.03,,
42573,T5K523JV,1,1,0,26.88,,
42586,1810141,5,3,2,331.25,,
42594,MS6007WR,16,10,6,45.07,,
42595,MSX60RVR,5,3,2,72.20,,
42616,30573-0003,3,0,3,46.62,,
42617,121,0,0,0,194.96,,
42619,CL-MOBI,0,0,0,343.69,,
42620,CLZ-FOB,0,0,0,59.08,,
42621,09-24652-02-CN,2,0,2,14.81,,
42622,09-24652-04-CN,0,0,0,14.81,,
42623,09-24653-02-CN,0,0,0,15.43,,
42624,10-24516-03,0,0,0,165.43,,
42625,10-24727-03,0,0,0,172.84,,
42627,80-47508-01,2,2,0,86.42,,
42628,80-47508-02,0,0,0,81.55,,
42630,10-13373-07,0,0,0,276.54,,
42631,09-701B-1,0,0,0,22.40,,
42632,09-702B-1,1,0,1,23.70,,
42634,09-704BT-1,0,0,0,34.94,,
42636,01604-00,5,0,5,113.58,,
42637,01674-001,3,2,1,113.58,,
42638,02204-00,1,0,1,125.93,,
42639,02274-001,0,0,0,125.93,,
42642,A10-114,1,0,1,156.00,,
42645,ZDIGAIT2000,2,2,0,637.46,,
42648,7420CR,15,9,6,30.12,,
42649,12VPK,9,6,3,13.77,,
42650,6083CR,0,0,0,79.90,,
42653,305CRCN,13,5,8,23.21,,
42655,303SSEL-B,54,29,25,68.15,,
42656,301EL-B,24,15,9,43.93,,
42657,199117,15,11,4,71.12,,
42658,305CRR,8,6,2,24.45,,
42664,153AY,8,5,3,160.45,,
42665,157AY,6,4,2,148.47,,
42668,806-1206-01,0,0,0,360.53,,
42669,806-1210-01,0,0,0,468.50,,
42670,806-1220-01,0,0,0,682.15,,
42673,806-1870,0,0,0,1047.79,,
42674,806-1874,1,1,0,1025.79,,
42690,121A,6,5,1,100.41,,
42693,111A,0,0,0,127.65,,
42696,105SPP,8,3,5,43.80,,
42701,104SPP,6,4,2,39.73,,
42704,6364CRN,1,0,1,70.78,,
42705,6365CRN,42,24,18,63.56,,
42706,12VRC,15,3,12,9.99,,
42710,MILSPAPOWER9,4,4,0,65.00,,
42712,PP4401,0,0,0,269.08,,
42716,2126,0,0,0,45.47,,
42722,2128,16,8,8,28.46,,
42723,2719,8,8,0,21.86,,
42727,4002,0,0,0,5.23,,
42728,4003,5,0,5,5.23,,
42729,5035,12,4,8,28.63,,
42730,5037,5,0,5,26.59,,
42737,2127,28,10,18,29.15,,
42738,2718,17,2,15,26.00,,
42746,395,8,3,5,20.63,,
42747,152,0,0,0,75.00,,
42749,026,0,0,0,209.30,,
42750,025,6,1,5,240.70,,
42775,AP-1100-B-S,0,0,0,204.75,,
42776,AP-1100-B-M,0,0,0,204.75,,
42777,AP-1100-B-L,0,0,0,204.75,,
42778,AP-1100-B-XL,0,0,0,204.75,,
42779,AP-1100-B-XXL,0,0,0,204.75,,
42780,AB-1100-RB-S,0,0,0,210.94,,
42781,AB-1100-RB-M,0,0,0,210.94,,
42782,AB-1100-RB-L,0,0,0,210.94,,
42783,AB-1100-RB-XL,0,0,0,210.94,,
42784,AB-1100-RB-XXL,0,0,0,210.94,,
42785,AB-1100-OG-S,0,0,0,210.94,,
42786,AB-1100-OG-M,0,0,0,210.94,,
42787,AB-1100-OG-L,0,0,0,210.94,,
42788,AB-1100-OG-XL,0,0,0,210.94,,
42789,AB-1100-OG-XXL,0,0,0,210.94,,
42790,AC-1100-RB-S,0,0,0,234.00,,
42791,AC-1100-RB-M,0,0,0,234.00,,
42792,AC-1100-RB-L,1,1,0,234.00,,
42793,AC-1100-RB-XL,0,0,0,234.00,,
42794,AC-1100-RB-XXL,0,0,0,234.00,,
42803,"BP 03511",39,19,20,7.62,10.95,
42805,"CA 03518-6",18,12,6,40.91,54.95,
42807,"LQ 04587",6,0,6,11.15,15.95,
42808,"LQ 04506",0,0,0,18.79,27.95,
42812,"GW 02785",6,1,5,11.15,16.95,
42818,"KG 41501",13,5,8,15.26,23.95,
42832,65000,2,2,0,160.49,,
42845,459M,8,8,0,10.76,,
42846,132,0,0,0,5.58,,
42847,135,0,0,0,16.08,,
42848,136,0,0,0,7.10,,
42895,010-11251-08,0,0,0,19.99,,
42897,010-11251-06,41,20,21,30.00,,
42898,010-11251-05,0,0,0,21.99,,
42905,92856,0,0,0,154.53,,
42925,MRANT12W,50,0,50,7.48,,
42935,815-3012,0,0,0,1747.88,,
42936,27200,69,48,21,6.91,,
42937,27201,30,9,21,9.45,,
42939,27206A,9,2,7,9.72,,
42940,27310G,0,0,0,30.60,,
42942,27410,11,8,3,11.78,,
42943,27420,21,2,19,14.88,,
42944,27430,5,2,3,15.60,,
42945,27440,12,8,4,15.94,,
42950,55120A,95,54,41,11.80,,
42951,55121A,22,10,12,11.80,,
43087,29045-3000,7,3,4,69.38,,
43088,CNV-12-1,2,0,2,77.50,,
43089,37040-0000,7,5,2,52.57,,
43090,90197-0000,27,13,14,17.79,,
43119,63100,46,19,27,72.93,,
43137,HX400IS,242,47,195,280.39,,
43171,9575,0,0,0,1513.16,,
43210,ZDIGAIS100P,3,1,2,262.46,,
43257,RM-10,7,5,2,13.69,,
43258,ME-52,7,6,1,66.61,,
43260,SBC-2,3,2,1,22.44,,
43261,SBC-3,8,3,5,41.19,,
43317,RMX4100,0,0,0,349.08,,
43318,RMX4101,0,0,0,363.62,,
43319,RMX4400,0,0,0,378.17,,
43320,RMX4401,0,0,0,392.72,,
43321,RMX4402,0,0,0,392.72,,
43323,PP4100,0,0,0,225.44,,
43324,PP4101,0,0,0,239.99,,
43325,PP4400,0,0,0,254.53,,
43326,PP5063,0,0,0,399.99,,
43327,PP4402,0,0,0,269.08,,
43332,GP1809,0,0,0,312.72,,
43333,GP2059,0,0,0,327.26,,
43337,GP2058,0,0,0,327.26,,
43338,GP1063,0,0,0,363.62,,
43339,GP2063,0,0,0,363.62,,
43342,GP1049,0,0,0,334.53,,
43343,GP2049,0,0,0,334.53,,
43346,AG27,0,0,0,327.26,,
43347,AG18,0,0,0,322.49,,
43348,AG218,0,0,0,352.49,,
43349,AG227,0,0,0,349.08,,
43353,HL-02,0,0,0,10.88,,
43392,GS-170,2,2,0,802.53,,
43397,P05-06W,4,2,2,32.49,,
43399,P06-06W,3,3,0,40.27,,
43423,96-268-F,18,11,7,25.59,,
43428,A10-104,4,2,2,138.00,,
43433,A10-132T,6,3,3,50.63,,
43434,A10-133T,12,10,2,14.06,,
43435,A10-134T,9,4,5,14.06,,
43436,A10-135T,9,7,2,12.50,,
43437,A10-136T,2,2,0,14.06,,
43438,A10-137T,10,1,9,10.13,,
43441,101070,6,2,4,135.52,,
43443,MRR21,2,2,0,19.99,,
43444,010-11010-20,2,1,1,787.49,,
43463,5104,132,87,45,54.81,,
43474,TBH-4,0,0,0,33.19,,
43475,TBH-10,0,0,0,33.19,,
43493,ER370,6,6,0,63.75,,
43517,B164-12-8G,0,0,0,917.61,,
43522,010-10982-20,14,10,4,243.74,,
43525,010-10982-21,6,6,0,243.74,,
43527,010-10183-22,0,0,0,359.99,,
43531,010-10192-21,8,4,4,142.49,,
43532,P79-8G,2,1,1,140.34,,
43534,010-10272-10,7,3,4,57.91,,
43545,1183-CW,0,0,0,336.67,,
43547,1126-VW,0,0,0,282.80,,
43549,010-10182-21,5,2,3,217.49,,
43550,010-10193-22,3,1,2,511.75,,
43551,010-10194-21,0,0,0,134.99,,
43553,010-10640-20,0,0,0,1119.99,,
43557,010-10703-20,0,0,0,712.49,,
43559,TM260-8G,0,0,0,987.78,,
43642,FI5002,3,3,0,190.91,,
43643,804-1260-02,5,3,2,544.27,,
43644,815-2012,12,5,7,1493.12,,
43645,809-0921,0,0,0,189.05,,
43646,H1170A,2,1,1,25.41,,
43647,H1179,6,5,1,6.42,,
43648,T1127,22,12,10,1.56,,
43650,TPA129,1,1,0,94.78,,
43651,TPA189,2,2,0,105.61,,
43652,TPA249,4,2,2,116.44,,
43653,TPA1212,3,1,2,107.06,,
43654,TPA1812,0,0,0,124.61,,
43655,TPA2412,0,0,0,127.28,,
43733,804-2410,4,0,4,304.61,,
43734,804-2420,3,3,0,383.91,,
43737,815-3024,2,1,1,1843.74,,
43802,36252,0,0,0,38.89,,
43803,10-13407-08,0,0,0,172.84,,
43804,64534-24,0,0,0,234.57,,
43805,09-10616,8,5,3,22.22,,
43807,10-13329-104,0,0,0,225.65,,
43857,66318-7,8,1,7,25.23,,
43858,66319R7,6,4,2,26.33,,
43859,66319G7,12,5,7,26.33,,
43869,5110-30-7,10,9,1,17.99,,
43870,5110-36-7,10,6,4,22.61,,
43871,5110-42-7,4,0,4,20.99,,
43873,7100A7,7,2,5,31.48,,
43874,7100B7,4,3,1,35.87,,
43875,7100C7,11,8,3,36.95,,
43885,91022-7,7,4,3,10.84,,
43894,6556-7,6,2,4,48.04,,
43895,6356D7,11,6,5,16.45,,
43897,11940-2,21,15,6,13.59,,
43900,11437-7,7,3,4,20.63,,
43901,11438-7,14,9,5,22.67,,
43905,4730-4,8,5,3,84.19,,
43906,4760-4,10,5,5,94.08,,
43908,4608-7,44,30,14,24.99,,
43909,4612-7,366,113,253,19.99,,
43913,4801-7,5,3,2,30.06,,
43914,4202-7,6,5,1,20.46,,
43915,4201-7,6,2,4,22.13,,
43916,4141-4,3,3,0,94.44,,
43917,4143-4,9,4,5,102.17,,
43918,4140-4,20,12,8,37.42,,
43920,7615A3,7,3,4,15.71,,
43923,1733-4,32,22,10,21.57,,
43925,1749-4,0,0,0,24.69,,
43945,M2-TD02,3,1,2,174.99,266.40,
43952,S2-2112,1,0,1,419.99,,
43953,S2-3108,0,0,0,464.64,,
43954,S2-4109,1,0,1,474.99,,
44028,2897.91,0,0,0,108.97,,
44029,2898.91,0,0,0,108.97,,
44030,A53D,3,1,2,187.49,,
44069,A62360,1,0,1,63.91,,
44187,010-11613-00,6,5,1,52.49,,
44191,6007200,69,56,13,29.29,,
44192,6006200,18,7,11,21.96,,
44201,3153,17,6,11,9.50,,14.47
44216,758NUT,10,5,5,22.17,,
44217,702NUT,6,2,4,22.57,,
44224,BM-2,1,1,0,162.51,,
44225,CL-NCS,0,0,0,116.62,,
44299,OT-0542BKA15-HD,4,2,2,616.05,,
44300,SPD-4XI-W,0,0,0,415.69,,
44301,010-11680-00,0,0,0,11.24,,
44311,BHW100,4,2,2,48.80,,
44316,OCTAF1012LAM7,0,0,0,1561.47,,
44317,OCTAF1012LAR7,0,0,0,1561.47,,
44318,OCTAF1212LAM12,0,0,0,1758.79,,
44319,OCTAF1212LAR12,0,0,0,1758.79,,
44321,OCTAFMDMSW,0,0,0,789.03,,
44357,OCTAFMDTPW,0,0,0,876.80,,
44358,OC17SUK03,1,1,0,156.15,,
44359,OC15SUK07,3,2,1,36.04,,
44360,OC15SUK08,2,2,0,58.34,,
44362,OC15SUK16,1,1,0,59.60,,
44364,OCTAFMDRESYSA,0,0,0,1071.58,,
44365,OCTAFMDRESYSB,0,0,0,1071.58,,
44368,OC15109-9,0,0,0,132.98,,
44372,OC15SUK27B,1,1,0,205.05,,
44373,OC15SUK27D,0,0,0,205.05,,
44374,OC15SUK27E,0,0,0,209.79,,
44375,OC15SUK83,0,0,0,179.31,,
44387,51494,0,0,0,298.46,,439.00
44396,4411,0,0,0,170.48,,229.00
44397,4421,4,1,3,179.96,,239.00
44398,4422,2,0,2,179.84,,239.00
44404,109,0,0,0,26.96,,
44461,101033,9,4,5,30.83,,
44462,101034,6,1,5,30.83,,
44463,101035,0,0,0,30.83,,
44464,112500,15,6,9,73.08,,
44465,112501,0,0,0,79.61,,
44466,112502,0,0,0,79.61,,
44467,112503,16,6,10,41.40,,
44468,112508,5,5,0,73.08,,
44469,112520,18,6,12,73.08,,
44470,112521,10,8,2,79.61,,
44471,112522,0,0,0,79.61,,
44472,112523,19,10,9,41.40,,
44473,112800,11,0,11,73.68,,
44474,112801,0,0,0,86.99,,
44475,112802,0,0,0,80.90,,
44477,112808,0,0,0,73.68,,
44478,112820,6,0,6,73.68,,
44479,112821,0,0,0,80.90,,
44481,112823,0,0,0,42.26,,
44482,112828,4,0,4,73.68,,
44483,101073,52,27,25,7.15,,
44497,001-156-750,0,0,0,31.82,,
44578,1466,6,2,4,21.88,,
44583,MS-CLADAP,16,16,0,18.13,,
44600,B50ASSY,0,0,0,241.77,337.45,
44601,BF50,0,0,0,98.05,136.85,
44602,BM50S,0,0,0,143.72,200.60,
44604,010-11394-00,0,0,0,258.99,,
44609,SPH-4XI-W,0,0,0,393.19,,
44628,6077C,0,0,0,18.04,,
44629,6177C,0,0,0,20.81,,
44630,6014C,0,0,0,23.03,,
44631,6114C,0,0,0,22.59,,
44632,6040C,0,0,0,16.31,,
44633,6140C,0,0,0,17.79,,
44634,6039C,0,0,0,16.31,,
44635,6139C,0,0,0,17.79,,
44636,6078C,0,0,0,18.04,,
44637,6178C,0,0,0,20.81,,
44638,6015C,0,0,0,23.03,,
44639,6115C,0,0,0,22.59,,
44640,6042C,0,0,0,16.31,,
44641,6142C,0,0,0,17.79,,
44642,6041C,0,0,0,16.31,,
44643,6141C,0,0,0,17.79,,
44644,6194,0,0,0,17.35,,
44645,6195,4,0,4,17.35,,
44646,6043C,0,0,0,15.48,,
44647,6143C,0,0,0,17.56,,
44649,6076C,0,0,0,16.65,,
44650,6176C,0,0,0,18.88,,
44651,6192,3,0,3,19.99,,
44652,6249C,0,0,0,3.68,,
44655,6093C,0,0,0,16.24,,
44656,6193C,0,0,0,17.61,,
44657,6044C,0,0,0,18.87,,
44658,6045C,0,0,0,18.87,,
44659,6144C,0,0,0,20.43,,
44660,6145C,0,0,0,20.43,,
44661,6046C,0,0,0,23.40,,
44662,6146C,0,0,0,25.92,,
44663,6051C,0,0,0,32.25,,
44664,6086,0,0,0,31.03,,
44666,6151,0,0,0,39.96,,
44670,527ID-IHN,0,0,0,888.89,,
44679,440,6,5,1,25.00,,
44684,001-122-790,0,0,0,190.91,,
44687,A62361,9,0,9,79.16,,
44688,A80005,9,3,6,94.73,,
44689,A62362,6,1,5,129.16,,
44690,A80006,1,0,1,166.66,,
44691,A80007,12,5,7,285.32,,
44698,ZDIGSPL2000,2,1,1,299.96,,
44708,740087-1,6,2,4,20.69,,
44717,MDA-1,5,2,3,629.30,,
44718,MDA-2,4,2,2,293.30,,
44719,MDA-3,8,4,4,279.30,,
44722,E22158,10,1,9,99.99,,
44738,808-9002,7,4,3,18.68,,
44742,27760,22,1,21,156.42,,
44753,580-0200-7,3,0,3,119.87,,
44757,40631,4,1,3,52.55,,
44758,40621,5,4,1,12.20,,
44767,1016,25,6,19,18.52,,
44780,A80010,1,1,0,1479.61,,
44786,K00-00118-01,81,81,0,11.76,,
44791,806-1851,0,0,0,1397.98,,
44809,101102,4,4,0,122.86,,
44810,101103,3,3,0,122.86,,
44811,101099,11,6,5,122.07,,
44812,101100,6,2,4,122.07,,
44841,010-11654-07,1,1,0,29.98,,
44846,5215-AIS,13,5,8,59.57,,
44847,100-329-371,0,0,0,13.64,,
44862,R001441,3,2,1,66.55,,
44866,MMW-IE,1,1,0,738.60,,
44867,MMW-IIE,0,0,0,865.20,,
44868,MMW-IIIE,0,0,0,948.60,,
44869,SE-100,0,0,0,303.39,,
44870,SE-142,0,0,0,529.97,,
44871,SE-162,0,0,0,568.66,,
44872,81-2010-12,19,9,10,1066.27,,
44873,81-2530-12,10,7,3,1366.94,,
44874,A18127,1,0,1,349.99,,
44875,EOS-II-BK,6,6,0,48.28,,
44876,A80151,1,0,1,68.17,,
44877,QUAD-II-BK,0,0,0,40.09,56.99,
44885,QUAD-BK,4,1,3,29.26,,
44913,EF-2-NY,2,2,0,13.50,18.99,
44938,E70010,20,3,17,236.40,,
44940,PX0852,0,0,0,6.00,,
44955,72-0177,0,0,0,29.82,,
44963,92415,6,3,3,20.40,,
44964,CL-CTC,1,1,0,186.69,,
44977,37064-0000,5,2,3,152.43,,
44990,WX1-005-014,0,0,0,50.00,,
44995,010-11838-00,26,9,17,13.74,,
45006,500187,2,0,2,318.84,,
45007,500188,0,0,0,318.84,,
45011,1012,10,5,5,20.52,,
45013,1014,10,4,6,3.16,,
45019,67510,2,1,1,128.25,,
45052,HDPB230101,0,0,0,112.50,,
45053,HDPB330101,0,0,0,132.81,,
45055,HDPB350101,0,0,0,175.32,,
45056,001-500594,1,1,0,196.74,,
45057,001-500596,1,0,1,1184.78,,
45059,FW16000101,4,2,2,150.91,,
45079,STC1000101,0,0,0,44.00,,
45080,"ETC 0101",0,0,0,12.80,,
45081,"ETCLB 0700",0,0,0,19.69,,
45082,CR8008,1,1,0,24.01,,
45083,CR8012,9,7,2,32.00,,
45084,000-159-704,0,0,0,72.73,,
45100,PG700,1,1,0,643.95,,
45104,"GB 04985",0,0,0,11.15,15.95,
45105,"TA 04885",7,6,1,11.15,15.95,
45106,"TA 04806",10,6,4,18.79,27.95,
45108,"MX 32806",7,5,2,10.40,16.95,
45125,010-11832-00,0,0,0,15.99,,
45126,1152,0,0,0,5.11,,
45136,010-11843-00,6,2,4,15.99,,
45137,010-11843-02,0,0,0,15.99,,
45138,010-11843-01,0,0,0,39.99,,
45139,A80014,0,0,0,741.84,,
45143,INFPRV250,0,0,0,172.85,259.95,
45146,INFMPK250,2,1,1,271.77,379.95,
45183,127,4,4,0,136.76,,
45205,T49896,8,8,0,33.86,,
45230,010-11454-00,0,0,0,32.89,,
45231,OC17SUK34,1,0,1,279.30,,
45232,20330008,0,0,0,490.00,,
45234,10080035,2,0,2,525.00,,
45235,10080038,0,0,0,630.00,,
45239,30110004,0,0,0,31.47,,
45257,9972208B,3,2,1,82.08,,
45258,9982304B,0,0,0,75.63,,
45259,9982316B,8,4,4,48.40,,
45260,9973410B,9,6,3,400.75,,
45286,9960008B,0,0,0,59.60,,
45287,9960009B,0,0,0,79.51,,
45288,9960010B,10,8,2,22.03,,
45289,9960011B,0,0,0,57.81,,
45290,9960014B,0,0,0,46.25,,
45291,9960016B,4,2,2,80.61,,
45292,9960017B,1,0,1,53.18,,
45293,9960018B,2,2,0,67.09,,
45294,9960022B,0,0,0,68.73,,
45303,9960021B,2,0,2,27.36,,
45304,9960023B,4,2,2,91.19,,
45414,A80159,1,0,1,108.32,,
45440,Z83120,10,2,8,121.99,229.99,
45452,TPOM120,0,0,0,76.67,,
45453,TPOM80,0,0,0,71.61,,
45459,10400G,22,5,17,17.07,,
45460,10401G,9,3,6,19.31,,
45461,10403G,18,5,13,28.33,,
45462,10404G,30,14,16,32.43,,
45463,10405G,9,6,3,38.23,,
45466,10455G,38,3,35,41.85,,
45470,16681A,10,5,5,19.70,,
45471,16691A,20,13,7,4.50,,
45472,27481,35,10,25,16.42,,
45473,32420A,17,17,0,6.38,,
45475,010-11829-00,13,2,11,185.49,,264.99
45476,010-11829-01,8,6,2,23.09,,
45477,010-11829-02,12,10,2,41.99,,
45479,010-11092-30,15,9,6,22.49,,
45481,010-11814-02,0,0,0,13.74,,
45498,000-011-704,0,0,0,654.55,,
45533,2827,2,1,1,514.48,,
45534,2828,0,0,0,637.26,,
45535,TB-01,2,1,1,314.44,,
45536,TP-01,0,0,0,438.19,,
45537,RA-01,3,2,1,57.94,,
45538,SPH-8-W,0,0,0,306.53,,
45539,SPH-12-W,0,0,0,346.76,,
45540,SPD-7-W,0,0,0,322.41,,
45541,SPD-8-W,0,0,0,354.18,,
45542,SPD-12-W,0,0,0,375.35,,
45596,010-11785-00,12,12,0,15.07,,
45597,QCM-CG1-QCF-01,0,0,0,33.20,,
45600,PAD4000.4,11,5,6,313.63,,
45601,PAD5000.5,1,0,1,396.31,,
45612,R001501,0,0,0,67.54,,
45670,899890,4,4,0,35.21,,
45674,12,37,16,21,136.96,,
45684,46DR,4,0,4,35.67,,
45687,ID20,11,6,5,69.56,,
45723,0615DP2STS,2,1,1,83.78,,
45726,0616DP2STS,0,0,0,150.63,,
45792,F16-0150-F,4,2,2,467.41,,
45795,F16-0212-F,0,0,0,240.90,,
45815,GSC-0025-1,3,1,2,96.46,,
45844,RK-0002PB,2,2,0,143.69,,
45850,RK-0001SB,5,3,2,70.67,,
45855,RK-0001PCB,1,1,0,59.35,,
45868,COK-0008B-1,12,10,2,15.64,,
45874,PX0837/5M00,0,0,0,115.20,,
45915,F16-2700-1,1,1,0,51.38,,
45916,F16-2751-1,4,2,2,107.09,,
45917,F16-2753-1,0,0,0,167.06,,
45918,F16-2752-1,3,1,2,210.29,,
45920,F31-3003BSA-1,2,0,2,154.35,,
45921,F31-3004BSA-1,2,0,2,217.45,,
45923,P03-063W,2,2,0,42.22,,
45924,P03-064B,4,3,1,61.86,,
45925,P03-064W,0,0,0,53.04,,
45927,P03-074W,2,2,0,57.46,,
45928,P03-132W,3,2,1,41.14,,
45929,P03-133W,5,3,2,44.49,,
45930,P03-134W,3,1,2,50.33,,
45932,P01-2120W,24,12,12,109.99,,
45933,P01-2132W,7,1,6,124.99,,
45935,P01-2000W,3,3,0,70.04,,
45938,P01-1000W,1,1,0,31.67,,
45940,P01-1200W,2,2,0,12.14,,
45946,461,13,8,5,106.25,,
45947,460,11,4,7,118.75,,
45948,462,17,5,12,62.50,,
45951,1551,19,10,9,18.75,,
45958,4372,0,0,0,46.88,,
45959,151,2,0,2,25.00,,
45960,385,54,11,43,21.88,,
45961,3120,17,13,4,28.13,,
45962,3101,8,4,4,15.63,,
45963,3150,9,4,5,43.75,,
45964,3151,4,2,2,25.00,,
45965,3200,3,3,0,25.00,,
45966,1705,0,0,0,31.25,,
45967,3155,9,3,6,7.71,,
45968,1310,7,3,4,28.13,,
45974,2027,11,11,0,47.99,,
45976,447,0,0,0,79.28,,
45977,453,0,0,0,17.13,,
45978,455,6,1,5,17.88,,
45980,438,4,0,4,12.48,,
45981,414,0,0,0,3.48,,
45982,415,14,14,0,3.54,,
45983,2500,12,4,8,447.27,,
45995,42009G,7,5,2,1024.78,,
45996,42010R,5,2,3,1071.72,,
45997,42011T,3,2,1,1270.26,,
45998,42012V,4,2,2,1334.29,,
45999,42017F,3,1,2,436.37,,
46000,42018H,4,2,2,366.05,,
46001,42023A,9,4,5,394.77,,
46002,42026G,6,2,4,244.46,,
46003,42027J,8,4,4,912.04,,
46004,42028L,4,1,3,27.74,,
46005,42029N,4,2,2,44.54,,
46006,42052H,8,6,2,23.05,,
46007,42053K,5,1,4,30.49,,
46008,42056S,9,4,5,27.19,,
46009,42060G,8,2,6,27.19,,
46010,71021K,7,2,5,81.67,,
46011,73639T,9,4,5,31.68,,
46012,EM11,3,1,2,2869.25,,
46013,EM12,2,1,1,3934.72,,
46014,EM21,2,1,1,4393.21,,
46015,EM22,1,1,0,5639.73,,
46016,EE11,3,1,2,2397.32,,
46017,EE12,2,1,1,4223.07,,
46018,EE21,2,1,1,2702.80,,
46019,EE22,1,1,0,4004.65,,
46020,MM11,3,1,2,3647.06,,
46021,MM12,2,1,1,4712.53,,
46022,MM21,2,1,1,5801.51,,
46023,MM22,1,1,0,7055.22,,
46024,MM11T,3,1,2,3692.27,,
46025,MM12T,2,1,1,4802.94,,
46026,MM21T,2,1,1,5801.48,,
46028,ME11,3,1,2,3167.98,,
46029,ME12,2,1,1,4233.44,,
46030,ME21,2,1,1,4413.65,,
46031,ME22,1,1,0,5667.38,,
46032,P1096500AJ,0,0,0,140.34,,
46033,P1096600AJ,1,1,0,180.14,,
46046,E70066,2,0,2,216.02,,
46047,E70145,3,2,1,339.46,,
46049,E70064,0,0,0,191.57,,
46050,E70142,0,0,0,252.71,,
46051,E70143,1,1,0,259.15,,
46054,E70058,1,1,0,407.60,,
46055,E70147,0,0,0,378.94,,
46056,E70060,2,0,2,448.36,,
46057,E70149,3,3,0,611.83,,
46058,E70059,4,1,3,407.60,,
46059,E70148,0,0,0,394.73,,
46060,E70061,6,3,3,434.20,,
46062,E70150,5,2,3,789.46,,
46083,LTB-SF,2,1,1,399.99,,
46087,P7188500AJ,0,0,0,39.78,,
46090,P7188800AJ,4,3,1,50.24,,
46146,1901140,12,3,9,399.49,,
46147,1901130,0,0,0,284.08,,
46148,1901120,5,2,3,233.94,,
46149,1901020,26,23,3,192.17,,
46165,1810302,1,1,0,327.57,,
46166,1810303,1,0,1,327.57,,
46195,710236-1,5,0,5,71.42,,
46204,408920-1,10,10,0,111.99,,
46205,408400-1,10,1,9,153.99,,
46224,1866460,0,0,0,23.24,,
46261,SLT6,61,14,47,96.56,,
46262,SLT10,68,33,35,108.63,,
46264,A06074,3,0,3,25.56,,
46267,010-11029-04,6,0,6,10.99,,
46269,010-11251-18,6,3,3,21.99,,
46272,305CRMB,17,9,8,18.95,,
46276,3034-F,0,0,0,207.43,,
46277,3036-F,0,0,0,273.69,,
46284,010-11483-00,12,0,12,14.01,,
46285,010-11482-01,0,0,0,30.80,,
46292,101134,0,0,0,471.49,,
46295,3201,7,7,0,6.11,,8.98
46296,3202,3,3,0,6.11,,8.98
46297,3203,0,0,0,6.11,,8.98
46298,101135,2,0,2,493.42,,
46299,101133,2,2,0,349.99,,
46300,3205,8,2,6,15.07,,21.98
46301,3206,1,0,1,15.07,,21.98
46302,3207,15,8,7,15.07,,21.98
46316,101137,0,0,0,81.65,,
46317,101138,6,2,4,87.93,,
46318,101139,0,0,0,87.93,,
46319,109PC,10,5,5,36.57,,
46320,118PF,17,9,8,27.33,,
46321,124PF,10,1,9,32.69,,
46322,124PF6,6,4,2,34.99,,
46323,136PF,6,6,0,39.07,,
46324,136PF6,0,0,0,48.41,,
46325,136PF9,2,0,2,51.99,,
46326,101097,5,0,5,91.65,,
46327,101098,0,0,0,91.65,,
46329,101147,0,0,0,146.70,,
46330,101148,0,0,0,146.70,,
46331,101144,6,3,3,16.35,,
46332,101145,20,14,6,16.35,,
46333,101146,5,3,2,16.35,,
46334,216PC,10,10,0,35.19,,
46335,224PF,0,0,0,29.70,,
46336,230PF,0,0,0,33.36,,
46337,315FP4,0,0,0,61.83,,
46338,315FP6,0,0,0,69.81,,
46339,318P,0,0,0,25.15,,
46340,318P1/FPS3R,9,1,8,28.99,,
46342,111809,3,0,3,109.99,,
46343,519CG#3,0,0,0,405.88,,
46344,111808,2,0,2,130.93,,
46345,111810,0,0,0,127.54,,
46346,111828,0,0,0,128.13,,
46347,524C,0,0,0,271.73,,
46348,954DP2,0,0,0,171.50,,
46350,1174-BUCKET,2,2,0,163.33,,
46351,1177-BUCKET,0,0,0,178.74,,
46387,FPS-3R,0,0,0,10.63,,
46390,FVR1-3/4,0,0,0,17.22,,
46392,FPH-1-1/4-4,0,0,0,36.94,,
46394,FPH-1-1/4-6,0,0,0,43.10,,
46411,DP10-B,15,5,10,4.23,,
46412,DP10-W,8,6,2,3.00,,
46416,DP40-N,12,7,5,14.19,,
46417,DP40-B,16,8,8,14.19,,
46418,DP40-W,22,15,7,14.19,,
46419,DP40-B-C,13,12,1,17.83,,
46420,DP40-N-C,0,0,0,17.83,,
46421,DP40-W-C,0,0,0,18.35,,
46423,DP60-B,17,10,7,20.60,,
46424,DP60-N,3,2,1,16.49,,
46425,DP60-W,15,9,6,20.60,,
46426,DP60-B-C,11,2,9,24.72,,
46428,DP60-W-C,17,13,4,24.72,,
46429,DP62-B,5,5,0,20.60,,
46431,DP62-W,8,7,1,20.01,,
46433,DP80-N,3,0,3,21.99,,
46434,DP80-W,14,4,10,24.99,,
46435,DP80-B-C,0,0,0,34.70,,
46436,DP80-N-C,0,0,0,34.70,,
46437,DP80-W-C,7,0,7,34.70,,
46438,DP50-B,17,9,8,16.22,,
46440,DP50-W,17,8,9,16.22,,
46441,DP40BB,0,0,0,36.11,,
46442,DP40BW,0,0,0,37.18,,
46443,DP60BB,0,0,0,43.25,,
46444,DP60BW,1,0,1,34.99,,
46445,DP50BB,0,0,0,36.69,,
46446,DP50BN,0,0,0,35.64,,
46447,DP50BW,0,0,0,36.69,,
46449,DP61-W,0,0,0,21.68,,
46450,DP61-W-C,5,3,2,17.99,,
46451,DP63-N,2,2,0,21.06,,
46452,DP63-W,12,10,2,21.06,,
46453,DP81-W,13,3,10,23.99,,
46455,DP81-N-C,0,0,0,37.91,,
46457,DP83-N,7,3,4,33.90,,
46458,DP83-W,9,3,6,33.90,,
46459,HH-4,0,0,0,52.32,,
46460,HH-6B,0,0,0,15.43,,
46461,HH-6,12,4,8,15.43,,
46462,HH-61B,5,0,5,20.06,,
46463,HH-61,7,3,4,20.06,,
46464,HH-81B,5,0,5,9.99,,
46465,HH-81,18,9,9,17.38,,
46466,HH-8B,6,0,6,13.49,,
46467,HH-8,7,7,0,19.24,,
46468,HH-2,4,3,1,23.93,,
46469,HH-3,20,10,10,26.40,,
46471,305CRPN,48,24,24,12.95,,
46474,F111640,4,4,0,50.72,,
46482,AB-1100-HV-S,0,0,0,210.94,,
46483,AB-1100-HV-M,0,0,0,210.94,,
46484,AB-1100-HV-L,0,0,0,210.94,,
46485,AB-1100-HV-XL,0,0,0,210.94,,
46486,AB-1100-HV-XXL,0,0,0,210.94,,
46487,AC-1100-HV-S,0,0,0,234.00,,
46488,AC-1100-HV-M,0,0,0,234.00,,
46489,AC-1100-HV-L,0,0,0,234.00,,
46490,AC-1100-HV-XL,0,0,0,234.00,,
46491,AC-1100-HV-XXL,0,0,0,234.00,,
46492,438-BUCKET,0,0,0,293.73,,
46494,AS-1100-RB-S,0,0,0,409.50,,
46495,AS-1100-RB-M,0,0,0,409.50,,
46496,AS-1100-RB-L,0,0,0,409.50,,
46497,AS-1100-RB-XL,0,0,0,409.50,,
46498,AS-1100-RB-XXL,0,0,0,409.50,,
46499,AS-1100-HV-S,0,0,0,409.50,,
46500,AS-1100-HV-M,0,0,0,409.50,,
46502,AS-1100-HV-L,0,0,0,409.50,,
46503,AS-1100-HV-XL,0,0,0,409.50,,
46505,AS-1100-HV-XXL,0,0,0,409.50,,
46518,A80013,0,0,0,1442.92,,
46519,001-112-970,0,0,0,100.00,,
46525,SPM-3I-W,0,0,0,381.94,,
46526,"ROGUE WAVE",2,1,1,322.99,,
46527,"ROGUE PRO",0,0,0,477.47,,
46536,HH,7,3,4,44.80,,
46552,112809,0,0,0,73.68,,
46553,112829,0,0,0,76.69,,
46554,"PDK 25503",44,17,27,123.43,179.95,
46555,113190,4,3,1,73.12,,
46556,113191,0,0,0,94.31,,
46557,113192,0,0,0,94.31,,
46558,113193,0,0,0,36.86,,
46559,113198,32,12,20,73.12,,
46560,113199,11,3,8,73.12,,
46561,113110,9,3,6,73.12,,
46562,113111,10,4,6,94.31,,
46563,113112,0,0,0,94.31,,
46564,113113,16,3,13,36.86,,
46565,113118,10,5,5,73.12,,
46566,113119,35,6,29,73.12,,
46567,113120,11,4,7,73.12,,
46568,113121,17,13,4,94.31,,
46569,113122,0,0,0,97.33,,
46570,113123,15,0,15,36.86,,
46571,113128,24,8,16,73.12,,
46572,113129,2,2,0,73.12,,
46573,MN2KKIT,2,2,0,116.40,,
46574,T70134,1,1,0,99.99,,
46626,"41 483",0,0,0,90.88,,
46644,"81 501",0,0,0,110.68,,
46676,010-C1066-00,19,10,9,262.49,,
46686,010-10911-00,0,0,0,7.00,,
46694,TPAM80,2,1,1,102.72,,
46695,TPAM120,2,1,1,107.78,,
46696,USB-57B,14,10,4,21.41,,
46710,010-11029-03,0,0,0,10.99,,
46747,MS-OS420,17,0,17,46.23,,
46823,21501530,6,2,4,92.14,,
46824,21501540,0,0,0,92.14,,
46830,WN3604,2,2,0,146.55,179.00,
46831,WT3604,2,0,2,202.59,209.00,
46832,WN3702,0,0,0,136.37,169.00,
46833,WT3702,1,1,0,153.69,219.00,
46834,WN3503,1,1,0,99.90,129.00,
46835,WT3503,1,1,0,140.33,149.00,
46838,WN3506,0,0,0,34.48,39.95,
46839,WL3506,0,0,0,36.44,54.95,
46840,WT3507,0,0,0,57.05,79.95,
46844,WNAC04,0,0,0,6.51,,
46845,PT3500,0,0,0,6.32,,
46846,PT3600,0,0,0,6.18,,
46847,PT3700,0,0,0,10.39,,
46857,1104,0,0,0,7.23,,
46858,1105,0,0,0,12.19,,
46859,1107,0,0,0,19.69,22.95,
46862,1132,0,0,0,130.31,169.00,
46863,1134,1,1,0,91.98,99.95,
46865,1139,0,0,0,49.01,74.95,
46875,1501,0,0,0,13.93,,
46877,1509,2,2,0,40.42,49.95,
46879,1523,0,0,0,18.37,,
46880,1524,0,0,0,22.04,,
46881,1526,0,0,0,41.35,59.95,
46882,1528,2,2,0,43.77,69.95,
46884,1529,0,0,0,32.89,49.95,
46885,1530,0,0,0,65.33,69.95,
46886,1533,0,0,0,26.15,44.95,
46887,1534,0,0,0,33.64,59.95,
46888,1535,0,0,0,45.97,69.95,
46889,1537,1,1,0,44.89,69.95,
46890,1539,0,0,0,66.38,89.95,
46902,1025,0,0,0,18.81,,
46903,1027,0,0,0,12.89,,
46904,1030,0,0,0,12.89,,
46905,1020,0,0,0,11.95,,
46906,1035,0,0,0,24.12,,
46907,1005,0,0,0,7.34,,
46908,1010,0,0,0,11.04,,
46912,L234,0,0,0,63.52,74.95,
46913,L230,0,0,0,54.70,64.95,
46932,CT-99,3,2,1,17.65,,
46956,T10-485,0,0,0,16.88,,
46957,18555000A,15,9,6,247.93,,
46958,18550000A,6,2,4,195.99,,
46959,04406043A,0,0,0,164.60,,
46960,04406143A,32,11,21,107.79,,
46963,M000612,3,0,3,341.60,,
46964,LEMHTA400-S,1,1,0,134.40,,
46965,LEMHTA600-S,0,0,0,163.20,,
46966,NG1-100C,0,0,0,605.20,,
46967,NB1-100C,0,0,0,605.20,,
46968,NF-NF,6,3,3,35.28,,
46969,NM-CF,3,1,2,35.52,,
46970,NM-NM,9,6,3,35.28,,
46971,NM4P-05,2,2,0,42.40,,
46973,61126,1,1,0,17.91,,
46974,66302,0,0,0,35.80,,
46975,66402,2,2,0,37.04,,
46976,48503,7,4,3,35.80,,
46985,EX-1,0,0,0,141.09,,
46987,DM-DG1-DF-00.5,2,0,2,23.92,,
46988,48703,3,1,2,38.27,,
46989,DM-DG1-DF-01.0,2,0,2,24.24,,
46990,DM-DG1-DF-02.0,0,0,0,26.56,,
46991,DM-DG1-DF-03.0,2,2,0,29.92,,
46992,DM-DG1-DF-04.0,0,0,0,33.36,,
46993,DM-DG1-DF-05.0,0,0,0,34.40,,
46994,48903,6,3,3,41.48,,
46995,48103,0,0,0,42.79,,
46996,DM-DG1-DF-06.0,0,0,0,36.80,,
46997,DM-DG1-DF-07.0,0,0,0,35.04,,
46998,DM-DG1-DF-08.0,0,0,0,41.84,,
47000,28503,13,12,1,35.80,,
47001,DM-DG1-DF-10.0,0,0,0,48.24,,
47002,38503,0,0,0,35.80,,
47003,DM-DB1-DF-00.5,2,2,0,24.08,,
47004,28703,13,13,0,38.89,,
47005,38703,4,3,1,38.89,,
47006,28103-00,2,0,2,41.48,,
47007,38103,4,2,2,41.48,,
47008,16004B,1,0,1,133.33,,
47010,DM-DB1-DF-01.0,0,0,0,24.96,,
47011,60000,1,0,1,69.14,,
47012,DM-DB1-DF-02.0,3,2,1,26.88,,
47013,DM-DB1-DF-03.0,3,2,1,29.76,,
47014,DM-DB1-DF-04.0,1,1,0,31.52,,
47015,DM-DB1-DF-05.0,5,2,3,34.48,,
47016,DM-DB1-DF-06.0,2,2,0,36.88,,
47017,34014,0,0,0,118.52,,
47018,DM-DB1-DF-08.0,0,0,0,41.92,,
47019,34024,0,0,0,96.30,,
47021,DM-DB1-DF-10.0,1,1,0,48.24,,
47023,DG1-100C,1,1,0,402.64,,
47024,DB1-100C,0,0,0,412.24,,
47025,CP-WH-ALM-100,0,0,0,13.76,,
47026,CP-BK-ALM100,0,0,0,16.40,,
47034,OC15109-6,0,0,0,124.40,,
47037,2606,0,0,0,66.23,,
47038,2612,0,0,0,75.98,,
47057,MC0075-1017,0,0,0,52.88,,
47058,MC0075-1034,0,0,0,52.88,,
47059,MC0075-1054,0,0,0,52.88,,
47060,PTM-R1-2,0,0,0,1361.25,,
47061,SPH-3I-W,0,0,0,246.94,,
47065,FP900UW00000A00,37,37,0,21.79,,
47066,FP900DW00000A00,28,28,0,21.79,,
47068,RC121012V,2,1,1,2650.40,3887.00,
47069,RC1210CAP12V,0,0,0,2888.47,4092.00,
47074,MR1308UAB,14,6,8,48.33,,
47078,S30-15,38,23,15,31.90,,
47102,MILBTREC,0,0,0,27.23,,
47103,240-15NM,0,0,0,67.39,,
47106,FR-2000-R,3,2,1,277.78,,
47428,432-0010-01-00,0,0,0,4591.66,,
47429,432-0010-03-00,0,0,0,5541.66,,
47434,IF-NMEA2K2,2,0,2,290.91,,
47441,302,0,0,0,25.57,29.95,
47442,301,1,1,0,12.45,,
47443,MSX65R,10,3,7,72.34,,
47453,E2500,0,0,0,148.80,,
47454,MARE-004-1M-7,2,1,1,52.00,,
47455,VS-07.OHG,0,0,0,69.60,,
47456,MS-1035,0,0,0,6.16,,
47457,MS-1085-N,2,1,1,13.52,,
47459,MS-1075,0,0,0,3.04,,
47493,PST12EX,3,1,2,1994.19,,
47523,7504,8,3,5,59.65,,
47524,7509,3,1,2,68.29,,
47525,7601,9,5,4,57.58,,
47526,7611,2,0,2,83.13,,
47527,7649,4,4,0,91.32,,
47613,FNB-125,18,15,3,23.86,,
47616,CLIP-24,6,2,4,5.65,,
47661,010-11251-15,0,0,0,31.99,,
47663,124750,2,2,0,131.67,,
47664,311599,4,2,2,27.78,,
47665,311699,6,2,4,27.78,,
47667,S2-6110,1,0,1,1199.99,,
47669,59401,5,2,3,188.20,,
47709,5608,0,0,0,84.70,99.95,
47710,2602,0,0,0,61.52,79.95,
47711,5508,0,0,0,37.90,,
47712,361,0,0,0,22.49,29.95,
47713,367,0,0,0,21.99,29.95,
47714,375,0,0,0,37.06,42.95,
47781,HC1100,58,23,35,7.06,,
47782,HC1600,27,10,17,7.06,,
47809,010-11425-04,6,3,3,27.99,,
47823,RH-1,0,0,0,26.25,,
47824,MB30-RLY,0,0,0,26.25,,
47825,ES-3000-01,0,0,0,281.25,,
47839,P104330,1,0,1,169.20,,
47840,P104331,1,1,0,345.00,,
47841,P104332,0,0,0,81.60,,
47842,P104333,0,0,0,96.00,,
47844,P104345,1,0,1,170.25,,
47845,P104340,0,0,0,192.00,,
47846,P104372,0,0,0,224.25,,
47847,P104373,0,0,0,313.50,,
47848,P104335,0,0,0,67.80,,
47849,010-10106-20,0,0,0,142.49,,
47850,010-10249-40,0,0,0,55.99,,
47853,010-10218-21,3,0,3,125.99,,
47854,010-10218-22,5,0,5,125.99,,
47855,010-10217-21,0,0,0,164.99,,
47856,010-10217-22,2,0,2,164.99,,
47857,010-11937-20,0,0,0,824.99,,
47863,010-11937-22,0,0,0,824.99,,
47864,010-11939-20,0,0,0,899.99,,
47865,010-11939-21,1,0,1,899.99,,
47866,010-11939-22,5,1,4,899.99,,
47867,010-11938-20,1,0,1,1124.99,,
47868,010-11938-21,2,1,1,1124.99,,
47869,010-11938-22,7,3,4,1124.99,,
47870,010-11927-20,1,0,1,337.49,,
47871,010-11927-21,3,1,2,337.49,,
47872,010-11927-22,6,5,1,337.49,,
47874,010-11634-21,0,0,0,562.49,,
47875,010-11634-22,1,1,0,562.49,,
47876,010-11636-20,0,0,0,659.99,,
47877,010-11636-21,2,0,2,659.99,,
47878,010-11636-22,3,2,1,659.99,,
47883,E70153,13,7,6,1087.00,,
47905,010-10717-20,0,0,0,119.00,,
47907,101043,13,6,7,16.98,,
47908,101044,29,9,20,16.98,,
47909,101045,13,8,5,16.98,,
47910,101046,13,3,10,16.98,,
47911,101047,25,7,18,16.98,,
47912,101048,0,0,0,16.98,,
47913,1619DP2BLK,2,0,2,116.30,,
47914,"TM 81585",10,6,4,6.50,11.95,
48004,112509,0,0,0,73.08,,
48005,112529,0,0,0,73.08,,
48017,33-479-01,0,0,0,21.71,,
48021,52024,4,2,2,271.59,,339.49
48026,AIR-331-104-01,0,0,0,86.36,,
48027,AIR-331-104-02,0,0,0,196.00,,
48029,DT-800MSF,0,0,0,351.11,,
48043,FAP7002,0,0,0,1355.56,,
48044,FAP6112,0,0,0,333.33,,
48050,V11-0809BBK70-2,4,2,2,261.87,,
48053,V11-3426BBK50-2,4,2,2,399.99,,
48056,V11-3447BBK70-2,4,2,2,387.96,,
48057,V11-3447WWK50-2,3,1,2,352.63,,
48180,010-11612-00,0,0,0,17.49,,
48237,50010,17,2,15,55.09,,
48240,50020,21,11,10,20.77,,
48241,50044,4,4,0,23.70,,
48242,50025,20,10,10,21.99,,
48243,50048,18,12,6,23.57,,
48244,50030,0,0,0,20.03,,
48245,50040,14,9,5,24.06,,
48246,50050,19,9,10,138.64,,
48247,50055,8,3,5,140.58,,
48258,68,0,0,0,7.60,,
48260,A53S,2,0,2,189.20,,
48261,31911-0002,65,23,42,26.22,,
48262,275,13,7,6,5.57,,
48263,277,5,4,1,9.46,,
48264,278,60,38,22,8.78,,
48265,279,19,12,7,8.26,,
48266,285,4,2,2,7.26,,
48267,286,7,1,6,12.58,,
48270,66,12,1,11,11.08,,
48271,IL200,6,4,2,23.96,,
48272,IL200P,10,9,1,34.99,,
48273,IL200K,4,2,2,43.17,,
48274,IL500P,5,3,2,56.69,,
48277,200WX,3,1,2,1048.95,,
48278,113010,5,0,5,122.12,,
48279,1130-FT,47,47,0,1.80,,
48280,113510,6,2,4,122.12,,
48281,1135-FT,34,34,0,1.80,,
48282,113910,4,3,1,122.12,,
48283,1139-FT,37,37,0,1.80,,
48284,114010,4,1,3,200.30,,
48285,1140-FT,48,48,0,2.72,,
48286,114510,4,0,4,200.30,,
48287,1145-FT,35,35,0,2.72,,
48288,114910,4,2,2,200.30,,
48289,1149-FT,50,50,0,2.72,,
48290,115010,0,0,0,255.49,,
48291,1150-FT,12,12,0,4.68,,
48292,115510,3,2,1,255.49,,
48293,1155-FT,33,33,0,4.68,,
48294,115910,0,0,0,255.49,,
48296,116010,2,1,1,298.41,,
48297,1160-FT,16,16,0,4.03,,
48298,116510,3,2,1,298.41,,
48299,1165-FT,20,20,0,4.03,,
48300,116910,2,1,1,298.41,,
48301,1169-FT,25,25,0,4.03,,
48302,117010,4,4,0,368.94,,
48303,1170-FT,40,40,0,5.15,,
48304,117510,2,1,1,368.94,,
48305,1175-FT,26,26,0,5.15,,
48306,117910,3,1,2,368.94,,
48307,1179-FT,18,18,0,5.15,,
48308,MX8713CR,0,0,0,384.58,,
48309,108310,5,1,4,32.88,,
48310,1083-FT,70,70,0,0.72,,
48311,120710,5,0,5,228.52,,
48312,1207-FT,18,18,0,2.94,,
48313,120910,3,0,3,130.61,,
48314,1209-FT,234,234,0,1.71,,
48315,121110,6,4,2,77.78,,
48316,1211-FT,36,36,0,0.98,,
48317,156610,3,0,3,60.45,,
48318,1566-FT,89,89,0,0.77,,
48319,156410,4,3,1,74.63,,
48322,A80224,1,1,0,29.82,,
48328,108010,3,3,0,32.88,,
48329,1080-FT,223,223,0,0.72,,
48330,108810,6,3,3,32.88,,
48331,1088-FT,26,26,0,0.72,,
48332,F16-2810-1,0,0,0,72.55,,
48334,WCN604,1,0,1,149.18,189.00,
48336,WCN503,2,1,1,107.31,129.00,
48337,WCT503,1,1,0,112.98,159.00,
48338,F16-2600POL-1,0,0,0,101.97,,
48339,F16-2623POL-1,6,1,5,107.87,,
48340,F16-2630POL-1,10,4,6,123.01,,
48347,111010,0,0,0,55.43,,
48348,1110-FT,11,11,0,1.05,,
48349,111310,4,0,4,55.43,,
48350,1113-FT,13,13,0,1.05,,
48351,111510,0,0,0,55.43,,
48352,1115-FT,238,238,0,1.05,,
48353,112010,3,2,1,89.17,,
48354,1120-FT,80,80,0,1.29,,
48355,112310,3,1,2,89.17,,
48356,1123-FT,7,7,0,1.29,,
48357,112510,0,0,0,89.17,,
48358,1125-FT,105,105,0,1.29,,
48359,21431730,3,1,2,83.54,,
48360,21431930,3,0,3,83.54,,
48361,252234,22,22,0,1.60,,
48362,242234,0,0,0,14.94,,
48363,244234,5,0,5,44.02,,
48364,252235,0,0,0,1.60,,
48365,242235,2,2,0,14.94,,
48366,244235,3,1,2,43.76,,
48369,252236,11,11,0,1.60,,
48370,242236,1,1,0,14.94,,
48371,244236,12,5,7,44.02,,
48373,252244,7,7,0,2.42,,
48374,242244,3,0,3,20.56,,
48375,244244,3,1,2,58.41,,
48376,252245,4,4,0,2.42,,
48377,242245,0,0,0,20.56,,
48378,244245,3,1,2,61.31,,
48379,252246,4,4,0,2.42,,
48380,242246,0,0,0,20.56,,
48381,244246,4,3,1,68.33,,
48382,252241,8,7,1,2.41,,
48385,HC15F,2,2,0,138.64,,
48387,HC15S,10,5,5,85.61,,
48390,252254,25,12,13,2.42,,
48392,242254,0,0,0,22.23,,
48397,244254,6,2,4,65.76,,
48398,252255,21,17,4,2.81,,
48399,242255,4,3,1,26.24,,
48400,244255,4,3,1,78.63,,
48401,252256,13,6,7,2.81,,
48402,242256,7,1,6,26.24,,
48403,244256,5,2,3,78.63,,
48404,252257,5,2,3,3.67,,
48405,242257,4,3,1,14.09,,
48406,252251,7,2,5,3.22,,
48407,252265,20,20,0,3.22,,
48408,242265,9,6,3,30.22,,
48409,244265,7,6,1,90.74,,
48410,252266,4,4,0,4.41,,
48411,242266,11,6,5,41.16,,
48412,244266,0,0,0,125.45,,
48413,252267,8,5,3,4.38,,
48414,252261,9,2,7,4.41,,
48415,252275,8,8,0,3.22,,
48416,242275,1,0,1,31.47,,
48417,252276,0,0,0,3.22,,
48418,242276,1,1,0,31.47,,
48422,252271,0,0,0,3.05,,
48427,252285,5,5,0,3.69,,
48428,242285,5,3,2,36.34,,
48429,244285,2,2,0,107.49,,
48430,252286,1,1,0,3.69,,
48432,242286,6,4,2,40.56,,
48433,244286,2,2,0,107.49,,
48434,252287,9,0,9,4.81,,
48435,252295,7,7,0,4.41,,
48436,242295,10,6,4,42.79,,
48437,244295,0,0,0,127.50,,
48438,252296,0,0,0,4.41,,
48439,242296,8,7,1,42.79,,
48440,244296,2,1,1,127.50,,
48441,252297,5,0,5,4.38,,
48442,242297,4,2,2,17.36,,
48443,260100,54,26,28,2.79,,
48444,260200,59,35,24,3.03,,
48445,260325,11,2,9,5.33,,
48446,260010,13,10,3,6.65,,
48447,260012,6,2,4,7.83,,
48448,260322,5,2,3,20.57,,
48460,1035,3,0,3,7.96,,
48464,CLZ-CRDL,0,0,0,28.22,,
48465,21432311,2,0,2,75.44,,
48466,21501740,1,1,0,92.14,,
48467,21501940,2,1,1,92.14,,
48479,809-0913,3,2,1,266.88,,
48482,010-11855-00,0,0,0,15.99,,
48483,G-5,0,0,0,43.59,,
48484,G-7,67,34,33,55.95,,
48485,G-11,27,10,17,76.77,,
48486,G-16,8,4,4,111.25,,
48487,G-23,4,3,1,175.66,,
48488,000-171-974,0,0,0,159.09,,
48489,000-171-975,0,0,0,104.55,,
48493,010-11617-10,9,5,4,27.99,,
48494,118505,5,2,3,271.16,,
48495,1185-FT,43,43,0,9.28,,
48496,119505,6,0,6,288.57,,
48497,1195-FT,32,32,0,8.57,,
48498,252715,2,0,2,5.36,,
48499,242715,6,4,2,21.37,,
48500,252716,5,4,1,5.64,,
48501,242716,2,2,0,21.79,,
48502,252717,3,0,3,5.64,,
48503,252725,11,8,3,6.86,,
48504,242725,0,0,0,29.45,,
48505,252726,1,0,1,6.91,,
48506,242726,7,2,5,29.45,,
48507,252727,7,2,5,6.91,,
48508,242727,5,0,5,29.45,,
48518,21410004,0,0,0,693.60,,
48519,11410001,0,0,0,745.45,,
48520,20360023,0,0,0,509.13,,
48521,10360001,1,0,1,1309.01,,
48526,432-0010-11-00,0,0,0,5462.49,,
48527,432-0010-13-00,0,0,0,6412.49,,
48529,311399,0,0,0,27.78,,
48530,311499,0,0,0,27.78,,
48531,312399,20,6,14,38.28,,
48532,312499,0,0,0,38.28,,
48533,312599,4,2,2,38.28,,
48534,312699,5,3,2,38.28,,
48548,MS-BT100,4,0,4,40.18,,
48560,TZTBB,0,0,0,2425.95,,
48565,10070024,1,0,1,2015.28,,
48567,10040003,0,0,0,2990.66,,
48573,20310007,0,0,0,919.52,,
48575,20310013,0,0,0,848.44,,
48581,20310002,0,0,0,397.81,,
48583,20330008,0,0,0,385.14,,
48584,20330007,0,0,0,116.02,,
48587,20320004,0,0,0,614.27,,
48628,1247-FT,53,53,0,0.37,,
48639,LLB-33JW-81-OT,1,1,0,43.90,,
48640,LLB-33QW-81-OT,0,0,0,43.90,,
48641,LLB-33RW-81-OT,0,0,0,43.90,,
48642,LLB-33SW-81-OT,0,0,0,43.90,,
48643,LLB-49WR-21-CR,0,0,0,65.85,,
48656,LLB-32AH-01-00,0,0,0,4.15,,
48658,010-11580-00,9,0,9,17.49,,
48660,010-11010-22,0,0,0,917.61,,
48684,A80228,0,0,0,174.99,,
48707,LLB-11TW-61-00,0,0,0,9.00,,
48708,LLB-16NW-61-00,0,0,0,9.69,,
48711,LLB-21UW-21-00,7,4,3,9.00,,
48714,PRC200BC,8,3,5,84.77,136.99,
48715,LLB-21TW-21-00,0,0,0,9.00,,
48717,LLB-216W-21-00,0,0,0,8.31,,
48721,LLB-186W-21-00,0,0,0,6.92,,
48722,LLB-202W-21-00,0,0,0,6.23,,
48727,LLB-26FC-21-00,0,0,0,7.62,,
48728,LLB-26FW-21-00,2,2,0,7.62,,
48729,LLB-229W-21-00,0,0,0,3.46,,
48730,LLB-269W-21-00,0,0,0,3.46,,
48736,LLB-44BG-01-00,0,0,0,4.15,,
48737,LLB-44DG-01-00,0,0,0,4.15,,
48738,LLB-44EE-01-00,0,0,0,10.38,,
48739,LLB-453W-01-02,0,0,0,31.46,,
48740,LLB-453W-01-05,1,1,0,54.15,,
48741,LLB-453R-01-02,0,0,0,31.46,,
48742,LLB-453R-01-05,0,0,0,54.15,,
48743,LLB-453B-01-02,0,0,0,31.46,,
48744,LLB-453B-01-05,4,2,2,54.15,,
48745,05903-00,11,0,11,74.07,,
48746,LLB-463W-01-05,2,2,0,35.85,,
48750,22102,4,2,2,35.31,,
48751,22702,5,3,2,32.74,,
48752,22502,19,10,9,32.74,,
48756,33103,0,0,0,39.51,,
48757,LLB-453M-01-02,0,0,0,31.46,,
48758,LLB-453M-01-05,1,0,1,54.15,,
48775,2010,0,0,0,28.28,,
48776,4020,0,0,0,27.51,,
48777,6030,0,0,0,27.51,,
48779,80300,5,2,3,57.47,,
48780,805002,0,0,0,15.81,,
48783,8065050,0,0,0,55.18,,
48787,80650,2,2,0,12.32,,
48788,805,0,0,0,15.83,,
48789,805B,0,0,0,15.41,,
48790,803,0,0,0,11.51,,
48791,803B,0,0,0,11.82,,
48792,805950,0,0,0,25.00,,
48793,805900,0,0,0,45.93,,
48794,805950B,0,0,0,23.65,,
48795,805900B,0,0,0,42.87,,
48796,803950,0,0,0,21.81,,
48797,803900,0,0,0,35.12,,
48798,803950B,0,0,0,21.81,,
48799,803900B,6,0,6,35.12,,
48801,80113,0,0,0,13.97,,
48802,80113B,0,0,0,14.77,,
48803,83212,0,0,0,18.57,,
48804,83216,0,0,0,21.15,,
48805,83220,0,0,0,23.49,,
48806,83224,0,0,0,24.20,,
48808,102420,0,0,0,25.46,,
48809,102424,0,0,0,26.82,,
48810,102436,0,0,0,38.88,,
48812,142016,0,0,0,25.14,,
48813,142024,0,0,0,26.76,,
48814,142028,0,0,0,36.89,,
48815,142032,0,0,0,41.14,,
48816,142040,0,0,0,45.01,,
48817,3816325,3,0,3,41.99,,
48818,51618245,0,0,0,46.61,,
48820,51618122,0,0,0,47.08,,
48822,1024122,0,0,0,45.74,,
48823,80725,2,0,2,38.99,,
48824,807100,0,0,0,208.11,,
48825,809025,0,0,0,26.35,,
48826,809100,1,1,0,89.99,,
48827,901024,0,0,0,53.68,,
48828,901420,0,0,0,58.39,,
48829,50142050,0,0,0,28.23,,
48831,60250,0,0,0,14.86,,
48832,60375,0,0,0,19.82,,
48833,60500,0,0,0,26.84,,
48834,60625,0,0,0,26.84,,
48835,60750,0,0,0,35.09,,
48836,601000,0,0,0,35.09,,
48837,80250,0,0,0,19.41,,
48838,80375,0,0,0,27.66,,
48839,80500,0,0,0,40.88,,
48840,80625,0,0,0,40.88,,
48841,80750,0,0,0,54.50,,
48842,801000,0,0,0,54.50,,
48863,CVS-126TM,1,1,0,678.30,,
48864,CVS-1266TH,1,1,0,758.80,,
48865,CVS-1266TH1,3,1,2,699.30,,
48866,CVS-1266012,0,0,0,874.30,,
48867,CVS-1266020,1,1,0,874.30,,
48868,CVS-126744,2,0,2,856.80,,
48869,B744V-CX,2,0,2,284.99,,
48873,201010,0,0,0,256.41,,
48874,402010,0,0,0,248.87,,
48883,71245,1,0,1,7.41,,
48884,90051,0,0,0,21.19,,
48885,90191-00,2,0,2,21.19,,
48886,90261,2,2,0,37.41,,
48889,90331,0,0,0,23.68,,
48891,90511,1,0,1,20.57,,
48892,90681-00,0,0,0,20.25,,
48893,90791,1,0,1,20.57,,
48896,09-1026B-9,0,0,0,26.17,,
48897,09-1027B-10,2,0,2,28.00,,
48899,09-1028B-9,0,0,0,38.64,,
48901,09-1052S-9,0,0,0,19.01,,
48902,09-1077B-9,3,0,3,27.46,,
48903,09-13384,0,0,0,172.84,,
48904,09-46839-01,3,1,2,98.77,,
48905,09-46839-02,0,0,0,98.77,,
48906,09-47196,1,1,0,32.94,,
48907,09-5000,0,0,0,54.32,,
48908,09-6000,2,0,2,54.32,,
48909,09-802B,0,0,0,90.12,,
48912,09-810B-9,0,0,0,22.44,,
48914,09-814B,0,0,0,81.48,,
48916,09-819B-9,2,0,2,56.43,,
48917,09-820B,2,2,0,224.69,,
48920,09-824P-9,0,0,0,24.69,,
48921,09-842B,2,0,2,239.51,,
48922,09-843S-9,0,0,0,27.16,,
48972,T70152,5,1,4,1421.04,,
48973,T70153,5,3,2,1421.04,,
48974,T70154,4,1,3,1342.09,,
49025,15101,1,1,0,94.51,,
49034,32-0510-50,0,0,0,219.38,,
49037,412-BK,2,2,0,6.41,,
49040,19-0410,0,0,0,365.50,,
49048,A80229,7,4,3,204.16,,
49049,A80230,0,0,0,308.32,,
49050,A80227,0,0,0,124.99,,
49078,32-1087-50,1,0,1,74.99,,
49092,1128A00BLK,4,2,2,167.71,,
49093,1127RA0BLK,0,0,0,167.71,,
49094,1127GA0BLK,0,0,0,167.71,,
49095,1129A00BLK,2,0,2,167.71,,
49096,1129MA0BLK,0,0,0,167.71,,
49097,1130A00BLK,0,0,0,167.71,,
49098,1365E00BLK,0,0,0,441.68,,
49099,0314C0712V,0,0,0,1108.86,,
49100,PSU017,0,0,0,445.68,,
49102,A80176,0,0,0,123.57,,
49104,E70096,11,4,7,579.60,,
49108,E70098,2,1,1,440.21,,
49109,E70099,2,1,1,774.45,,
49110,E70139,1,1,0,1667.11,,
49111,E70100,9,1,8,1574.44,,
49112,R70160,1,1,0,179.34,,
49113,0374001CLR,0,0,0,42.85,,
49114,0374002CLR,0,0,0,45.40,,
49116,0374003CLR,0,0,0,42.85,,
49117,0374004CLR,12,0,12,42.85,,
49118,0342024CLR,0,0,0,59.89,,
49130,16004B-24,0,0,0,138.27,,
49133,10-13252-103-BW,0,0,0,143.21,,
49134,10-13252-107-BW,0,0,0,143.21,,
49135,10-13350-03,0,0,0,175.31,,
49136,10-13350-04,0,0,0,197.53,,
49137,10-13395-103,0,0,0,108.64,,
49138,10-13395-104,0,0,0,101.48,,
49139,73681S,6,3,3,65.22,,
49140,42054M,0,0,0,45.55,,
49141,42057U,0,0,0,32.19,,
49142,"UFO X",3,0,3,164.40,,
49143,7241321FG,10,7,3,166.87,,
49145,7241321FGK,3,2,1,182.73,,
49146,7241521FGK,6,3,3,200.74,,
49153,58121,7,4,3,172.85,,
49154,58130,9,6,3,174.30,,
49155,58131,14,7,7,198.95,,
49156,58140,11,2,9,161.01,,
49158,58180,80,64,16,38.41,,
49159,58182,16,4,12,39.74,,
49160,58183,0,0,0,67.40,,
49162,58231,2,0,2,47.61,,
49163,58300,11,9,2,35.16,,
49164,58275,21,16,5,37.96,,
49165,A80195,6,0,6,80.95,,
49167,CAB000863,4,2,2,17.61,,
49182,B265LH,0,0,0,1422.22,,
49184,PM265LH,0,0,0,1422.22,,
49188,31410018,2,1,1,94.99,,
49189,11953-4,4,2,2,23.25,,
49194,11780-6,7,2,5,4.29,,
49195,11776-5,10,8,2,22.62,,
49196,11775-5,2,2,0,12.81,,
49217,6005200,13,3,10,21.96,,
49218,6010200,10,5,5,36.56,,
49219,6011200,0,0,0,36.56,,
49220,12VCP,33,15,18,35.51,,
49221,150BBI,40,4,36,16.87,,
49222,S20-15,0,0,0,38.71,,
49223,S15-30,13,10,3,31.90,,
49224,S20-30,4,2,2,53.16,,
49225,6152SPP-25,5,5,0,420.78,,
49226,6152SPPW-25,2,2,0,467.55,,
49227,6152SPP,4,1,3,591.27,,
49228,6152SPPW,1,0,1,612.35,,
49229,12VBR,14,6,8,19.23,,
49230,12VBP,16,5,11,13.79,,
49231,12VBRAD,13,10,3,14.28,,
49232,12VCP6,9,1,8,45.37,,
49240,6369CR,11,5,6,92.69,,
49241,6370CR,2,2,0,90.92,,
49242,305CRRB,7,3,4,25.69,,
49243,6371EL-B,5,2,3,123.66,,
49244,6373EL-B,29,6,23,130.20,,
49245,6373EL,14,2,12,138.07,,
49246,2018BP-12,0,0,0,19.40,,
49247,2018BP-24,9,3,6,18.45,,
49248,2018BR-MB,34,32,2,57.72,,
49249,2018PKG,1,1,0,77.03,,
49250,2018BR,6,2,4,38.72,,
49257,RY504-2-30,3,2,1,311.92,,
49259,110A,5,3,2,99.37,,
49260,115A,2,1,1,161.27,,
49261,117A,3,2,1,138.83,,
49262,199120,6,4,2,83.20,,
49263,12VPG,9,6,3,7.47,,
49264,12VCPS2,32,12,20,28.73,,
49290,150400-200-030-12,3,0,3,65.99,,
49291,150400-200-040-12,2,0,2,86.85,,
49292,150400-200-050-12,4,2,2,86.85,,
49293,150400-200-060-12,0,0,0,86.85,,
49294,150400-200-070-12,0,0,0,86.85,,
49295,150400-200-080-12,0,0,0,86.85,,
49301,151200-200-004-13,2,1,1,53.25,,
49302,100200-200-002-12,14,7,7,55.71,,
49305,100100-200-002-12,8,8,0,45.71,,
49306,100100-200-004-12,9,3,6,50.71,,
49308,102000-200-002-12,0,0,0,12.50,,
49309,102000-200-004-12,1,0,1,12.50,,
49310,102000-200-005-12,0,0,0,12.50,,
49312,102200-200-004-12,8,4,4,59.23,,
49333,A80277,0,0,0,283.32,,
49335,A80273,2,1,1,34.08,,
49341,USBA6,0,0,0,43.34,,
49345,6360CRN,8,6,2,72.44,,
49346,6153SPP,7,5,2,416.55,,
49347,6153SPP-25,0,0,0,370.85,,
49348,6153SPPW,0,0,0,462.80,,
49351,CS30-12,9,7,2,49.29,,
49352,CS30-25,13,9,4,85.79,,
49353,CS30-50,17,10,7,98.28,,
49354,CS503-25,2,2,0,436.48,,
49355,CS503-50,1,1,0,490.23,,
49356,CS504-25,0,0,0,482.00,,
49357,CS504-50,0,0,0,677.27,,
49358,P15-30,0,0,0,46.71,,
49359,P30-15,0,0,0,51.51,,
49360,P503-30,4,2,2,116.85,,
49361,P30-503,6,3,3,150.15,,
49362,P504-30,2,1,1,137.56,,
49363,P30-504,4,3,1,163.24,,
49364,P504-503,4,1,3,199.65,,
49365,Y503-2-30,0,0,0,219.26,,
49366,Y504-2-30,7,4,3,188.66,,
49367,Y504-2-503,0,0,0,418.85,,
49368,Y30-2-30,3,3,0,169.90,,
49369,Y504-2-504,0,0,0,404.52,,
49390,2882.91,0,0,0,89.39,,
49391,2883.91,0,0,0,89.39,,
49392,2884.91,0,0,0,89.39,,
49393,2885.91,0,0,0,89.39,,
49394,305CRCN.VPK,11,5,6,39.86,,
49395,103RN,5,3,2,13.24,,
49396,103ELN,0,0,0,14.14,,
49397,6361CRN,6,4,2,62.10,,
49398,2848.91,1,1,0,221.89,,
49399,2846.91,1,1,0,221.89,,
49400,2842.91,1,1,0,221.89,,
49401,2844.91,1,1,0,221.89,,
49402,2874.91,1,1,0,221.89,,
49403,2875.91,1,1,0,221.89,,
49404,7715CRN,11,4,7,20.51,,
49405,7715ELN,1,0,1,20.51,,
49406,A80160,1,0,1,63.91,,
49407,18598-1000,0,0,0,56.10,,
49410,GS-280,7,2,5,1417.06,,
49411,GS-2801,4,2,2,1430.45,,
49418,32-3005,1,0,1,434.15,,
49446,30100,17,8,9,36.86,,
49447,30200,0,0,0,45.56,,
49513,010-11932-00,0,0,0,19.99,,
49537,GS-170-2,2,2,0,435.87,,
49538,F16-0311C-1,0,0,0,122.14,,
49542,OC-0421VEL8,13,11,2,114.99,,
49543,V30-0744B8-2,15,5,10,9.72,,
49544,V30-0748B8-2,0,0,0,11.96,,
49545,V30-1333B10-1,6,0,6,20.03,,
49546,V30-0202B10-1,9,3,6,21.81,,
49547,V30-0109B10-1,10,7,3,17.38,,
49548,V30-0113B10-1,8,5,3,17.90,,
49549,V30-1005B25-1,7,5,2,49.44,,
49550,V30-1005W25-1,4,4,0,49.44,,
49551,V30-1008B25-1,10,4,6,49.44,,
49552,V30-1008W25-1,9,2,7,49.44,,
49553,V30-1312B25-1,3,0,3,55.78,,
49554,V30-1312W25-1,2,0,2,55.94,,
49555,V30-1316B25-1,5,3,2,55.82,,
49556,V30-1316W25-1,4,2,2,53.53,,
49561,CB3961001,16,4,12,31.35,,
49562,CB3559001,3,2,1,24.15,,
49568,MS6007BR,13,5,8,51.94,,
49570,22823,15,9,6,12.24,,
49571,22833,15,11,4,21.47,,
49572,22853,0,0,0,33.12,,
49585,P66-BL,1,0,1,173.24,,
49597,A28167,7,3,4,55.39,,
49600,A80207,0,0,0,95.82,,
49601,LLB-45AU-08-00,0,0,0,34.15,,
49622,1901122,11,10,1,293.26,,
49630,68800,0,0,0,310.06,,
49631,68790,0,0,0,42.75,,
49665,010-11409-20,7,4,3,8.40,,
49717,CLIP-17,23,17,6,7.50,,
49718,CN-3,5,3,2,8.25,,
49721,FBA-42,8,2,6,18.75,,
49723,FBA-44,7,5,2,18.75,,
49727,B117-DT-BL,0,0,0,240.29,,
49733,E-DC-19A,27,6,21,24.75,,
49734,E-DC-6,8,2,6,7.50,,
49735,SPR-1I-RM,1,0,1,119.65,,
49736,SPR-7-RM,0,0,0,290.12,,
49737,20350001,0,0,0,687.62,,
49738,20360016,3,2,1,114.99,,
49740,001-167-880-10,0,0,0,50.00,,
49741,001-167-900-10,0,0,0,90.91,,
49745,LLB-28NW-24-SY,0,0,0,37.87,,
49750,"SS 01306",0,0,0,10.40,16.95,
49754,"BC 01806",116,57,59,11.33,17.95,
49755,"BC 01810",6,3,3,49.74,69.95,
49758,010-11968-00,0,0,0,31.49,,
49759,LLB-33AW-81-OT,0,0,0,41.16,,
49760,LLB-33BW-81-OT,0,0,0,41.16,,
49761,LLB-33CW-81-OT,1,1,0,50.49,,
49762,LLB-33EW-81-OT,0,0,0,43.90,,
49766,3970.3,10,7,3,52.96,,
49767,3971.3,0,0,0,58.21,,
49772,010-11977-00,0,0,0,6.99,,
49773,010-11994-00,0,0,0,34.99,,
49800,154000-200-020-13,0,0,0,469.57,,
49801,154000-200-004-13,0,0,0,469.57,,
49802,154000-200-005-13,0,0,0,506.51,,
49803,154100-200-020-13,0,0,0,546.64,,
49804,154100-200-004-13,0,0,0,546.64,,
49805,154100-200-005-13,0,0,0,586.31,,
49819,E70227,3,2,1,309.77,,
49820,2714.4,0,0,0,157.46,,
49850,11031A,3,3,0,7.40,,
49851,11065A,158,113,45,5.07,,
49852,23000,0,0,0,16.67,,
49853,23102,68,34,34,12.11,,
49854,23103,21,5,16,18.60,,
49855,25006GA,26,4,22,17.30,,
49856,27700,17,10,7,116.25,199.99,
49857,27710,46,30,16,130.13,229.99,
49858,27850,26,10,16,31.27,,
49859,29300,2,0,2,15.76,,
49860,29330,5,3,2,15.77,,
49861,29331,11,5,6,19.56,,
49862,29332,7,7,0,17.15,,
49863,29333,16,5,11,17.49,,
49864,27635,6,3,3,141.14,259.99,
49865,26051A,15,8,7,16.92,,
49866,26053A,9,3,6,6.98,,
49867,53690A,62,33,29,24.53,49.99,
49868,55108A,16,15,1,49.34,,
49880,426,0,0,0,12.48,,
49882,133-4,6,6,0,4.53,,
49883,133-16,33,33,0,13.08,,
49885,368,13,11,2,12.90,,
49886,1158,7,7,0,23.93,,
49887,1159,6,6,0,24.45,,
49928,710237-1,0,0,0,84.41,,
49953,940800220,2,1,1,1590.99,,1849.99
49954,940800230,0,0,0,1797.39,,2089.99
49955,940800240,0,0,0,1805.99,,2099.99
49956,940800250,2,1,1,1934.99,,2249.99
49957,940800260,3,1,2,1977.99,,2299.99
49973,941700080,3,2,1,1504.99,,1749.99
49974,941700090,1,0,1,1805.99,,2099.99
49975,941700100,2,0,2,2020.99,,2349.99
49976,720085-1,0,0,0,25.75,,
50006,8M0064076,9,1,8,34.20,,
50019,940200050,0,0,0,392.49,,
50020,940200060,2,1,1,401.62,,
50023,940200090,4,3,1,529.41,,
50024,940200100,3,1,2,556.79,,
50025,940200110,0,0,0,602.43,,
50026,940200120,2,1,1,648.07,,
50042,81-2022-12,2,0,2,1184.53,,
50043,940800270,4,2,2,1762.99,,2049.99
50057,2278,32,14,18,74.69,,
50058,2279,37,3,34,43.73,,
50067,SPLR-3,6,3,3,34.38,,
50068,202319,15,10,5,4.92,,
50069,202320,0,0,0,5.10,,
50074,3726BC,0,0,0,28.06,,
50075,3730BC,1,0,1,23.18,,
50076,6228BC,0,0,0,40.23,,
50077,6230BC,0,0,0,34.35,,
50078,6228WC,0,0,0,40.23,,
50079,6230WC,0,0,0,34.35,,
50080,02840000A,0,0,0,476.78,,
50082,29092-1000,31,14,17,11.04,,
50083,S-235C,0,0,0,69.81,,
50084,S-236C,0,0,0,88.03,,
50087,S-239C,0,0,0,41.15,,
50088,3226BC,25,21,4,25.05,,
50091,3230BC,0,0,0,19.48,,
50092,6094C,2,0,2,32.85,,
50093,6095C,0,0,0,36.29,,
50094,6096C,4,2,2,32.85,,
50095,6097C,3,2,1,36.29,,
50096,S-976C,13,8,5,5.63,,
50097,S-976BC,30,12,18,5.44,,
50100,6223C,0,0,0,30.99,,
50101,6349,0,0,0,102.10,,
50102,S-1320,0,0,0,62.60,,
50105,6263,0,0,0,17.68,,
50106,S-1524C,0,0,0,14.15,,
50107,S-1525C,0,0,0,15.20,,
50108,S-1526C,0,0,0,19.57,,
50109,S-1527C,0,0,0,21.44,,
50110,S-1528C,0,0,0,22.96,,
50111,6098C,0,0,0,36.46,,
50112,6099C,0,0,0,79.79,,
50113,6970C,5,4,1,22.30,,
50121,1133-F,3,2,1,46.52,,
50122,1205-F,0,0,0,100.49,,
50123,101245,4,1,3,203.82,,
50124,101246,13,10,3,203.82,,
50125,1200-F,0,0,0,100.49,,
50126,95-077-F,1,1,0,143.16,,
50127,1008-F,11,5,6,26.87,,
50128,1058-F,9,5,4,10.25,,
50129,1059-F,6,4,2,11.73,,
50130,73-071-F,0,0,0,64.13,,
50149,1363660,2,0,2,1393.39,,1649.99
50152,FRRRCR902000A00,0,0,0,312.19,,
50154,FRRRCH902000A00,0,0,0,148.83,,
50156,FRRRCP902000A00,0,0,0,105.27,,
50166,1363860,0,0,0,1017.15,,
50167,1363844,2,0,2,300.81,,
50168,1363854,1,0,1,455.77,,
50169,1363845,4,2,2,338.03,,
50170,1363855,1,0,1,471.48,,
50174,1363856,1,1,0,486.46,,
50179,FVC100358220Q00,2,1,1,487.73,,
50182,FVC08031231CA00,0,0,0,288.33,,
50191,FVC7031231CQ00,2,2,0,274.43,,
50193,FVC070312130Q00,1,1,0,307.09,,
50194,FVC070312120Q00,1,1,0,259.17,,
50206,MS-CBUSBFM1,3,1,2,18.26,,
50208,1810222,12,6,6,181.61,,
50213,114110,0,0,0,74.99,,
50214,1852072,0,0,0,25.41,,
50215,1865023,0,0,0,35.59,,
50216,114113,6,6,0,37.75,,
50217,114118,6,6,0,72.49,,
50218,114119,0,0,0,72.49,,
50219,114120,0,0,0,74.99,,
50220,114123,0,0,0,40.19,,
50221,114128,11,5,6,74.99,,
50222,114129,0,0,0,74.99,,
50223,101217,9,5,4,122.86,,
50224,101218,8,2,6,122.86,,
50225,101185,6,2,4,122.36,,
50232,1210-0001-P,1,1,0,29.28,,
50233,13554-0001-P,5,3,2,47.31,,
50234,17018-0001-P,6,0,6,54.81,,
50235,17935-0001-P,7,2,5,55.57,,
50236,17936-0001-P,0,0,0,87.10,,
50237,17937-0001-P,8,6,2,32.28,,
50238,18838-0001-P,3,1,2,32.28,,
50239,18777-0001-P,7,3,4,30.79,,
50240,18948-0001-P,5,2,3,36.80,,
50241,22405-0001-P,20,7,13,20.27,,
50242,6056-0003-P,7,0,7,116.40,,
50243,6303-0003-P,5,3,2,21.78,,
50244,6303-0007-P,11,7,4,36.80,,
50245,836-0001-P,14,7,7,46.56,,
50246,836-0003-P,0,0,0,46.56,,
50247,920-0001-P,10,6,4,31.53,,
50248,14750-0003-P,17,14,3,29.28,,
50249,17370-0001-P,2,0,2,110.38,,
50251,5929-0003-P,8,6,2,78.85,,
50252,6760-0003-P,4,0,4,157.69,,
50253,6080C,0,0,0,13.08,,
50254,9200-0023-P,6,0,6,40.56,,
50255,6180C,5,5,0,18.45,,
50256,920-0003-P,0,0,0,31.53,,
50257,6079C,0,0,0,15.13,,
50258,6179C,2,2,0,18.45,,
50259,6215C,0,0,0,12.40,,
50260,6216C,0,0,0,12.40,,
50261,6091C,0,0,0,16.35,,
50262,6081C,0,0,0,13.08,,
50263,6181C,0,0,0,18.45,,
50264,6225C,0,0,0,14.61,,
50265,6226C,0,0,0,14.61,,
50266,6279C,0,0,0,15.68,,
50267,6280C,0,0,0,16.47,,
50268,6090,1,1,0,42.21,,
50274,408340-1,0,0,0,580.99,,
50281,6190,0,0,0,46.31,,
50282,6130,0,0,0,42.19,,
50284,6050,0,0,0,21.16,,
50288,6048C,0,0,0,29.19,,
50291,6049C,0,0,0,20.43,,
50293,6084,0,0,0,39.21,,
50295,6184,0,0,0,37.41,,
50297,6229C,0,0,0,17.07,,
50299,S-7091P,0,0,0,33.15,,
50300,S-7092P,0,0,0,37.95,,
50303,S-7093P,0,0,0,46.12,,
50307,11901,0,0,0,36.96,,
50333,6028,0,0,0,10.60,,
50334,6029,6,6,0,15.74,,
50335,S-3433,0,0,0,7.69,,
50336,33611,3,0,3,97.83,,
50337,S-1492,0,0,0,4.64,,
50338,33621,12,6,6,99.18,,
50339,S-3030,8,2,6,2.08,,
50340,33631,6,2,4,102.84,,
50341,S-3031,0,0,0,2.08,,
50342,6007,0,0,0,11.64,,
50343,6021,0,0,0,13.24,,
50344,S-3436,0,0,0,7.01,,
50345,S-3032,0,0,0,1.91,,
50346,S-3033,0,0,0,1.91,,
50347,6161,0,0,0,16.37,,
50348,6162,0,0,0,17.06,,
50349,S-3025,0,0,0,5.26,,
50350,S-3439,4,4,0,7.19,,
50351,S-3440,0,0,0,6.31,,
50352,6027C,0,0,0,30.56,,
50353,S-990C,0,0,0,18.71,,
50354,S-990BC,0,0,0,19.20,,
50355,6211C,0,0,0,26.40,,
50356,6018C,3,3,0,17.94,,
50357,S-991,0,0,0,10.79,,
50358,6024L,0,0,0,16.37,,
50359,6024R,0,0,0,16.37,,
50360,6390,0,0,0,11.41,,
50361,6391,0,0,0,12.39,,
50362,6163,0,0,0,9.21,,
50365,6164,0,0,0,11.31,,
50366,S-1497,0,0,0,4.28,,
50367,S-3034,0,0,0,1.91,,
50368,S-3035,0,0,0,1.91,,
50369,S-3415,0,0,0,3.52,,
50370,S-3416,0,0,0,5.42,,
50371,S-3417,0,0,0,4.51,,
50372,S-3418,0,0,0,8.49,,
50373,S-3419,0,0,0,9.05,,
50374,S-3420,1,1,0,10.43,,
50375,S-3421,0,0,0,7.58,,
50376,S-3422,0,0,0,5.68,,
50377,S-3425,0,0,0,9.31,,
50378,6025,8,2,6,8.90,,
50379,6026,4,0,4,13.10,,
50380,S-3428,0,0,0,10.71,,
50381,S-3430,5,0,5,10.21,,
50382,S-604,0,0,0,12.24,,
50383,S-604BC,0,0,0,9.44,,
50384,S-605C,0,0,0,17.40,,
50385,S-605BC,0,0,0,10.81,,
50386,6384,0,0,0,40.09,,
50387,6160,0,0,0,15.30,,
50388,S-3422R,0,0,0,6.55,,
50389,S-3700,10,4,6,9.26,,
50390,S-3705,6,5,1,8.87,,
50391,S-3444,6,0,6,11.17,,
50392,6342C,0,0,0,21.09,,
50393,S-4051C,0,0,0,13.73,,
50394,S-579C,0,0,0,11.17,,
50395,S-579BC,0,0,0,8.73,,
50396,S-1400C,0,0,0,8.23,,
50397,6343C,2,2,0,21.09,,
50398,S-4052C,0,0,0,10.34,,
50399,S-578C,0,0,0,10.61,,
50400,S-4053C,0,0,0,12.44,,
50401,S-585C,7,3,4,8.89,,
50402,S-585BC,0,0,0,9.76,,
50403,S-586C,0,0,0,13.40,,
50404,S-586BC,0,0,0,15.14,,
50405,S-588C,8,5,3,42.86,,
50406,S-054C,3,2,1,11.99,,
50407,S-054BC,0,0,0,14.05,,
50408,S-1401C,0,0,0,7.57,,
50409,S-1401BC,3,3,0,8.34,,
50410,S-1402C,0,0,0,9.63,,
50411,S-1402BC,5,2,3,8.34,,
50412,S-1031,0,0,0,15.77,,
50416,S-1032,0,0,0,22.67,,
50417,S-1033,4,1,3,27.56,,
50418,S-5031,2,0,2,4.12,,
50421,S-5032,0,0,0,4.15,,
50423,S-5033,9,2,7,5.87,,
50428,6022C,0,0,0,14.44,,
50429,S-3360C,2,2,0,8.91,,
50430,S-3360BC,0,0,0,8.91,,
50431,S-3362C,0,0,0,9.34,,
50432,S-3362BC,0,0,0,10.80,,
50433,S-3364C,6,2,4,11.43,,
50434,S-3364BC,0,0,0,11.71,,
50435,S-222C,5,4,1,8.14,,
50436,S-223C,0,0,0,7.87,,
50437,S-224C,2,2,0,11.54,,
50438,S-229C,7,3,4,4.75,,
50439,S-977C,7,7,0,6.21,,
50440,S-503C,0,0,0,7.57,,
50441,S-148SC,0,0,0,14.20,,
50442,S-149C,0,0,0,4.68,,
50453,000-11142-001,0,0,0,559.33,,
50464,0456DP4,0,0,0,93.60,,
50465,0456DP6,10,3,7,93.60,,
50466,0456DP7,23,8,15,93.60,,
50467,0457DP4,11,8,3,156.99,,
50468,010-11076-04,25,2,23,20.99,,
50469,0457DP6,5,2,3,156.99,,
50470,0457DP7,0,0,0,156.99,,
50485,S-096B,0,0,0,25.50,,
50486,60900,0,0,0,147.30,,
50487,60902,2,0,2,189.44,,
50488,60901,0,0,0,151.93,,
50489,60903,5,2,3,199.59,,
50490,67900,0,0,0,155.61,,
50491,67902,1,1,0,200.11,,
50492,67901,0,0,0,160.50,,
50493,67903,0,0,0,210.85,,
50495,60821,0,0,0,23.50,,
50496,60823,1,1,0,11.10,,
50497,60822,1,0,1,11.10,,
50499,60825,0,0,0,24.82,,
50501,60827,0,0,0,11.71,,
50503,60826,0,0,0,11.71,,
50504,60805,1,1,0,29.84,,
50505,60831,0,0,0,40.27,,
50506,60833,0,0,0,15.03,,
50507,60832,0,0,0,15.03,,
50508,60835,0,0,0,46.92,,
50509,60837,0,0,0,15.11,,
50510,60836,0,0,0,15.11,,
50511,60847,0,0,0,71.36,,
50512,60703,0,0,0,81.08,,
50513,60705,3,1,2,74.20,,
50514,60855,0,0,0,46.92,,
50515,60857,0,0,0,28.54,,
50516,60858,0,0,0,25.26,,
50517,60859,0,0,0,19.62,,
50518,60860,0,0,0,17.12,,
50519,60861,0,0,0,35.90,,
50520,60840,0,0,0,41.68,,
50521,60841,0,0,0,24.94,,
50522,60843,0,0,0,41.68,,
50523,60844,0,0,0,30.88,,
50524,60850,0,0,0,18.27,,
50525,60851,0,0,0,17.23,,
50526,60853,0,0,0,16.02,,
50527,60854,0,0,0,10.20,,
50528,60150-20,0,0,0,2.52,,
50529,60151-20,0,0,0,3.30,,
50530,60152-20,7,5,2,3.78,,
50531,60153-20,4,2,2,6.60,,
50532,60154-20,3,3,0,9.88,,
50533,60155-20,2,2,0,9.02,,
50534,60148,0,0,0,3.52,,
50535,60149,0,0,0,5.84,,
50536,60120-A,0,0,0,5.61,,
50537,60130-A,0,0,0,7.74,,
50538,60131-A,0,0,0,11.11,,
50539,60137-A,0,0,0,11.64,,
50540,60145-A,2,0,2,3.78,,
50541,60146-A,2,2,0,4.38,,
50563,157000-300-010-12,1,0,1,12.49,,
50567,157000-300-050-12,0,0,0,14.12,,
50568,152800-300-050-13,4,4,0,25.99,,
50569,152800-300-075-13,4,0,4,39.29,,
50571,102500-702-999-12,20,0,20,9.99,,
50572,102400-702-999-12,0,0,0,12.14,,
50580,1366ME0BLK,0,0,0,441.68,,
50640,60124-A,11,3,8,6.05,,
50641,60127-A,2,2,0,3.30,,
50642,60135-A,0,0,0,4.80,,
50643,60142-A,0,0,0,6.29,,
50644,60147-A,9,0,9,8.76,,
50645,60170,15,7,8,6.97,,
50646,60171,12,9,3,6.97,,
50647,60172,10,6,4,6.97,,
50649,61973,0,0,0,25.75,,
50651,61974,4,4,0,35.76,,
50652,60712,0,0,0,23.33,,
50653,60710,0,0,0,38.80,,
50654,60714,3,2,1,24.50,,
50655,60716,2,2,0,43.41,,
50658,60629,0,0,0,51.93,,
50660,60720,2,1,1,64.89,,
50662,60721,0,0,0,64.89,,
50664,60722,0,0,0,77.13,,
50667,60723,0,0,0,77.13,,
50669,60724,2,2,0,95.55,,
50670,60725,0,0,0,95.55,,
50675,60730,0,0,0,29.11,,
50677,60732,0,0,0,42.44,,
50680,60734,0,0,0,58.70,,
50681,60736,0,0,0,84.18,,
50682,61398,0,0,0,363.36,,
50683,61399,0,0,0,379.18,,
50684,61397,0,0,0,363.36,,
50685,S-3511C,7,7,0,11.81,,
50687,61394,2,0,2,275.66,,
50688,62402,0,0,0,129.74,,
50689,62406,4,2,2,86.64,,
50690,62404,1,1,0,140.14,,
50698,62414,0,0,0,55.16,,
50699,62408,1,0,1,29.11,,
50700,62550,0,0,0,114.85,,
50701,62418,0,0,0,40.50,,
50702,62416,0,0,0,24.50,,
50703,62421,0,0,0,17.46,,
50704,62420,0,0,0,11.49,,
50705,62434,0,0,0,37.76,,
50706,62432,0,0,0,18.20,,
50707,62433,0,0,0,37.16,,
50708,62618,0,0,0,17.95,,
50709,62620,3,1,2,29.10,,
50710,62425,0,0,0,58.70,,
50711,62426,0,0,0,42.69,,
50712,62440,4,2,2,65.36,,
50713,62436,0,0,0,43.10,,
50714,62438,0,0,0,49.19,,
50715,62444,4,2,2,24.76,,
50716,62446,0,0,0,68.13,,
50717,62442,0,0,0,16.53,,
50718,62540,0,0,0,62.15,,
50719,62544,0,0,0,43.31,,
50720,62354,0,0,0,117.58,,
50721,62344,0,0,0,40.00,,
50722,62322,5,2,3,13.54,,
50738,N2KVIEW,0,0,0,556.00,,
50741,62330,9,2,7,10.89,,
50742,62332,5,4,1,19.84,,
50743,62338,0,0,0,37.84,,
50744,62334,0,0,0,13.54,,
50745,62336,0,0,0,15.80,,
50746,62310,0,0,0,9.53,,
50747,62312,0,0,0,11.10,,
50748,62315,0,0,0,28.14,,
50749,62314,0,0,0,13.03,,
50750,62316,4,2,2,18.24,,
50762,62670,0,0,0,13.33,,
50763,62672,0,0,0,13.33,,
50764,62526,4,2,2,17.35,,
50765,62512,0,0,0,67.14,,
50766,62520,0,0,0,41.36,,
50767,62524,1,0,1,23.43,,
50768,62530,0,0,0,35.18,,
50769,62534,0,0,0,28.23,,
50770,62532,4,2,2,47.24,,
50771,62536,0,0,0,9.46,,
50772,62502,7,3,4,68.13,,
50773,50900-1000,6,4,2,276.77,,
50774,62504,0,0,0,42.75,,
50775,62508,0,0,0,61.43,,
50776,62560,6,3,3,12.33,,
50777,62601,4,4,0,28.64,,
50778,62602,0,0,0,36.96,,
50779,62610,0,0,0,22.35,,
50780,62612,3,1,2,27.34,,
50781,62616,1,1,0,43.41,,
50782,18690-0000,1,1,0,672.36,,
50783,62410,0,0,0,29.11,,
50784,56D-24,3,1,2,225.65,,
50785,62634,4,2,2,55.26,,
50786,60034,0,0,0,86.84,,
50787,60020,0,0,0,224.40,,
50788,60031,0,0,0,206.09,,
50789,60055,0,0,0,323.60,,
50790,60030,0,0,0,226.56,,
50791,60028,0,0,0,247.56,,
50792,60029,0,0,0,767.33,,
50793,60608,0,0,0,21.96,,
50794,60620,5,3,2,72.41,,
50795,60610,4,2,2,15.50,,
50796,60612,5,2,3,26.28,,
50797,60614,5,2,3,31.24,,
50798,60609,5,4,1,5.16,,
50799,60329,0,0,0,19.21,,
50800,60502,13,6,7,17.03,,
50801,60504,8,4,4,9.83,,
50802,60506,4,0,4,7.12,,
50803,60101,9,1,8,9.66,,
50804,60102,8,6,2,15.00,,
50805,60104,11,9,2,23.09,,
50806,60106,15,6,9,29.06,,
50807,60108,0,0,0,54.05,,
50808,60110,4,3,1,66.11,,
50809,60112,5,2,3,78.29,,
50810,60114,1,1,0,14.70,,
50811,65855,0,0,0,46.46,,
50812,63272,4,2,2,10.91,,
50813,65856,0,0,0,31.65,,
50814,63218,0,0,0,47.51,,
50815,63219,0,0,0,90.81,,
50816,60808,0,0,0,15.36,,
50817,60809,0,0,0,54.61,,
50818,60810,0,0,0,110.32,,
50819,60811,7,7,0,16.40,,
50820,60812,9,6,3,21.87,,
50821,60813,0,0,0,61.72,,
50822,60814,0,0,0,15.71,,
50823,60815,0,0,0,50.57,,
50824,60816,0,0,0,15.36,,
50825,60817,0,0,0,7.15,,
50826,60818,7,4,3,59.71,,
50827,02-100-112,0,0,0,235.63,301.60,
50829,02-100-134,0,0,0,235.63,301.60,
50830,02-100-200,0,0,0,235.63,301.60,
50831,02-100-214,0,0,0,235.63,301.60,
50832,02-118-112,0,0,0,235.63,301.60,
50833,02-118-134,0,0,0,235.63,301.60,
50834,02-114-134,0,0,0,270.00,345.60,
50838,1379213,0,0,0,285.28,,
50839,1379215,0,0,0,304.88,,
50844,02-114-200,0,0,0,270.00,345.60,
50845,02-114-214,0,0,0,270.00,345.60,
50846,02-114-212,0,0,0,270.00,345.60,
50847,02-138-214,0,0,0,270.00,345.60,
50848,02-138-212,0,0,0,270.00,345.60,
50849,02-112-214,0,0,0,356.88,456.80,
50850,02-112-212,3,1,2,356.88,456.80,
50851,02-112-234,0,0,0,356.88,456.80,
50852,02-112-300,0,0,0,356.88,456.80,
50853,02-112-314,0,0,0,356.88,456.80,
50854,02-112-312,0,0,0,356.88,456.80,
50855,02-134-212,0,0,0,390.63,500.00,
50856,02-134-234,0,0,0,390.63,500.00,
50857,02-134-300,0,0,0,390.63,500.00,
50858,02-134-314,0,0,0,390.63,500.00,
50859,02-134-312,0,0,0,390.63,500.00,
50860,02-200-234,0,0,0,458.75,587.20,
50861,02-200-300,0,0,0,458.75,587.20,
50862,02-200-314,0,0,0,458.75,587.20,
50866,02-200-312,0,0,0,458.75,587.20,
50867,02-214-312,0,0,0,523.13,669.60,
50868,02-214-400,0,0,0,523.13,669.60,
50872,02-212-312,0,0,0,523.13,669.60,
50874,02-212-400,0,0,0,523.13,669.60,
50875,02-300-412,0,0,0,746.88,956.00,
50876,A06068,4,2,2,63.91,,
50932,29045-2000,5,3,2,69.38,,
50933,000-164-608,0,0,0,70.91,,
50935,000-153-769,0,0,0,190.91,,
50936,7717,35,13,22,63.92,,
50937,15125-101,0,0,0,433.63,,
50938,15126-101,0,0,0,458.48,,
50939,15088-101,0,0,0,508.18,,
50940,15112-101,0,0,0,283.90,,
50941,15095-001,3,0,3,43.10,,
50942,15500-101,0,0,0,1433.96,,
50943,15501-101,0,0,0,1659.78,,
50944,30246-001D,0,0,0,83.23,,
50945,30252-001D,0,0,0,43.96,,
50946,30277-001D,0,0,0,62.81,,
50947,30259-001D,0,0,0,78.51,,
50948,30257-001D,0,0,0,73.80,,
50950,30260-002D,0,0,0,58.10,,
50951,30260-003,0,0,0,72.23,,
50952,30260-004,0,0,0,87.93,,
50953,30260-005,0,0,0,108.34,,
50954,30260-006,0,0,0,128.75,,
50955,30262-001D,0,0,0,70.66,,
50959,ZDIGGV30,2,0,2,142.46,,
50962,124910,3,3,0,23.24,,
50963,0947DP1CHR,15,10,5,34.80,,
50964,1186DP0ZNC,27,9,18,12.15,,
50965,1187DP0ZNC,10,10,0,12.15,,
50966,1299DP0CHR,8,0,8,14.93,,
50968,1110DP0CHR,0,0,0,15.29,,
50969,0506DP4CHR,27,17,10,13.28,,
50970,1184DP0CHR,12,10,2,50.75,,
50971,1183DP0CHR,5,4,1,37.04,,
50972,1604DP0CHR,2,0,2,15.79,,
50974,1440DP5CHR,12,10,2,32.36,,
50975,1440DP6CHR,1,0,1,46.52,,
50976,1221DP0CHR,16,5,11,13.53,,
50977,1220DP0CHR,8,8,0,15.29,,
50980,100-340-032,0,0,0,45.45,,
50981,100-343-132,0,0,0,27.27,,
50982,E1150Z-11AAH,1,0,1,51.22,,
50983,IRIS595,5,0,5,419.16,,
50985,5530-24A7,6,4,2,40.38,,
50986,5530-36A7,4,0,4,42.27,,
50987,5530-42A7,10,1,9,44.70,,
50992,5580A7,13,0,13,38.07,,
50993,6355W7,17,7,10,9.59,,
50994,11794-7,4,1,3,19.62,,
50996,14185XFS-7,0,0,0,36.92,,
50997,14187XFS-7,0,0,0,53.65,,
50998,11246-1,23,8,15,13.01,,
51000,11441-4,8,6,2,77.69,,
51003,11897-2,4,2,2,15.31,,
51005,11901-4,42,21,21,33.92,,
51006,14066-7,12,5,7,20.07,,
51007,9350-4,0,0,0,20.32,,
51008,14367-6,7,4,3,10.08,,
51105,010-01226-00,2,0,2,157.49,,
51144,104,0,0,0,9.63,,12.98
51154,VIZZ-IND,3,1,2,47.55,65.99,
51156,QUAD-IND,0,0,0,33.90,,
51176,010-12017-00,6,4,2,89.99,,
51181,2400,10,4,6,46.88,,
51182,2410,3,1,2,46.88,,
51183,2415,4,2,2,37.50,,
51184,2420,4,2,2,43.75,,
51185,2430,0,0,0,15.63,,
51186,2440,6,3,3,16.88,,
51187,2445,3,3,0,18.75,,
51188,2460,11,9,2,12.50,,
51189,2450,3,0,3,17.50,,
51190,2455,0,0,0,17.50,,
51214,1RPC50,0,0,0,66.65,,
51216,199128,5,2,3,81.72,,
51218,122200-200-020-14,0,0,0,54.67,,
51219,122200-200-040-14,9,6,3,46.99,,
51220,122200-200-060-14,6,0,6,54.67,,
51224,122000-300-020-14,11,5,6,44.00,,
51225,122000-300-040-14,2,2,0,44.00,,
51226,122000-300-060-14,5,5,0,44.00,,
51229,33-523-01,0,0,0,120.41,,
51241,CL-ENT,0,0,0,335.11,,
51263,1854120,10,10,0,8.71,,
51266,100-323-601,0,0,0,70.91,,
51268,001-122-810-10,0,0,0,431.82,,
51280,SATPT-40,0,0,0,370.69,,
51281,SATPT-60,0,0,0,396.56,,
51283,SPR-1I-AM,1,1,0,172.06,,
51284,SPR-7-AM,0,0,0,322.41,,
51287,T70226,3,0,3,1144.73,,
51291,A80276,0,0,0,76.69,,
51293,A80272,0,0,0,63.91,,
51294,07-100-112R,0,0,0,69.38,88.80,
51295,07-100-134R,0,0,0,69.38,88.80,
51296,07-100-200R,0,0,0,69.38,88.80,
51297,07-100-214R,0,0,0,69.38,88.80,
51298,07-118-112R,0,0,0,69.38,88.80,
51299,07-118-134R,0,0,0,69.38,88.80,
51300,07-114-134R,0,0,0,90.00,115.20,
51301,07-114-200R,0,0,0,90.00,115.20,
51302,07-114-214R,0,0,0,90.00,115.20,
51303,07-114-212R,0,0,0,90.00,115.20,
51304,07-138-214R,0,0,0,90.00,115.20,
51305,07-138-212R,0,0,0,90.00,115.20,
51306,07-112-214R,0,0,0,114.38,146.40,
51307,07-112-212R,0,0,0,114.38,146.40,
51308,07-112-234R,0,0,0,114.38,146.40,
51309,07-112-300R,0,0,0,114.38,146.40,
51310,07-112-314R,0,0,0,114.38,146.40,
51311,07-112-312R,0,0,0,114.38,146.40,
51312,07-134-212R,0,0,0,114.38,146.40,
51313,07-134-234R,0,0,0,114.38,146.40,
51314,07-134-300R,0,0,0,114.38,146.40,
51315,07-134-314R,0,0,0,114.38,146.40,
51316,07-134-312R,0,0,0,114.38,146.40,
51317,07-200-234R,0,0,0,114.38,146.40,
51318,07-200-300R,0,0,0,114.38,146.40,
51319,07-200-314R,0,0,0,114.38,146.40,
51320,07-200-312R,0,0,0,114.38,146.40,
51321,07-214-312R,0,0,0,163.75,206.60,
51322,07-214-400R,0,0,0,163.75,209.60,
51323,07-212-312R,0,0,0,163.75,209.60,
51324,07-212-400R,0,0,0,163.75,209.60,
51325,07-300-412R,0,0,0,231.88,296.80,
51331,31014,9,8,1,76.58,,
51333,33001,12,10,2,43.73,,
51334,33011,3,3,0,8.26,,
51335,33012,4,4,0,8.26,,
51337,33016,11,0,11,9.51,,
51342,33640,5,2,3,27.36,,
51343,33641,16,11,5,28.70,,
51344,33650,0,0,0,27.36,,
51350,33651,10,6,4,28.70,,
51351,33660,21,9,12,29.31,,
51352,33661,8,0,8,30.53,,
51353,33670,0,0,0,62.42,,
51354,33671,9,7,2,65.10,,
51355,33680,17,10,7,19.55,,
51358,40400,20,12,8,17.83,,
51376,010-10723-17,0,0,0,31.99,,
51379,SVS-760,0,0,0,629.30,,
51380,SVS-760CF,2,0,2,699.99,,
51381,SVS-760TM,0,0,0,748.30,,
51382,SVS-760TH,0,0,0,769.30,,
51383,SVS-760TH1,0,0,0,828.80,,
51385,SVS-760B60-12,0,0,0,944.30,,
51386,SVS-760B60-20,0,0,0,944.30,,
51387,SVS-760TH2,0,0,0,926.80,,
51394,SVS-760CFTH2,2,0,2,1066.80,,
51395,SAS-300-1,1,1,0,1224.30,,
51396,SAS-300-2,2,1,1,1169.99,,
51397,SAS-300-3,2,1,1,674.99,,
51405,18670-9127,5,3,2,247.80,,
51406,T-760,2,2,0,1644.30,,
51414,941700110,1,1,0,1797.39,,2089.99
51428,101241,5,2,3,30.19,,
51429,101242,10,4,6,74.73,,
51430,101243,14,0,14,74.73,,
51431,101240,4,0,4,12.18,,
51432,101230,0,0,0,16.35,,
51433,101223,19,2,17,16.98,,
51434,101224,19,7,12,16.98,,
51481,A22154,2,2,0,216.66,,
51482,0540DPG99A,0,0,0,36.60,,
51483,0540DPGCHR,9,0,9,42.67,,
51485,010-11970-00,94,4,90,16.09,,
51500,MDA-1-ANT,2,1,1,84.00,,
51536,T5K784,4,4,0,26.88,,
51544,T49961,0,0,0,33.33,,
51546,T49963JV,0,0,0,33.33,,
51548,104000-200-000-14,13,5,8,20.67,,
51562,010-11119-00,0,0,0,25.46,,
51563,010-11120-00,0,0,0,25.46,,
51571,111910,3,2,1,55.43,,
51577,010-10562-00,12,6,6,4.24,,
51581,MA7065,4,4,0,69.94,,
51582,MA7050,1,1,0,49.41,,
51594,11500800,2,0,2,36.45,,
51595,21431530,3,0,3,83.54,,
51602,S2-0802,0,0,0,139.51,,
51611,58303,18,13,5,47.14,,
51612,58184,9,5,4,85.66,,
51613,58173,9,5,4,293.98,,
51614,R1,5,1,4,2.75,,
51615,R2,10,0,10,6.90,,
51616,R3,89,0,89,10.57,,
51617,R4,5,0,5,20.56,,
51618,R5,0,0,0,30.82,,
51619,R7,0,0,0,54.49,,
51620,R1AL,4,0,4,3.29,,
51621,R2AL,4,0,4,5.97,,
51622,R3AL,6,0,6,8.82,,
51623,R4AL,0,0,0,17.32,,
51624,R5AL,0,0,0,24.91,,
51625,R1MG,0,0,0,4.65,,
51626,R2MG,0,0,0,13.43,,
51627,R3MG,4,0,4,20.15,,
51628,R4MG,0,0,0,39.24,,
51629,R5MG,0,0,0,48.10,,
51632,141133,10,9,1,178.57,,
51633,EFC-03,0,0,0,43.79,,
51634,EFC-04,3,3,0,51.51,,
51635,X1,0,0,0,7.21,,
51636,X2,0,0,0,6.63,,
51637,X3,0,0,0,7.10,,
51638,X4,0,0,0,7.56,,
51639,X5,0,0,0,7.66,,
51641,X6,0,0,0,11.34,,
51642,X7,0,0,0,10.97,,
51643,X8,0,0,0,15.79,,
51644,X9,0,0,0,17.40,,
51645,X10,0,0,0,40.28,,
51646,X11,0,0,0,33.72,,
51647,X12,0,0,0,50.66,,
51648,X13,0,0,0,43.47,,
51649,X14,0,0,0,62.32,,
51650,X15,0,0,0,63.79,,
51651,X16,0,0,0,74.41,,
51652,X17,0,0,0,66.00,,
51653,X18,0,0,0,71.25,,
51654,X19,0,0,0,79.10,,
51655,X20,0,0,0,210.18,,
51656,X21,0,0,0,94.99,,
51657,X22,1,1,0,54.99,,
51681,10025,13,8,5,56.92,,
51684,X1AL,0,0,0,6.99,,
51685,X2AL,0,0,0,6.90,,
51686,X3AL,0,0,0,6.54,,
51687,X4AL,0,0,0,6.44,,
51688,X5AL,0,0,0,7.07,,
51689,X6AL,0,0,0,9.01,,
51690,X7AL,0,0,0,8.72,,
51691,X8AL,0,0,0,16.82,,
51692,X9AL,0,0,0,14.53,,
51693,X10AL,0,0,0,31.12,,
51694,X11AL,0,0,0,31.93,,
51695,X12AL,0,0,0,34.59,,
51696,X13AL,0,0,0,37.57,,
51697,X1MG,0,0,0,12.88,,
51698,X2MG,0,0,0,12.88,,
51699,X3MG,0,0,0,16.44,,
51700,X4MG,0,0,0,16.96,,
51701,X5MG,1,0,1,12.47,,
51702,X6MG,0,0,0,20.78,,
51704,X7MG,0,0,0,22.76,,
51705,X8MG,0,0,0,23.50,,
51706,X9MG,0,0,0,25.91,,
51707,00800,0,0,0,8.32,,
51708,00800AL,0,0,0,8.38,,
51709,00800MG,0,0,0,11.41,,
51710,00801,0,0,0,11.69,,
51711,00804,0,0,0,7.56,,
51712,00806,0,0,0,16.66,,
51713,00806BIS,0,0,0,14.53,,
51714,00806BISAL,0,0,0,10.12,,
51715,00806BISMG,0,0,0,14.50,,
51716,00807,0,0,0,2.63,,
51717,00807AL,0,0,0,3.47,,
51718,00807MG,0,0,0,4.24,,
51722,28106,106,55,51,78.42,,
51723,28210,82,32,50,125.09,,
51725,010-C1087-00,0,0,0,112.49,,
51738,5291,29,19,10,4.27,,
51739,5292,5,1,4,4.27,,
51740,5293,13,6,7,4.27,,
51741,5294,13,7,6,4.27,,
51742,5295,18,8,10,4.27,,
51743,5296,4,0,4,4.27,,
51744,5297,7,2,5,4.27,,
51745,5298,14,6,8,4.27,,
51746,5299,12,9,3,4.27,,
51747,00817,1,1,0,2.26,,
51748,00817AL,0,0,0,3.31,,
51749,00817MG,0,0,0,5.74,,
51750,00818,0,0,0,5.29,,
51751,00818AL,0,0,0,6.53,,
51752,00818MG,0,0,0,8.44,,
51753,00816,0,0,0,9.53,,
51754,00816AL,0,0,0,7.59,,
51755,00816MG,0,0,0,12.47,,
51756,00815,0,0,0,15.38,,
51757,00815AL,0,0,0,11.96,,
51758,00815MG,0,0,0,16.13,,
51759,00814,0,0,0,11.10,,
51760,00814AL,0,0,0,11.03,,
51761,00814MG,0,0,0,16.41,,
51762,00812,0,0,0,10.84,,
51763,01124,9,0,9,14.85,,
51764,01124AL,0,0,0,13.79,,
51765,01112,2,1,1,16.07,,
51768,01112AL,1,0,1,14.21,,
51770,01133DX,0,0,0,15.26,,
51771,01133DXAL,0,0,0,10.56,,
51772,01134SX,0,0,0,15.26,,
51773,01134SXAL,0,0,0,10.56,,
51774,TEC-DIVERS,1,0,1,48.32,,
51775,TEC-DIVERSMG,2,0,2,51.16,,
51776,TEC-20,1,1,0,4.66,,
51777,TEC-30,0,0,0,17.00,,
51778,TEC-30AL,4,4,0,13.18,,
51779,TEC-Z-406,0,0,0,49.90,,
51786,SPC12RP,5,2,3,20.00,,
51787,EMU-1,2,0,2,466.78,,
51801,OPTO-4,0,0,0,100.59,,
51803,QNB-1,0,0,0,163.41,,
51808,5049,31,22,9,3.66,,
51809,5050,10,7,3,34.73,,
51810,5051,5,5,0,56.82,,
51811,5052,21,6,15,44.19,,
51812,5054,18,5,13,75.76,,
51813,4303,8,2,6,26.23,,
51814,4305,3,2,1,40.95,,
51815,4307,13,7,6,54.04,,
51816,4309,0,0,0,67.33,,
51821,WP-150WHA-1,5,2,3,115.77,,
51822,P04-091W,19,12,7,3.75,,
51823,P04-0111W,0,0,0,10.38,,
51824,P04-011W,12,4,8,9.38,,
51826,F31-3504BSA-1,3,1,2,260.76,,
51991,7520,3,1,2,94.41,,
52003,010-11979-00,3,3,0,29.98,,
52007,3119,0,0,0,537.68,,
52008,TEC-40,0,0,0,18.37,,
52009,TEC-N1,0,0,0,25.49,,
52011,00630FISH,6,0,6,56.81,,
52012,TEC-S-Z1,0,0,0,5.75,,
52013,GO,1,1,0,962.36,,
52016,00718,0,0,0,15.76,,
52018,4187BX,37,6,31,38.67,,
52020,20708,0,0,0,32.69,,
52021,20708AL,5,1,4,29.81,,
52022,20708MG,2,2,0,44.40,,
52023,20800,0,0,0,35.22,,
52024,20800AL,1,1,0,30.69,,
52025,20800MG,2,0,2,32.26,,
52026,20801,0,0,0,49.84,,
52027,20801AL,1,1,0,46.43,,
52028,20801MG,1,1,0,51.46,,
52029,20803,1,1,0,40.06,,
52030,20803AL,5,5,0,23.99,,
52031,20803MG,3,1,2,37.06,,
52032,20804,3,1,2,26.47,,
52033,20804AL,2,0,2,37.34,,
52034,20804MG,4,0,4,32.22,,
52035,20805,3,0,3,44.16,,
52036,20805AL,1,1,0,50.38,,
52037,20805MG,4,0,4,43.03,,
52038,20814,0,0,0,28.75,,
52039,20814AL,2,2,0,29.94,,
52040,20814MG,0,0,0,36.59,,
52041,20816,4,1,3,45.75,,
52042,20816AL,3,1,2,30.76,,
52043,20816MG,0,0,0,39.49,,
52044,21101,2,0,2,27.18,,
52045,21101AL,0,0,0,21.82,,
52046,21102,0,0,0,34.74,,
52047,21102AL,0,0,0,21.82,,
52048,21104,9,0,9,27.59,,
52049,21104AL,0,0,0,24.31,,
52050,21106,6,0,6,27.91,,
52051,21106AL,0,0,0,23.46,,
52055,TEC-E0-C,0,0,0,3.26,,
52056,TEC-E00-C,2,2,0,2.44,,
52057,TEC-E1-C,0,0,0,5.10,,
52058,TEC-E2-C,0,0,0,5.81,,
52059,TEC-E3-C,0,0,0,8.99,,
52060,TEC-E4-C,0,0,0,10.62,,
52061,TEC-E5-C,0,0,0,9.79,,
52062,20701,0,0,0,27.28,,
52063,20701AL,0,0,0,31.59,,
52064,20701MG,0,0,0,28.03,,
52065,20702,0,0,0,26.85,,
52066,010-11057-00,1,0,1,55.99,,
52067,20702AL,0,0,0,26.82,,
52068,20702MG,0,0,0,27.28,,
52069,20705,0,0,0,29.00,,
52070,20705AL,0,0,0,24.21,,
52071,20705MG,0,0,0,33.38,,
52072,20706,2,0,2,29.81,,
52073,20706AL,0,0,0,21.21,,
52074,20706MG,0,0,0,26.50,,
52075,20715,0,0,0,78.60,,
52096,450,23,11,12,10.29,,
52097,510,11,4,7,7.50,,
52098,511,34,15,19,7.50,,
52099,512,29,16,13,7.50,,
52100,448,17,7,10,62.50,,
52101,430,0,0,0,21.88,,
52102,393,131,46,85,8.36,,
52103,420,5,2,3,30.00,,
52104,425,4,3,1,18.75,,
52105,422,5,3,2,12.86,,
52106,540,16,12,4,12.86,,
52107,544,8,6,2,12.86,,
52108,2205,0,0,0,28.13,,
52112,3160,4,4,0,31.25,,
52113,3161,0,0,0,18.75,,
52121,B4-419Q,0,0,0,3655.40,4476.00,
52122,1260,21,7,14,50.00,,
52123,B4-619Q,0,0,0,5288.73,6476.00,
52124,B4-409AA,1,0,1,3199.99,3996.00,
52125,B4-609AA,1,0,1,4399.99,5836.00,
52127,1261,4,2,2,9.64,,
52128,B4-639HD,1,0,1,7183.40,8796.00,
52131,950,0,0,0,8.44,,
52132,1311,12,9,3,7.71,,
52133,2350,47,29,18,8.36,,
52134,2351,31,8,23,8.36,,
52135,2352,34,13,21,8.36,,
52136,1295,11,3,8,37.50,,
52137,1452,0,0,0,12.86,,
52138,1450,0,0,0,43.75,,
52146,7747,5,2,3,208.33,,
52148,6357,15,8,7,336.65,,
52149,6322,1,0,1,579.17,,
52150,6323,0,0,0,808.33,,
52151,6322C,1,1,0,449.99,,
52152,6327,0,0,0,1058.33,,
52153,6328,0,0,0,1287.50,,
52154,6327C,2,2,0,799.99,,
52156,6345,5,3,2,233.33,,
52157,6345CS,2,1,1,579.55,,
52158,6332,7,4,3,167.05,,
52160,7654,2,0,2,412.50,,
52161,7656,1,1,0,213.07,,
52162,7660,3,1,2,213.07,,
52164,7627,0,0,0,312.50,,
52165,6450,3,1,2,187.50,,
52166,6490,1,1,0,354.17,,
52167,6673,0,0,0,40.91,,
52168,6440,4,2,2,72.44,,
52169,6470,4,2,2,76.70,,
52171,6475,5,3,2,68.18,,
52172,6477,11,7,4,38.35,,
52173,6410,0,0,0,191.76,,
52174,6420,4,2,2,141.67,,
52175,7720,2,2,0,245.83,,
52176,7714,4,2,2,112.50,,
52181,6510SER,5,2,3,187.50,,
52184,7876-008,0,0,0,38.82,,
52185,7876-040,0,0,0,39.47,,
52186,7876-100,2,2,0,52.94,,
52187,7876-200,0,0,0,70.59,,
52195,7649003,12,0,12,90.68,,
52196,7650003,17,10,7,129.04,,
52205,A0-TPGN-Z30,2,1,1,1484.57,,
52206,A0-BOLT-REV,3,1,2,1404.32,,
52207,A0-BOLT-RAD,2,0,2,1203.70,,
52208,17-1526-23,4,2,2,56.17,,
52209,A0-1500-TEL,1,1,0,767.84,,
52210,A0-1800-TEL,3,1,2,794.72,,
52212,CA-0110-TG,2,0,2,103.52,,
52213,REV-TPGN-15T,0,0,0,2180.72,,
52214,REV-TPGN-18T,2,0,2,2291.79,,
52215,Z30-TPGN-15T,0,0,0,2256.95,,
52216,Z30-TPGN-18T,1,0,1,2368.02,,
52217,RAD-TPGN-15T,0,0,0,1984.11,,
52218,RAD-TPGN-18T,2,0,2,2095.93,,
52257,68870,0,0,0,108.63,,
52264,4131-4,3,0,3,121.11,,
52265,11574-4,1,1,0,84.99,,
52269,CA-0110-MO,0,0,0,112.35,,
52270,CA-0025-MO,1,0,1,132.41,,
52271,5010-4,0,0,0,20.37,,
52272,CA-0106,7,3,4,28.44,,
52273,CA-0105,2,2,0,36.56,,
52274,CA-0023,11,7,4,52.81,,
52276,PAK-0001,2,2,0,141.47,,
52277,PAK-0002,0,0,0,172.06,,
52278,PAK-0003,0,0,0,91.76,,
52279,PAK-0004,0,0,0,91.76,,
52280,PAK-0005,3,2,1,179.71,,
52281,PAK-0006,2,2,0,179.71,,
52282,5009-4,0,0,0,15.24,,
52283,5014-4,0,0,0,14.44,,
52284,CA-0087,77,16,61,15.85,,
52295,66470-7,6,4,2,34.99,,
52300,66362-7,7,5,2,32.83,,
52302,66363-7,2,2,0,32.83,,
52304,66364-7,1,0,1,32.83,,
52305,66364W7,2,1,1,27.99,,
52316,12761-7,11,6,5,13.89,,
52317,12750-6,7,3,4,8.39,,
52318,13066-7,7,3,4,25.62,,
52323,11849-2,6,3,3,7.24,,
52327,11848-4,7,6,1,6.23,,
52328,14137-7,2,2,0,11.55,,
52331,11900-4,4,2,2,22.92,,
52333,7563-6,10,5,5,6.97,,
52334,7594-3,7,6,1,10.28,,
52337,11862-6,1,0,1,6.58,,
52345,010-C1105-00,19,10,9,262.49,,
52346,010-C1106-00,19,10,9,262.49,,
52348,403252,4,0,4,6.41,,
52349,403312,5,3,2,6.74,,
52350,403372,4,0,4,6.74,,
52351,403502,4,2,2,7.10,,
52352,403562,8,5,3,7.72,,
52353,403622,4,2,2,7.78,,
52354,403752,5,0,5,9.12,,
52355,403872,4,2,2,9.81,,
52356,403892,6,5,1,10.14,,
52373,90885,4,2,2,170.73,,
52374,90195,2,2,0,209.76,,
52375,90160,5,5,0,117.07,,
52378,JBLPRV175,0,0,0,153.38,189.95,
52381,LLB-01WD-81-00,2,2,0,28.54,,
52385,LLB-55NN-81-00,0,0,0,73.17,,
52410,01-0366-07,1,0,1,2912.50,,
52411,01-0368-07,1,0,1,3596.40,,
52412,01-0364-07,2,1,1,4129.99,,
52413,01-0369-07,0,0,0,7196.40,,
52459,40190,0,0,0,37.81,54.99,
52460,01-0366-02,0,0,0,2912.50,,
52461,01-0368-02,0,0,0,3812.40,,
52462,40191,52,8,44,10.62,16.99,
52463,01-0368-09,0,0,0,4172.40,,
52464,01-0364-04,0,0,0,4820.40,,
52465,01-0364-34,0,0,0,5252.40,,
52466,40193,1,1,0,33.43,49.99,
52467,01-0369-02,0,0,0,7988.40,,
52468,01-0364-03,0,0,0,4460.40,,
52469,01-0369-03,0,0,0,7124.40,,
52471,40194,2,0,2,26.74,39.99,
52472,40195,11,5,6,26.74,39.99,
52473,40196,5,4,1,26.60,44.99,
52474,40197,0,0,0,28.12,44.99,
52478,40052,0,0,0,35.62,56.99,
52479,01-0372,2,0,2,479.99,,
52480,01-0370,0,0,0,630.88,,
52481,01-0373,1,1,0,797.03,,
52482,01-0371,2,0,2,1309.99,,
52484,N101200,0,0,0,480.11,,
52485,N121200,0,0,0,482.95,,
52486,N181100,0,0,0,530.68,,
52504,49001,0,0,0,45.62,,
52634,3020-P,0,0,0,16.28,,
52635,3021-P,0,0,0,18.56,,
52637,3025-P,0,0,0,15.33,,
52639,3034-P,0,0,0,15.13,,
52640,3035-P,0,0,0,12.88,,
52642,3040-P,0,0,0,17.01,,
52644,3050-P,0,0,0,15.46,,
52645,010-01142-00,0,0,0,337.49,,
52646,010-01142-10,0,0,0,337.49,,
52647,220,17,0,17,11.46,,15.98
52648,E70196,3,1,2,99.99,,
52654,305CRPN.VPK,68,28,40,22.40,,
52660,110R,10,4,6,9.53,,
52670,010-10806-30,0,0,0,47.99,,
52676,010-11814-10,0,0,0,14.99,,
52677,010-11823-00,0,0,0,17.49,,
52678,010-11828-10,19,4,15,11.69,,
52679,010-11828-11,0,0,0,12.99,,
52680,010-11867-10,0,0,0,31.99,,
52685,010-11874-00,0,0,0,20.50,,
52696,010-C1114-00,0,0,0,149.99,,
52697,010-C1113-00,0,0,0,112.49,,
52698,L255,0,0,0,105.82,119.00,
52699,WN3605,3,1,2,195.66,209.00,
52700,WT3605,2,2,0,188.18,229.00,
52781,010-11678-10,10,0,10,14.99,,
52842,10-263,2,2,0,29.56,,
52843,10-264,0,0,0,29.56,,
52844,10-265,3,3,0,29.56,,
52848,40043,88,88,0,18.58,,
52851,10-361,29,14,15,24.06,,
52865,41130,0,0,0,34.67,,
52871,47530,0,0,0,43.74,,
52873,42030,0,0,0,43.74,,
52880,43030,0,0,0,61.50,,
52891,42040,0,0,0,43.12,,
52903,42550,1,1,0,30.39,,
52909,42050,1,1,0,31.38,,
52921,831ST-1-14,0,0,0,111.75,,
52934,40645,9,3,6,12.52,,
52945,7943,9,4,5,10.24,,
52946,7944,6,2,4,10.24,,
52948,7945,2,2,0,10.24,,
53010,72-0452-01,0,0,0,1296.18,,
53011,240,0,0,0,9.47,,12.98
53019,A0-1500-CRP,0,0,0,552.90,,
53020,A0-1800-CRP,0,0,0,578.42,,
53021,CA-0002,0,0,0,240.74,,
53022,CA-0001,0,0,0,361.11,,
53023,CA-0113,0,0,0,57.78,,
53024,CA-0113-MO,0,0,0,60.99,,
53025,09-1258-2PC,2,2,0,10.00,,
53210,RA5099,6,2,4,9.62,,
53211,010-11254-02,0,0,0,28.79,,
53212,72-0634,1,1,0,299.99,,
53213,117005,6,3,3,186.51,,
53214,117505,3,0,3,186.51,,
53215,117905,1,1,0,186.51,,
53216,814-WLW,3,3,0,274.72,,
53218,010-10580-10,10,4,6,48.74,,
53219,GP1300,0,0,0,261.81,,
53220,GP1301,0,0,0,276.35,,
53221,GP2300,0,0,0,261.81,,
53222,GP2301,0,0,0,276.35,,
53228,42520,0,0,0,70.62,,
53232,47520,0,0,0,70.62,,
53233,48720,0,0,0,70.62,,
53234,42020,0,0,0,70.62,,
53248,L217,0,0,0,28.79,,
53257,LLB-472W-21-10,2,2,0,93.29,,
53259,01-0367-07,0,0,0,2995.83,,
53260,RM1500A,22,11,11,186.81,,
53261,RM2000A,45,2,43,240.59,,
53262,RM2000A-24,20,7,13,245.10,,
53280,CL-WWS,2,2,0,443.74,,
53281,CL-WWMH,0,0,0,416.03,,
53292,119002,6,2,4,169.72,,
53293,LLB-189R-21-00,0,0,0,7.62,,
53296,MCU002,0,0,0,160.00,,
53299,EFC-A1,1,0,1,42.00,,
53300,EFC-A2,0,0,0,70.36,,
53301,EFC-A3,5,0,5,64.99,,
53313,17860-2012,2,2,0,159.51,,
53320,1000864-26,5,3,2,10.76,,
53321,FAP7011C,0,0,0,933.33,,
53322,001-260-690-00,0,0,0,54.55,,
53327,010-12123-00,0,0,0,11.24,,
53331,E70240,0,0,0,95.82,,
53332,E70241,0,0,0,95.82,,
53333,010-12106-00,0,0,0,18.74,,
53334,010-12106-10,0,0,0,18.74,,
53347,FPHRC1002L00C00,3,1,2,137.28,,
53443,10-13406-107,0,0,0,155.56,,
53445,010-12067-00,0,0,0,35.10,,
53446,11330,74,43,31,21.83,,
53447,11350,6,2,4,17.36,,
53448,11372,13,2,11,17.36,,
53449,11349,14,9,5,35.75,,
53450,11373,9,3,6,35.75,,
53453,GP1203,0,0,0,363.62,,
53464,7713,1,0,1,189.22,,
53465,7717,2,1,1,189.22,,
53466,010-11971-00,0,0,0,10.48,,
53467,010-11972-00,0,0,0,10.48,,
53471,7788CR,5,2,3,38.77,,
53472,T10-471PB,1,1,0,67.50,,
53474,SP100,27,11,16,54.38,,
53475,SP200,9,0,9,126.92,,
53476,SP300,5,2,3,135.76,,
53480,LPS-1,11,9,2,144.00,,
53486,HRMK4300,0,0,0,553.86,,
53487,HRMK4200,0,0,0,430.39,,
53488,HRMK1504,0,0,0,85.65,,
53489,HRMK1304,0,0,0,156.46,,
53490,HRMK2300,0,0,0,191.35,,
53491,HRMK1503,4,2,2,20.51,,
53492,HRMK2200,0,0,0,68.05,,
53493,HRMK1201,0,0,0,70.96,,
53494,HRMK1301,0,0,0,332.40,,
53495,HRMK1204,0,0,0,29.52,,
53496,HRMK1300,0,0,0,53.66,,
53497,HRMK2203,0,0,0,10.05,,
53498,HRMK2202,0,0,0,25.88,,
53499,HRMK2503,0,0,0,12.21,,
53500,HRMK2504,0,0,0,13.81,,
53501,HRMK2502,0,0,0,12.94,,
53519,101071,13,4,9,73.36,,
53520,NQA-2447,0,0,0,132.30,,
53526,12VDUSB,28,10,18,12.12,,
53527,12VCOMBO,38,7,31,17.08,,
53529,703010,24,13,11,47.97,,
53530,703030,2,0,2,47.97,,
53531,703024,5,0,5,18.40,,
53533,320003,0,0,0,3.24,,
53534,320025,4,2,2,21.20,,
53535,320103,6,2,4,3.74,,
53536,320125,8,4,4,24.33,,
53537,320203,6,5,1,4.43,,
53538,320225,13,6,7,28.83,,
53539,320303,4,4,0,6.24,,
53540,320325,5,2,3,40.55,,
53575,T2P495,1,1,0,33.33,,
53590,10-13530-01,1,1,0,92.59,,
53592,81-47238-01,0,0,0,46.91,,
53680,40192,5,2,3,84.37,134.99,
53682,PP5203,0,0,0,392.72,,
53820,104050,2,2,0,66.54,,
53826,52026,0,0,0,295.99,,369.99
53828,52060,7,5,2,25.68,,
53830,27648,20,9,11,110.43,199.99,
53831,27636,15,10,5,141.14,259.99,
53832,27600,17,1,16,162.48,,
53833,29301,4,4,0,19.56,,
53834,32100G,18,18,0,19.50,,
53835,32110G,51,19,32,19.27,,
53836,32150G,82,11,71,19.75,,
53837,32003G,77,21,56,23.64,,
53839,32005G,62,22,40,25.86,,
53843,GP1036,0,0,0,363.62,,
53844,GP1037,0,0,0,363.62,,
53845,GP1040-02,0,0,0,334.53,,
53846,GP1040-04,0,0,0,334.53,,
53847,GP1040-08,0,0,0,334.53,,
53848,GP1040-11,0,0,0,334.53,,
53849,GP1040-13,0,0,0,334.53,,
53850,GP1040-14,0,0,0,334.53,,
53851,GP1040-15,0,0,0,334.53,,
53852,GP1040-18,0,0,0,334.53,,
53853,GP1048,0,0,0,334.53,,
53855,GP1065,0,0,0,363.62,,
53863,GP1080-13,0,0,0,385.44,,
53864,GP1080-14,0,0,0,385.44,,
53865,GP1080-18,0,0,0,385.44,,
53866,GP1088,0,0,0,385.44,,
53867,GP1170-04,0,0,0,385.44,,
53868,GP1170-06,0,0,0,385.44,,
53869,GP1176,0,0,0,385.44,,
53870,GP1200,0,0,0,349.08,,
53871,GP1201,0,0,0,363.62,,
53872,GP1202,0,0,0,363.62,,
53873,GP1204,0,0,0,363.62,,
53874,GP1400,0,0,0,298.17,,
53875,GP1401,0,0,0,312.72,,
53876,GP1500,0,0,0,261.81,,
53877,GP1040-07,0,0,0,334.53,,
53878,GP1501,0,0,0,276.35,,
53879,GP1502,0,0,0,276.35,,
53880,GP1503,0,0,0,276.35,,
53881,GP1505,0,0,0,276.35,,
53882,GP1506,0,0,0,276.35,,
53883,GP1507,0,0,0,276.35,,
53884,010-12029-00,0,0,0,1574.99,,
53885,GP1035,0,0,0,363.62,,
53886,GP1511,0,0,0,276.35,,
53887,GP1512,0,0,0,276.35,,
53888,GP1513,0,0,0,276.35,,
53889,GP1515,0,0,0,276.35,,
53890,GP1516,0,0,0,276.35,,
53891,GP1517,0,0,0,276.35,,
53892,GP1521,0,0,0,276.35,,
53893,GP1522,0,0,0,276.35,,
53894,GP1523,0,0,0,276.35,,
53898,GP1600,0,0,0,327.26,,
53899,GP1603,0,0,0,341.81,,
53900,GP1604,0,0,0,341.81,,
53901,GP1605,0,0,0,341.81,,
53902,GP1606,0,0,0,341.81,,
53903,GP1607,0,0,0,341.81,,
53904,GP1811,0,0,0,312.72,,
53906,GP1814,0,0,0,312.72,,
53907,GP1818,0,0,0,312.72,,
53908,GP2035,0,0,0,363.62,,
53909,GP2036,0,0,0,363.62,,
53910,GP2037,0,0,0,363.62,,
53911,GP2040-02,0,0,0,334.53,,
53912,GP2040-04,0,0,0,334.53,,
53913,GP2040-08,0,0,0,334.53,,
53914,GP2040-11,0,0,0,334.53,,
53915,GP2040-13,0,0,0,334.53,,
53916,GP2040-14,0,0,0,334.53,,
53917,GP2040-15,0,0,0,334.53,,
53926,16200A,28,21,7,4.13,,
53928,16303A,70,44,26,3.81,,
53931,26212GA,80,42,38,9.24,,
53940,GP2040-18,0,0,0,334.53,,
53941,GP2048,0,0,0,334.53,,
53942,GP2050-10,0,0,0,327.26,,
53943,GP2050-11,0,0,0,327.26,,
53944,GP2050-12,0,0,0,327.26,,
53945,GP2050-13,0,0,0,327.26,,
53946,GP2050-14,0,0,0,327.26,,
53947,GP2050-18,0,0,0,327.26,,
53955,GP2080-13,0,0,0,385.44,,
53957,GP2080-14,0,0,0,385.44,,
53958,GP2080-18,0,0,0,385.44,,
53959,GP2088,0,0,0,385.44,,
53960,GP2170-04,0,0,0,385.44,,
53961,GP2170-06,0,0,0,385.44,,
53962,GP2176,0,0,0,385.44,,
53963,GP2200,0,0,0,349.08,,
53964,GP2201,0,0,0,363.62,,
53965,GP2202,0,0,0,363.62,,
53966,GP2203,0,0,0,363.62,,
53967,GP2204,0,0,0,363.62,,
53968,GP2400,0,0,0,298.17,,
53969,GP2401,0,0,0,312.72,,
53970,GP2500,0,0,0,261.81,,
53971,GP2040-07,0,0,0,334.53,,
53972,GP2501,0,0,0,276.35,,
53973,GP2502,0,0,0,276.35,,
53974,GP2503,0,0,0,276.35,,
53976,GP2506,0,0,0,276.35,,
53977,GP2507,0,0,0,276.35,,
53978,GP2511,0,0,0,276.35,,
53979,GP2512,0,0,0,276.35,,
53988,GP2513,0,0,0,276.35,,
53989,GP2515,0,0,0,276.35,,
53990,GP2516,0,0,0,276.35,,
53991,GP2517,0,0,0,276.35,,
53992,GP2521,0,0,0,276.35,,
53993,GP2522,0,0,0,276.35,,
53994,GP2523,0,0,0,276.35,,
53998,GP2600,0,0,0,327.26,,
53999,GP2603,0,0,0,341.81,,
54000,GP2604,0,0,0,341.81,,
54001,GP2605,0,0,0,341.81,,
54002,GP2606,0,0,0,341.81,,
54003,GP2607,0,0,0,341.81,,
54007,PP4404,0,0,0,269.08,,
54008,PP4405,0,0,0,269.08,,
54009,PP4406,0,0,0,269.08,,
54011,PP4811,0,0,0,356.35,,
54013,PP4814,0,0,0,356.35,,
54014,PP4818,0,0,0,356.35,,
54015,PP5035,0,0,0,399.99,,
54016,PP5036,0,0,0,399.99,,
54017,PP5037,0,0,0,399.99,,
54018,PP5038,0,0,0,399.99,,
54020,PP5200,0,0,0,378.17,,
54021,PP5201,0,0,0,392.72,,
54022,PP5202,0,0,0,392.72,,
54023,PP5204,0,0,0,392.72,,
54024,RMX4404,0,0,0,392.72,,
54025,RMX4405,0,0,0,392.72,,
54026,RMX4406,0,0,0,392.72,,
54027,RMX4811,0,0,0,436.35,,
54029,RMX4814,0,0,0,436.35,,
54030,RMX4818,0,0,0,436.35,,
54039,740142-1,2,0,2,31.04,,
54040,740143-1,19,15,4,22.06,,
54042,780028-1,4,3,1,15.16,,
54056,1363831,2,2,0,796.02,,
54059,1854125,1,1,0,43.58,,
54060,1862050,9,9,0,39.94,,
54063,25M00,0,0,0,408.54,,
54064,25M00L,0,0,0,478.66,,
54065,25H00,0,0,0,414.63,,
54066,25H00L,0,0,0,457.32,,
54067,OT-0552BKA186,5,2,3,778.47,,
54080,A10-1225-2GS,4,2,2,499.99,,699.99
54094,R10-1001,0,0,0,276.43,,
54095,R10-1010-36,0,0,0,83.57,,
54096,R10-1020,0,0,0,90.00,,
54103,BOLT124,2,1,1,379.25,,
54104,BOLT129,5,3,2,393.67,,
54105,BOLT189,2,0,2,422.59,,
54106,BOLT249,0,0,0,451.50,,
54107,BOLT1212,0,0,0,422.59,,
54108,BOLT1812,2,2,0,451.50,,
54109,BOLT2412,1,0,1,480.36,,
54110,BRC4000,8,0,8,68.72,,
54113,BOLTLKCON,6,3,3,242.34,,
54114,BEA2000,4,3,1,162.72,,
54115,BEA2100,3,0,3,9.28,,
54120,BAW2005,0,0,0,23.17,,
54121,BAW2010,3,2,1,26.78,,
54122,BAW2015,5,2,3,30.39,,
54123,BAW2020,5,1,4,34.00,,
54124,BHW4003,0,0,0,33.28,,
54125,BHW4005,0,0,0,34.72,,
54126,BHW4007,0,0,0,36.17,,
54127,BHW4010,5,5,0,38.33,,
54128,V351CK,3,2,1,177.17,,
54129,V351LK,3,2,1,317.50,,
54130,8310CASBX,14,2,12,125.00,,
54151,748CAWBX,0,0,0,63.05,74.00,
54152,748CABBX,0,0,0,63.05,74.00,
54153,748CA24WBX,16,8,8,79.92,94.00,
54154,748CA24BBX,9,6,3,79.92,94.00,
54157,747DCWCS,13,5,8,48.10,64.00,
54158,747DCBCS,17,9,8,48.10,64.00,
54159,747CA24WCS,6,3,3,58.99,79.00,
54160,FVSLRSB12110A00,8,0,8,95.83,,
54161,FVSLRSB05110A00,0,0,0,95.83,,
54162,747CA24BCS,0,0,0,61.35,79.00,
54163,FVSLRSB0811SA00,0,0,0,95.83,,
54164,FVSLVS126B00A00,4,0,4,51.55,,
54165,757DCWBX,0,0,0,38.82,54.00,
54166,757DCBBX,0,0,0,38.82,54.00,
54167,757CA24WBX,9,9,0,51.41,64.00,
54168,757CA24BBX,8,8,0,53.47,64.00,
54169,SVS-460C,2,2,0,424.99,,
54176,817CAWBX,2,2,0,124.76,144.00,
54177,817CABBX,5,1,4,124.76,144.00,
54189,BKTLA-7C,2,2,0,22.58,,
54194,LP900S,28,20,8,69.94,,
54195,LP900D,3,0,3,46.10,,
54196,436977,4,2,2,217.68,,
54197,436979,6,2,4,242.58,,
54198,436981,0,0,0,286.35,,
54210,IRID-GO-ANT-ADA,1,1,0,41.11,,
54212,IRID-GO-BAT,2,2,0,59.34,,
54213,IRID-GO-BRACKET,0,0,0,35.56,,
54214,IRID-GO-CASE,0,0,0,31.11,,
54216,2000016407,9,5,4,39.71,,
54223,004-2100-7,5,0,5,11.14,,
54239,SXW9510-30,2,2,0,95.60,,
54240,SXW9510-40,0,0,0,95.60,,
54241,SXW9510-60,0,0,0,95.60,,
54242,SXW9510-80,8,4,4,95.60,,
54244,81-47240-01,0,0,0,192.59,,
54301,817CA24WBX,0,0,0,141.04,169.00,
54303,817CA24BBX,4,4,0,135.62,169.00,
54306,7482CAWBX,6,3,3,92.27,104.00,
54307,7482CABBX,6,4,2,92.27,104.00,
54308,707CHWBX,0,0,0,30.73,,
54309,707CHBBX,9,2,7,30.73,,
54319,827CATCS,4,0,4,14.94,,
54321,9510CABBX,51,20,31,211.73,299.00,
54322,9206CABBX,0,0,0,81.20,,
54323,9406CAABX,0,0,0,86.91,99.00,
54324,9303CABCS,8,8,0,30.31,39.00,
54328,MRKCA02BX,17,9,8,15.09,19.99,
54329,MRKCA03BX,5,5,0,15.07,18.99,
54331,74701WBG,12,5,7,7.11,,
54333,74701BBG,20,10,10,7.11,,
54338,70733WBG,1,0,1,5.77,,
54339,70733BBG,7,2,5,5.77,,
54340,80701WBG,15,10,5,5.95,,
54343,82701GBG,16,10,6,2.48,,
54344,747CL,10,6,4,17.40,,
54416,2000013194,0,0,0,26.47,,
54454,010-12117-20,3,1,2,337.49,,
54455,010-01403-10,0,0,0,899.99,,
54456,010-12117-30,0,0,0,862.49,,
54457,010-12117-02,0,0,0,22.49,,
54486,104000-105-000-15,4,4,0,20.67,,
54487,104200-500-000-15,5,0,5,21.00,,
54489,104300-200-001-15,4,4,0,23.33,,
54493,122200-505-020-15,5,5,0,54.67,,
54494,122200-505-040-15,8,2,6,54.67,,
54495,122200-505-060-15,9,6,3,54.67,,
54497,136200-701-999-13,2,0,2,21.33,,
54501,132000-500-004-15,7,1,6,110.21,,
54502,132000-105-004-14,6,0,6,107.06,,
54506,LLB-11TD-61-00,0,0,0,9.00,,
54516,LLB-202C-21-00,0,0,0,6.23,,
54524,LLB-542C-31-00,0,0,0,878.05,,
54529,00820,0,0,0,7.19,,
54530,00820AL,0,0,0,6.79,,
54531,00820MG,0,0,0,10.76,,
54555,65UW03B-7,0,0,0,104.51,,
54556,65UW03G-7,0,0,0,104.51,,
54557,65UW03W-7,0,0,0,104.51,,
54558,65UW06B-7,0,0,0,146.87,,
54559,65UW06G-7,0,0,0,146.87,,
54560,65UW06W-7,0,0,0,148.33,,
54561,65UW12B-7,0,0,0,245.45,,
54563,65UW12W-7,0,0,0,245.45,,
54587,MGR350B,40,22,18,94.39,,
54588,MR762BRGB,7,4,3,81.67,,
54593,MRGB65,9,2,7,66.09,,
54594,MR6W,11,8,3,25.23,,
54595,MR6B,8,2,6,25.23,,
54596,MR4.3W,5,3,2,43.09,,
54597,MR4.3B,2,2,0,43.09,,
54598,MRC5B,17,0,17,14.02,,
54599,MRC10,7,7,0,18.28,,
54603,MCKGB350W.6,4,3,1,127.99,,
54604,MCKGB350B.6,6,1,5,133.91,,
54605,1011200,16,9,7,7.92,,
54606,1016200,11,5,6,18.52,,
54608,1039,9,0,9,34.97,,
54609,1044,13,5,8,20.08,,
54610,1070,14,6,8,18.24,,
54612,KTF003,5,3,2,214.60,,
54613,1990,7,1,6,134.51,,
54614,1991,14,4,10,168.16,,
54615,1992,9,5,4,134.51,,
54616,1993,8,5,3,168.16,,
54617,KTF004,2,0,2,177.60,,
54618,33710,0,0,0,85.00,,
54619,33718,2,0,2,81.28,,
54620,33742,0,0,0,95.05,,
54622,33732,0,0,0,120.94,,
54624,33750,4,0,4,168.65,,
54626,33704,0,0,0,54.03,,
54628,13701,12,6,6,28.11,,
54629,13702,7,2,5,28.11,,
54630,13712,0,0,0,62.95,,
54631,13704,8,5,3,28.38,,
54632,13707,3,3,0,28.11,,
54633,13709,0,0,0,28.11,,
54635,13705,9,6,3,28.38,,
54636,KTF001,0,0,0,222.20,,
54637,KTF002,2,2,0,177.60,,
54638,33807,11,7,4,81.28,,
54639,33817,1,1,0,81.28,,
54640,33842,0,0,0,96.48,,
54641,33818,2,0,2,87.86,,
54642,33832,7,5,2,120.94,,
54643,33840,2,2,0,120.94,,
54644,33850,6,2,4,168.65,,
54645,33860,0,0,0,202.81,,
54646,33826,3,3,0,234.99,,
54647,33811,4,1,3,55.08,,
54648,33819,0,0,0,54.79,,
54649,13801,7,0,7,28.38,,
54650,13802,0,0,0,28.38,,
54651,13812,4,4,0,62.95,,
54652,13804,5,1,4,28.38,,
54653,13807,9,8,1,28.65,,
54654,13809,8,4,4,28.65,,
54656,13805,5,2,3,28.65,,
54657,KT9797,0,0,0,205.66,,
54658,KT9794,0,0,0,167.96,,
54659,33103,2,2,0,65.41,,
54660,33104,1,0,1,65.41,,
54663,33132,0,0,0,108.46,,
54664,33140,0,0,0,108.46,,
54665,33150,6,2,4,149.35,,
54666,33112,1,1,0,46.23,,
54667,33113,3,3,0,39.99,,
54668,13101,6,6,0,22.51,,
54669,13102,0,0,0,22.51,,
54670,13108,0,0,0,57.59,,
54671,13110,8,3,5,22.51,,
54672,13122,0,0,0,22.51,,
54673,13123,0,0,0,23.15,,
54675,13120,6,6,0,22.51,,
54678,KT9799,3,3,0,191.15,,
54679,KT9796,2,1,1,173.29,,
54680,32804,1,0,1,64.34,,
54681,32805,0,0,0,64.36,,
54682,32842,5,1,4,74.66,,
54683,32803,7,4,3,80.89,,
54684,32832,5,4,1,113.29,,
54685,32840,0,0,0,113.29,,
54686,32850,5,2,3,128.98,,
54688,32810,1,0,1,44.43,,
54689,32812,0,0,0,44.43,,
54690,12801,5,0,5,21.10,,
54691,12803,8,2,6,21.10,,
54692,12810,6,0,6,53.89,,
54693,12812,0,0,0,20.48,,
54694,12828,6,5,1,21.10,,
54695,12827,3,0,3,21.50,,
54697,12821,16,6,10,21.10,,
54698,KT9798,3,1,2,196.73,,
54699,KT9795,0,0,0,173.29,,
54700,32904,2,2,0,67.89,,
54701,32905,5,1,4,64.36,,
54702,32942,0,0,0,73.49,,
54706,32950,4,1,3,139.99,,
54707,32909,0,0,0,43.50,,
54708,32910,0,0,0,51.41,,
54709,12901,6,5,1,21.50,,
54710,12902,1,1,0,21.50,,
54711,12903,6,2,4,53.89,,
54712,12904,1,0,1,20.88,,
54713,12916,6,6,0,21.50,,
54714,12915,6,0,6,21.50,,
54715,12913,1,1,0,49.46,,
54716,12911,3,2,1,21.50,,
54717,KTF024,0,0,0,228.66,,
54718,39004,7,3,4,82.81,,
54719,39005,4,2,2,79.99,,
54721,39040,6,2,4,129.98,,
54722,39009,0,0,0,57.15,,
54723,19150,1,0,1,171.78,,
54724,19151,0,0,0,222.24,,
54725,19001,0,0,0,29.99,,
54726,19002,8,4,4,30.55,,
54727,19007,2,2,0,60.03,,
54728,19003,5,4,1,30.55,,
54729,19005,6,6,0,34.93,,
54730,19020,6,3,3,64.11,,
54731,19004,9,6,3,29.19,,
54732,33730,1,1,0,214.99,,
54743,F16-0151-1,11,5,6,68.24,,
54749,965,21,3,18,27.76,,39.98
54750,MRWT69RGB,2,2,0,113.58,,
54751,96-272-F,0,0,0,10.04,,
54755,1057-1-F,6,2,4,24.80,,
54756,73-100-F,9,4,5,39.19,,
54757,91-113-F,0,0,0,21.93,,
54759,3050-F,1,0,1,347.69,,
54762,1830,2,0,2,253.10,,
54764,1832,0,0,0,253.10,,
54765,1833,3,1,2,226.46,,
54768,1836,0,0,0,229.08,,
54769,1837,3,2,1,252.67,,
54771,1838,0,0,0,267.48,,
54772,53-135-F,1,1,0,62.01,,
54773,2340,18,8,10,18.29,,
54774,53-010-F,4,3,1,9.95,,
54775,5023,6,0,6,17.21,,
54776,5024,9,4,5,25.12,,
54777,85-272-F,0,0,0,261.36,,
54778,5032,18,11,7,52.28,,
54779,5068,0,0,0,17.54,,
54808,1001100,10,4,6,18.43,,
54809,1002100,8,2,6,21.51,,
54810,1003100,17,12,5,22.94,,
54811,1007,0,0,0,4.15,,
54812,1007100,6,6,0,8.66,,
54820,DRS4W,7,2,5,967.95,,
54831,535-3-125,0,0,0,127.50,,
54832,535-5-125,0,0,0,146.25,,
54833,535-7-125,0,0,0,160.50,,
54839,44010250,11,5,6,306.86,,
54851,81400200,0,0,0,56.42,,
54852,81400300,4,2,2,84.99,,
54853,81400330,0,0,0,200.07,,
54855,83116025,4,2,2,281.13,,
54856,83116035,5,2,3,315.03,,
54857,83125035,12,2,10,340.01,,
54865,MX7001CR,0,0,0,218.08,,
54866,MX7002CR,0,0,0,218.08,,
54867,MX7003CR,0,0,0,218.08,,
54869,910-002,0,0,0,165.63,212.00,
54870,910-001,0,0,0,171.88,220.00,
54871,910-004,0,0,0,193.75,248.00,
54872,910-014,0,0,0,165.63,212.00,
54873,910-009,0,0,0,309.38,396.00,
54874,910-012,0,0,0,309.38,396.00,
54875,910-044,0,0,0,315.63,404.00,
54876,910-029,0,0,0,534.38,684.00,
54877,910-026,0,0,0,690.63,884.00,
54878,800-036,0,0,0,75.00,96.00,
54879,800-038,0,0,0,78.13,100.00,
54880,800-041,0,0,0,81.25,104.00,
54881,800-037,0,0,0,106.25,136.00,
54882,800-010,0,0,0,106.25,136.00,
54883,800-011,0,0,0,106.25,136.00,
54884,800-014,0,0,0,106.25,136.00,
54885,800-030,0,0,0,125.00,160.00,
54886,SW45640,19,8,11,16.84,,
54887,800-037Y,0,0,0,137.50,176.00,
54888,SW46700,0,0,0,6.46,,
54889,SW46710,0,0,0,15.60,,
54890,800-010Y,0,0,0,137.50,176.00,
54891,800-011Y,0,0,0,137.50,176.00,
54892,800-YMKIT1,0,0,0,512.50,656.00,
54893,SW19150,0,0,0,10.73,,
54894,SW19155,2,2,0,14.63,,
54895,SW61900,0,0,0,4.55,,
54897,SW21314,12,8,4,31.36,,
54898,SW19170,11,7,4,21.07,,
54899,SW19175,6,0,6,11.13,,
54900,SW66670,0,0,0,27.24,,
54901,SW45670,8,4,4,46.73,,
54902,SW66610,38,6,32,5.15,,
54903,SW66620,0,0,0,3.95,,
54904,SW66630,0,0,0,4.63,,
54905,SW66640,0,0,0,8.68,,
54910,SW31215,61,32,29,22.19,,
54914,151710,7,5,2,105.32,,
54965,RF4050,26,13,13,67.80,105.02,
54974,MR-2BLK,6,3,3,11.67,,
54975,MR-2BLU,2,2,0,11.67,,
54976,MR-2R,0,0,0,11.67,,
54977,MR-3BLK,0,0,0,11.67,,
54978,MR-3BLU,3,0,3,11.67,,
54979,MR-3R,0,0,0,11.67,,
54980,MT-OPTI,0,0,0,61.33,,
54982,PNP121,0,0,0,6.70,,
54985,FAMP3112011CA00,0,0,0,108.17,,
54987,PNP14,0,0,0,1.44,,
54988,PNP88A,0,0,0,8.21,,
54991,PNP171R,0,0,0,8.84,,
54993,PNP182,0,0,0,6.70,,
54995,PNP186,0,0,0,8.21,,
54996,PNP187,0,0,0,9.14,,
54997,PNP188,0,0,0,9.70,,
54998,PNP189,0,0,0,9.70,,
55000,PNP27T,0,0,0,1.46,,
55001,PNP28T,0,0,0,1.46,,
55003,RA2028010000,2,0,2,891.28,985.50,
55004,RA2034010000,0,0,0,975.93,1079.10,
55005,RA2040010000,2,0,2,1054.07,1165.50,
55006,RA2046010000,2,0,2,1380.47,1526.40,
55007,RA554130,5,2,3,58.17,,
55008,RA554131,6,3,3,79.02,,
55009,RA554132,2,2,0,92.74,,
55010,RA554133,10,4,6,98.23,,
55011,RA554136,5,2,3,80.12,,
55013,RC61914,0,0,0,72.73,,
55014,RC61983,0,0,0,34.54,,
55015,RC63201,0,0,0,103.64,,
55016,RC63216,0,0,0,230.94,,
55017,RC7251-1.0A,0,0,0,58.31,,
55018,RC72504,0,0,0,26.46,,
55019,RC72536S,0,0,0,60.27,,
55020,RC72544,0,0,0,99.57,,
55021,RC72581,0,0,0,2.93,,
55022,RC81940,0,0,0,18.95,,
55027,RF128,0,0,0,2.93,,
55029,RF41000,0,0,0,4.99,,
55030,RF1759,0,0,0,4.41,,
55031,RF437,2,2,0,5.88,,
55032,RF1765,0,0,0,6.60,,
55033,RF103,0,0,0,28.88,44.73,
55034,RF104,0,0,0,27.39,42.43,
55035,RF418,0,0,0,15.02,23.27,
55036,RF418C,0,0,0,17.06,26.42,
55038,RF1032,16,16,0,13.86,21.21,
55039,RF1033,3,3,0,15.42,23.60,
55040,RF1034,0,0,0,20.21,30.91,
55041,RF1035,0,0,0,74.98,114.71,
55042,RF1851,0,0,0,6.38,,
55043,RF1806,0,0,0,4.78,,
55044,RF616,7,7,0,4.84,,
55045,RF617,0,0,0,6.38,,
55046,RF618,0,0,0,10.70,,
55047,RF619,0,0,0,16.48,25.22,
55048,RF620,0,0,0,28.67,43.85,
55050,RF1047,4,4,0,16.53,25.29,
55056,RF1058,0,0,0,5.88,,
55057,RF113,0,0,0,0.72,,
55058,RF1135-16,33,28,5,3.82,,
55059,RF114,0,0,0,0.72,,
55063,RF115X1,0,0,0,13.06,20.22,
55064,RF115X1/2,0,0,0,13.06,20.22,
55065,RF115X3/4,0,0,0,13.06,20.22,
55066,RF115X5/8,0,0,0,13.06,20.22,
55067,RF122,0,0,0,5.51,,
55068,RF123,0,0,0,5.51,,
55069,RF124,0,0,0,5.51,,
55070,RF125,0,0,0,9.54,,
55071,RF13101-2,4,1,3,9.42,,
55074,RF1315GRN,0,0,0,2.20,,
55083,RF1317R,0,0,0,1.46,,
55088,RF150,0,0,0,5.14,,
55089,RF151,0,0,0,5.88,,
55090,RF156,0,0,0,5.35,,
55100,RF167,0,0,0,9.99,,
55102,RF1685-3,0,0,0,3.12,,
55103,RF1685-4,0,0,0,3.12,,
55104,RF1685-5,0,0,0,3.12,,
55105,RF1685-6,0,0,0,3.91,,
55106,RF1685-8,0,0,0,5.51,,
55107,RF1685-10,0,0,0,9.43,,
55108,RF1685-12,0,0,0,11.82,,
55113,RF1706,0,0,0,2.93,,
55114,RF173,0,0,0,19.73,30.56,
55115,RF75,0,0,0,27.59,42.72,
55116,RF180,0,0,0,6.52,,
55118,RF1850S,3,0,3,4.78,,
55120,RF1852,0,0,0,7.04,,
55121,RF1853,0,0,0,9.90,,
55122,RF639,0,0,0,14.88,23.05,
55124,RF640,0,0,0,22.50,34.86,
55126,RF641,0,0,0,27.59,42.72,
55128,RF185,0,0,0,11.96,,
55129,RF186,0,0,0,20.06,30.69,
55130,RF187,0,0,0,23.15,35.42,
55131,RF20100,30,5,25,13.72,20.98,
55132,RF20101,0,0,0,7.83,,
55133,RF20111,0,0,0,9.99,,
55134,RF20151,0,0,0,10.70,,
55136,RF20151A,0,0,0,13.56,20.73,
55137,RF20171,0,0,0,14.27,21.83,
55138,RF20180,0,0,0,15.69,24.01,
55139,RF20202,16,1,15,19.98,30.56,
55140,RF20212,0,0,0,22.12,33.84,
55141,RF20302,9,4,5,27.11,41.48,
55142,RF20312,1,1,0,29.62,45.31,
55143,RF20332,0,0,0,57.09,87.35,
55144,RF20711,0,0,0,20.69,31.66,
55145,RF2180,0,0,0,5.14,,
55147,RF2181,0,0,0,5.14,,
55148,RF2182,0,0,0,5.88,,
55150,RF2183,0,0,0,6.60,,
55151,RF2184,6,0,6,11.46,,
55153,010-01159-00,0,0,0,712.49,,
55154,RF251,0,0,0,3.67,,
55155,RF25109,6,2,4,9.14,,
55156,RF254,0,0,0,9.62,,
55158,RF2665,0,0,0,14.32,21.92,
55159,RF536,0,0,0,2.93,,
55161,RF280,0,0,0,7.33,,
55162,RF291,0,0,0,4.78,,
55163,RF94,0,0,0,3.16,,
55164,RF94A,0,0,0,2.93,,
55165,RF5013,0,0,0,4.04,,
55166,RF5023,0,0,0,5.88,,
55167,RF294,15,12,3,6.31,,
55168,RF738,16,6,10,4.78,,
55169,RF30,0,0,0,35.70,54.63,
55170,RF602,0,0,0,42.89,65.62,
55171,RF30101,0,0,0,13.05,,
55172,RF31712,0,0,0,19.26,29.46,
55173,RF35100,49,3,46,14.27,21.83,
55174,RF35101,20,9,11,9.99,,
55175,RF35140,0,0,0,18.54,28.38,
55176,RF35151,1,1,0,11.41,,
55177,RF35202,0,0,0,24.26,37.11,
55178,RF35302,0,0,0,32.83,50.22,
55179,RF35312,16,16,0,34.25,52.40,
55180,RF3128,4,4,0,35.28,53.98,
55181,RF3129,8,4,4,39.69,60.72,
55184,RF3134,4,2,2,72.77,111.34,
55185,RF3131,0,0,0,71.30,109.09,
55188,RF3133,60,10,50,10.26,,
55189,RF3136,3,3,0,3.67,,
55199,RF4025,16,6,10,5.80,,
55200,RF4026,6,0,6,5.88,,
55201,RF41100,26,14,12,15.00,22.94,
55202,RF41101,0,0,0,12.40,,
55203,RF41110,0,0,0,19.98,30.56,
55204,RF41111,0,0,0,18.54,28.38,
55205,RF41140,4,0,4,21.41,32.74,
55206,RF41151,0,0,0,21.41,32.74,
55209,RF41712,40,0,40,18.45,33.84,
55210,RF40100,6,4,2,19.62,30.01,
55211,RF40140,0,0,0,26.40,40.39,
55212,RF413,0,0,0,4.41,,
55213,RF4410,0,0,0,119.75,164.90,
55214,RF4415,0,0,0,122.84,169.15,
55215,RF4430,0,0,0,129.01,177.65,
55216,RF4435,0,0,0,129.01,177.65,
55217,RF44100,0,0,0,42.44,64.94,
55218,RF45110,14,2,12,19.98,30.56,
55219,RF453,0,0,0,19.10,29.23,
55220,RF46100,2,0,2,43.89,67.15,
55221,RF469,0,0,0,13.51,20.66,
55222,RF48,0,0,0,5.51,,
55224,RF483,0,0,0,2.11,,
55225,RF484,0,0,0,2.11,,
55226,RF485,0,0,0,2.88,,
55227,RF48A,0,0,0,4.78,,
55228,RF49,0,0,0,6.31,,
55229,RF494,0,0,0,12.70,,
55230,RF498,13,13,0,2.33,,
55231,RF499,0,0,0,3.56,,
55232,RF5,0,0,0,42.84,66.35,
55233,RF50,0,0,0,4.84,,
55234,RF5000,0,0,0,17.63,26.98,
55235,RF5001,0,0,0,17.27,26.42,
55236,RF5010,5,0,5,19.47,29.78,
55238,RF5020,0,0,0,35.28,53.98,
55239,RF5400,5,2,3,17.20,26.31,
55240,RF5400B,0,0,0,17.20,26.31,
55241,RF5410,9,4,5,18.54,28.38,
55245,RF5003,0,0,0,3.96,,
55246,RF5005,0,0,0,5.88,,
55247,RF50100HL,0,0,0,41.49,63.48,
55248,RF51,0,0,0,8.81,,
55249,RF5100,2,2,0,5.80,,
55250,RF5101,25,25,0,5.80,,
55251,RF5105,0,0,0,7.98,,
55252,RF5106,0,0,0,8.71,,
55253,RF51100,6,6,0,21.64,33.11,
55255,RF51110,0,0,0,32.78,50.15,
55256,RF55110,5,0,5,29.98,45.85,
55257,RF56100,6,3,3,55.65,85.16,
55258,RF571,0,0,0,8.07,,
55259,RF573,0,0,0,12.85,,
55260,RF64100,0,0,0,63.33,96.90,
55261,RF64110,0,0,0,85.56,130.90,
55263,RF663,0,0,0,12.55,,
55264,RF74100,0,0,0,85.56,130.90,
55265,RF74100AW,0,0,0,149.44,228.65,
55266,RF520,0,0,0,3.56,,
55267,RF521,0,0,0,3.56,,
55271,RF5402,0,0,0,5.70,,
55274,RF5405,0,0,0,6.41,,
55276,BOW4512D,0,0,0,1585.69,2114.00,
55278,BOW5512D,1,0,1,1758.94,2345.00,
55281,BOW9512D,0,0,0,3009.94,4013.00,
55282,RF544,0,0,0,15.23,23.60,
55283,RF559,0,0,0,13.06,20.22,
55285,BPJE2,1,0,1,257.07,358.00,
55287,RF6080,0,0,0,14.77,22.59,
55289,BPSE2,3,2,1,180.22,251.00,
55291,RF58,6,4,2,50.35,78.00,
55292,EZDOCK2,0,0,0,493.71,,
55293,RF59,53,14,39,5.14,,
55294,RF6000,8,3,5,10.98,,
55295,RF6002,0,0,0,12.83,,
55296,RF6010C,18,8,10,5.35,,
55297,RF6093L,19,8,11,4.73,,
55298,RF6093M,12,6,6,4.63,,
55300,RF6093S,26,10,16,3.91,,
55302,RF6100,0,0,0,34.42,52.66,
55303,RF6110,0,0,0,44.42,67.96,
55304,RF6120,3,3,0,44.42,67.96,
55305,RF6130,0,0,0,49.44,75.65,
55308,RF6200,0,0,0,47.78,73.10,
55309,RF6210,1,1,0,59.42,90.91,
55311,RF6220,0,0,0,66.11,101.15,
55315,BP29,0,0,0,69.43,81.00,
55316,RF6321,7,5,2,94.63,144.78,
55317,BP2910,0,0,0,76.08,106.00,
55318,BP2916,0,0,0,100.69,134.00,
55319,RF614,0,0,0,5.62,,
55320,RF615,0,0,0,4.41,,
55321,RF615A,0,0,0,4.84,,
55324,BP125G10,0,0,0,108.60,136.00,
55327,RF625,0,0,0,22.05,33.73,
55328,BP150G10,0,0,0,133.07,155.00,
55330,BP185G10,0,0,0,198.00,231.00,
55331,RF627,0,0,0,5.07,,
55332,RF628,0,0,0,7.24,,
55333,ZE250,0,0,0,16.07,,
55334,ZE425,0,0,0,16.07,,
55335,ZEHC100,1,1,0,58.50,,
55336,RF629,0,0,0,10.16,,
55337,RF630,0,0,0,14.24,22.06,
55338,RF631,0,0,0,23.95,37.10,
55339,RF632,0,0,0,36.74,56.91,
55342,RF635,13,3,10,7.48,,
55343,RF636,2,2,0,11.09,,
55344,RF637,0,0,0,23.52,35.98,
55346,RF67,4,3,1,42.11,65.22,
55347,RF6710,0,0,0,127.22,194.65,
55348,RF6720,0,0,0,149.44,228.65,
55350,RF677,0,0,0,42.44,64.94,
55351,RF686,294,294,0,0.72,,
55352,RF687,3,0,3,0.83,,
55353,RF688,0,0,0,1.46,,
55354,RF7,0,0,0,89.50,138.63,
55357,RF713,0,0,0,18.37,28.11,
55363,RF8080BLU-2,0,0,0,12.83,,
55365,RF8080GRY-2,5,5,0,12.83,,
55366,RF8080R-2,2,1,1,12.83,,
55367,RF8081BLU,3,0,3,9.46,,
55368,RF8081R,0,0,0,9.46,,
55369,RF8090-08,0,0,0,11.09,,
55371,RF8090-11,0,0,0,13.56,,
55373,RF8090-16,8,3,5,13.86,,
55374,RF8090-21,5,2,3,21.09,,
55375,RF816,0,0,0,29.88,41.65,
55376,RF823002,17,15,2,55.53,76.46,
55380,RF917,0,0,0,10.51,,
55381,RF919,0,0,0,12.12,,
55382,RF92,0,0,0,14.96,22.89,
55383,RFSCISSORS,0,0,0,51.21,70.51,
55384,RFSPLICE-6,11,4,7,45.04,62.01,
55385,RFSPLICE-F15,25,0,25,18.49,25.46,
55387,RFSPLICE-F20,18,3,15,19.11,26.31,
55388,RFSPLICE-F25,6,3,3,19.73,27.16,
55400,TY-10WSP,7,5,2,5.32,,
55401,TY-15WSP,0,0,0,5.32,,
55402,TY-KITBLU,26,9,17,10.58,,
55403,WD-1W,12,7,5,13.27,,
55407,A80289,3,0,3,245.82,,
55408,199248,5,5,0,1.36,,
55409,199249,5,0,5,3.59,,
55410,199210,10,10,0,1.41,,
55411,199211,1,1,0,5.31,,
55412,199214,3,3,0,2.88,,
55413,199215,0,0,0,7.58,,
55414,199259,7,0,7,2.88,,
55415,199260,2,2,0,10.85,,
55416,199217,8,8,0,3.93,,
55417,199252,6,6,0,1.76,,
55418,199253,2,2,0,4.90,,
55419,199228,6,6,0,2.08,,
55420,199229,0,0,0,7.78,,
55421,199257,3,0,3,3.80,,
55422,199258,2,0,2,13.78,,
55423,309025,5,4,1,13.83,,
55424,309002,2,0,2,127.24,,
55425,309003,17,12,5,2.30,,
55426,309103,11,6,5,2.35,,
55427,309125,23,9,14,13.83,,
55428,309102,4,1,3,127.24,,
55429,309203,3,0,3,2.93,,
55430,309225,14,14,0,19.10,,
55431,309202,1,0,1,175.86,,
55432,312325,10,4,6,18.72,,
55433,312303,7,2,5,2.87,,
55434,312225,5,4,1,18.72,,
55435,312203,2,0,2,2.87,,
55436,312425,4,3,1,18.72,,
55437,312403,4,2,2,2.87,,
55438,312603,7,3,4,2.87,,
55439,312625,2,0,2,18.72,,
55440,312503,14,9,5,2.87,,
55441,312525,2,2,0,18.72,,
55442,311303,0,0,0,2.28,,
55443,311325,3,3,0,13.57,,
55444,311225,12,9,3,13.57,,
55445,311203,16,8,8,2.28,,
55446,311425,7,4,3,13.57,,
55447,311403,6,2,4,2.28,,
55448,311625,6,4,2,13.57,,
55449,311603,5,3,2,2.28,,
55450,311525,6,4,2,13.57,,
55451,311503,7,3,4,2.28,,
55452,310399,0,0,0,27.78,,
55453,310325,5,3,2,13.57,,
55454,310303,7,3,4,2.28,,
55455,310499,4,3,1,26.30,,
55456,310425,4,2,2,12.86,,
55457,310403,0,0,0,2.16,,
55458,310699,2,1,1,26.30,,
55459,310625,3,1,2,12.86,,
55460,310603,0,0,0,2.16,,
55461,310599,1,0,1,26.30,,
55462,310525,3,1,2,12.86,,
55463,310503,0,0,0,2.16,,
55476,010-11617-50,6,4,2,33.74,,
55477,010-11617-52,5,3,2,41.24,,
55478,010-12234-05,8,2,6,26.24,,
55480,010-12233-00,17,1,16,14.99,,
55481,010-12234-00,4,4,0,14.99,,
55482,010-12199-01,0,0,0,14.99,,
55483,010-12247-00,0,0,0,11.24,,
55484,010-12233-01,0,0,0,11.24,,
55485,010-12234-01,0,0,0,11.24,,
55486,010-12199-03,17,4,13,18.74,,
55487,010-12199-04,5,0,5,17.24,,
55488,010-12233-03,9,4,5,22.49,,
55510,310203,14,9,5,2.28,,
55511,310225,4,3,1,13.57,,
55525,E70297,2,1,1,789.46,,
55526,E70298,1,1,0,1105.25,,
55527,E70258,1,0,1,1815.78,,
55529,E70242,0,0,0,95.82,,
55530,010-11170-00,15,10,5,2.03,,
55558,70403163,3,2,1,279.99,,
55567,21-200-001A,0,0,0,526.13,,
55568,21-300-001A,0,0,0,200.22,,
55570,21-200-002A,0,0,0,751.94,,
55572,21-300-002A,0,0,0,294.00,,
55576,313203,0,0,0,2.16,,
55577,313225,1,0,1,15.22,,
55578,313299,6,2,4,31.15,,
55579,314203,0,0,0,2.16,,
55580,314225,0,0,0,15.83,,
55581,314303,0,0,0,2.16,,
55582,314325,0,0,0,15.07,,
55583,314399,1,1,0,30.83,,
55584,315203,0,0,0,2.73,,
55585,315225,1,1,0,20.57,,
55586,315303,0,0,0,2.73,,
55587,315325,0,0,0,20.57,,
55588,315399,5,2,3,42.13,,
55633,CPM50,2,1,1,113.14,,
55635,JMPSW800,5,1,4,151.52,205.95,
55642,FAMP3472X02CA00,0,0,0,53.00,,
55650,FAMP3022B02CA00,0,0,0,106.72,,
55652,FAMP3022S02CA00,0,0,0,106.72,,
55653,FAMP3022X01CA00,0,0,0,106.72,,
55654,FAMP3022X02CA00,0,0,0,106.72,,
55655,FAMP3022B11CA00,0,0,0,108.17,,
55659,FAMP3022X11CA00,0,0,0,108.17,,
55663,AK-1000-HV-S,0,0,0,33.75,,
55664,AK-1000-HV-M,2,2,0,24.99,,
55665,AK-1000-HV-L,0,0,0,33.75,,
55666,AK-1000-HV-XL,0,0,0,33.75,,
55667,AC-1100-RB-3XL,0,0,0,256.50,,
55668,AB-1100-RB-3XL,0,0,0,233.44,,
55669,AS-1100-RB-3XL,0,0,0,433.13,,
55670,FAMP3022X12CA00,0,0,0,108.17,,
55672,FAMP3012B02CA00,0,0,0,104.55,,
55675,FAMP3012X01CA00,0,0,0,104.55,,
55676,FAMP3012X02CA00,0,0,0,104.55,,
55681,FAMP3012X11CA00,0,0,0,106.72,,
55682,FAMP3012X12CA00,0,0,0,106.72,,
55683,1190-FT,12,12,0,8.57,,
55686,FAMP2982B02CA00,0,0,0,103.09,,
55691,FAMP2982X01CA00,0,0,0,103.09,,
55697,FAMP2982X11CA00,0,0,0,103.09,,
55699,FAMP2492B01CA00,0,0,0,103.09,,
55702,FAMP2492S02CA00,0,0,0,103.09,,
55704,FAMP2492X02CA00,0,0,0,103.09,,
55714,800CAXBX,115,115,0,64.09,79.99,
55716,FAMP3002X01CA00,0,0,0,106.72,,
55717,FAMP3002X02CA00,0,0,0,106.72,,
55722,FAMP3002X11CA00,0,0,0,106.72,,
55725,FAMP2992B02CA00,0,0,0,95.04,,
55740,FAMP3262X01CA00,0,0,0,101.64,,
55741,FAMP3262X02CA00,0,0,0,101.64,,
55743,433,6,6,0,21.43,,
55747,FAMP3262X11CA00,0,0,0,104.55,,
55755,FAMP3252X01CA00,0,0,0,101.64,,
55756,FAMP3252X02CA00,0,0,0,101.64,,
55762,FAMP3252X12CA00,0,0,0,103.09,,
55767,37041-0010,32,10,22,237.81,,
55768,8M0092085,7,5,2,128.04,,
55770,001-266-010-00,4,0,4,118.18,,
55772,5225-AIS,6,1,5,159.36,,
55773,5239,1,1,0,120.98,,
55776,3004,2,2,0,85.13,,
55777,3015,8,7,1,130.98,,
55778,3019,4,2,2,163.73,,
55791,S-9200P,18,9,9,20.49,,
55792,S-9201P,6,6,0,17.89,,
55793,S-9202P,20,17,3,11.51,,
55795,WN3508,0,0,0,77.44,79.95,
55796,WT3508,2,2,0,82.74,99.95,
55797,WN3606,0,0,0,94.78,109.00,
55798,WT3606,1,0,1,113.61,119.00,
55808,11300301,2,0,2,26.84,,
55809,31431512,4,4,0,264.78,,
55810,31431712,9,4,5,264.78,,
55811,31431912,5,2,3,264.78,,
55812,31432112,4,2,2,264.78,,
55813,31431530,9,1,8,301.23,,
55814,31431730,7,4,3,301.23,,
55815,31431930,5,2,3,301.23,,
55816,21502131,7,2,5,92.14,,
55817,21502141,4,2,2,92.14,,
55818,0070DP0CLR,8,5,3,9.32,,
55819,0070DP1CLR,0,0,0,9.83,,
55820,0071DP0CLR,14,9,5,9.17,,
55821,0072DP1CLR,9,4,5,13.71,,
55822,0126DP0BLK,15,5,10,9.16,,
55823,0248DP0CLR,0,0,0,10.75,,
55824,0271DP0CHR,20,10,10,22.69,,
55825,0338DP1CLR,4,4,0,6.74,,
55826,0338DP2CLR,1,0,1,7.13,,
55827,0339DP0CHR,5,5,0,31.92,,
55828,0554DP,18,18,0,8.07,,
55829,0559DP,23,0,23,5.56,,
55830,0561DP4CHR,10,10,0,13.95,,
55833,0831DP0PLB,0,0,0,21.47,,
55834,0841DP0CHR,0,0,0,12.25,,
55835,0958DP0CHR,0,0,0,12.09,,
55836,1059P00DP,3,2,1,26.64,,
55837,1091DP1BLK,11,8,3,41.36,,
55838,1091DP1WHT,10,3,7,41.36,,
55839,1092DP1WHT,39,14,25,36.94,,
55840,1092DP3BLK,6,1,5,36.94,,
55841,1194DP0CHR,7,0,7,19.12,,
55842,1205DP0CHR,5,0,5,52.48,,
55844,1232DP2CHR,10,5,5,13.53,,
55845,1262DP0CHR,0,0,0,15.17,,
55846,1267DP0CHR,0,0,0,15.92,,
55847,1267DP0ZNC,8,7,1,9.19,,
55848,1270DPG99A,6,5,1,15.39,,
55850,1313DP0CHR,6,1,5,18.13,,
55851,8501DP,4,0,4,39.88,,
55852,G-37,5,3,2,275.53,,
55853,G-55,0,0,0,406.95,,
55854,G-85,0,0,0,623.60,,
55855,G-125,0,0,0,924.18,,
55856,SG-7,0,0,0,62.84,,
55857,SG-11,0,0,0,70.65,,
55858,SG-16,0,0,0,75.34,,
55859,SG-23,0,0,0,96.02,,
55860,SG-37,0,0,0,99.54,,
55861,SG-55,0,0,0,146.39,,
55862,SG-85,0,0,0,181.52,,
55863,SG-125,0,0,0,190.49,,
55864,162HF012,0,0,0,899.39,,
55865,162HR012,0,0,0,899.39,,
55866,162MF012,0,0,0,875.00,,
55867,162MR012,0,0,0,1033.54,,
55868,2500RFK,1,1,0,250.00,,
55892,3134,8,8,0,12.86,,
55894,0342-BK,4,3,1,11.16,,
55895,0423,0,0,0,11.08,,
55934,ZDIGAIT1500,2,1,1,562.46,,
55935,M8AR,0,0,0,676.80,,
55936,M16AR,0,0,0,1021.60,,
55956,M1008,5,0,5,8.00,,
55972,M4232,2,2,0,15.97,,
55973,M4364,16,4,12,9.95,,
55974,M4416,3,2,1,9.04,,
55975,M4516,10,5,5,10.02,,
55977,M4716,1,1,0,10.80,,
55978,M4901,1,0,1,42.74,,
55979,M4916,8,3,5,10.71,,
55980,M4965,13,5,8,34.54,,
55981,M5001,0,0,0,47.63,,
55983,M5016,8,3,5,11.61,,
55984,M5032,5,0,5,19.18,,
55986,M5401,7,0,7,24.40,,
55987,M5416,15,9,6,5.14,,
55988,M5616,12,11,1,12.03,,
55989,M5716,14,4,10,11.03,,
55990,M5916,13,0,13,8.14,,
55991,M6132,5,5,0,19.35,,
55992,M6301,13,6,7,60.03,,
55993,M6311,0,0,0,20.65,,
55994,M6316,6,3,3,17.65,,
55995,M6332,9,5,4,21.99,,
56002,M9132,0,0,0,24.93,,
56005,M9424,12,5,7,10.42,,
56019,11959-1,7,3,4,14.55,,
56029,940800280,0,0,0,1917.79,,2229.99
56031,31501712,7,3,4,295.15,,
56032,31501912,10,3,7,295.15,,
56033,31502112,15,9,6,295.15,,
56034,31501722,1,0,1,295.15,,
56035,31501922,3,2,1,295.15,,
56036,31502122,0,0,0,295.15,,
56037,31501731,13,8,5,320.46,,
56038,31501931,17,6,11,320.46,,
56039,31502131,11,6,5,320.46,,
56041,31501741,1,1,0,320.46,,
56042,31501941,2,2,0,320.46,,
56043,31502141,3,3,0,320.46,,
56044,31501532,9,5,4,320.46,,
56045,31501542,2,0,2,320.46,,
56052,4128-110-E04,0,0,0,102.64,,
56054,4138-111-E65,14,3,11,122.84,,
56056,4148-153-E75,1,0,1,205.95,,
56060,4158-153-E75,0,0,0,293.91,,
56061,4558-153-E75,2,0,2,831.74,,
56062,4558-163-E75,1,0,1,882.90,,
56063,105-013,26,22,4,64.73,,
56064,4238-121-E07,0,0,0,140.97,,
56065,4248-153-E09,0,0,0,196.14,,
56066,4258-153-E09,0,0,0,271.91,,
56067,4348-153-E09,2,0,2,248.08,,
56068,4358-153-E09,0,0,0,329.73,,
56069,253-120-01,12,3,9,31.77,,
56070,253-220-01,62,32,30,33.93,,
56071,253-320-01,24,10,14,53.31,,
56073,253-121-01,19,11,8,38.22,,
56074,253-221-01,19,6,13,42.51,,
56075,253-321-01,19,8,11,59.77,,
56077,94-726-00,0,0,0,16.38,,
56078,94-727-00,7,3,4,16.14,,
56079,4648-153-E07,1,0,1,275.64,,
56080,1700-001-030,21,3,18,97.25,,
56081,1700-011-030,4,1,3,104.39,,
56082,1700-021-030,2,2,0,113.40,,
56083,358-001-10,0,0,0,130.41,,
56084,358-011-10,0,0,0,143.11,,
56085,357-013-10,10,5,5,45.86,,
56086,357-113-10,4,0,4,48.70,,
56087,357-103-10,11,11,0,53.69,,
56088,357-012-10,12,0,12,45.86,,
56089,357-112-10,14,0,14,48.70,,
56090,357-102-10,11,0,11,53.69,,
56091,357-014-10,8,2,6,45.86,,
56092,357-114-10,7,3,4,48.70,,
56113,330-021,0,0,0,29.03,,
56114,357-116-10,0,0,0,44.74,,
56115,357-106-10,27,13,14,48.70,,
56116,355-020-10,0,0,0,19.87,,
56117,355-010-10,0,0,0,23.20,,
56118,355-110-10,10,10,0,32.55,,
56119,355-100-10,0,0,0,36.79,,
56120,358-000-10,7,0,7,96.96,,
56121,358-010-10,0,0,0,125.99,,
56122,359-111-30,0,0,0,29.15,,
56123,359-111-40,16,4,12,36.39,,
56124,277-3110,14,9,5,29.06,,
56125,277-4110,13,6,7,31.83,,
56126,3200-001,0,0,0,168.96,,
56127,3200-101,2,2,0,168.96,,
56128,010-12117-01,7,4,3,56.24,,
56130,8050-305-526,4,2,2,142.19,,
56131,8050-305-626,7,5,2,165.23,,
56132,8050-305-426,3,1,2,182.51,,
56133,3010-000,8,2,6,23.42,,
56134,94-009-10,10,8,2,49.26,,
56135,94-009-12,0,0,0,44.26,,
56136,94-009-20,0,0,0,115.70,,
56137,255-323,76,53,23,10.17,,
56138,255-313,15,13,2,10.17,,
56139,255-315,18,12,6,13.33,,
56140,255-325,36,28,8,13.33,,
56141,340-001,20,3,17,13.74,,
56142,182-200,3,0,3,67.71,,
56143,183-039-08,10,10,0,36.49,,
56144,183-029-14,10,1,9,44.49,,
56145,183-029-18,26,15,11,35.83,,
56151,DS6-P,0,0,0,11.23,,
56152,DS-H6,6,3,3,13.30,,
56173,L258,0,0,0,119.14,139.00,
56175,101296,8,6,2,100.55,,
56181,35SPP,7,4,3,79.62,,
56182,113,5,5,0,46.76,,
56183,123,0,0,0,179.36,,
56185,132,0,0,0,155.96,,
56186,134,3,3,0,272.96,,
56187,SVS-560CF,1,0,1,534.99,,
56188,SVS-560CF-E,0,0,0,699.30,,
56194,SVS-460CE,1,1,0,484.99,,
56196,SVS-880CE,1,0,1,859.99,,
56199,101288,6,2,4,76.28,,
56201,GA-88,2,2,0,70.00,,
56202,101292,13,4,9,76.28,,
56211,20-001-01A,0,0,0,606.92,,
56216,166000,7,5,2,278.85,,
56217,21101MG,0,0,0,25.34,,
56218,21104MG,0,0,0,30.06,,
56220,20709AL,0,0,0,19.65,,
56221,20711AL,0,0,0,32.79,,
56227,FTT631512000B00,5,0,5,127.05,,
56231,M1AR,8,4,4,436.80,,
56233,000-0127-52,0,0,0,16.68,,
56234,S-3511BC,11,6,5,23.69,,
56235,S-3511RC,2,2,0,23.69,,
56247,M2AR,0,0,0,436.80,,
56248,76-0022-00,10,5,5,35.50,,
56249,806-1884,0,0,0,1025.01,,
56251,809-0918,6,3,3,348.80,,
56252,809-0946,6,3,3,20.06,,
56253,815-2524-02,0,0,0,1621.70,,
56254,815-3524-02,1,0,1,1858.52,,
56262,OC15SUK31A,0,0,0,71.98,,
56263,OC15SUK31B,0,0,0,71.98,,
56264,OC15SUK18,0,0,0,70.22,,
56268,804010,0,0,0,248.87,,
56269,8085050,1,1,0,58.16,,
56270,8040,0,0,0,27.51,,
56273,80850,0,0,0,12.48,,
56303,S-226BC,23,12,11,28.31,,
56304,S-226WC,33,16,17,28.31,,
56305,S-230BC,56,0,56,20.91,,
56306,S-230WC,93,69,24,20.91,,
56307,S-1444C,0,0,0,8.60,,
56308,S-1445C,0,0,0,9.81,,
56309,6744C,7,7,0,20.43,,
56310,6746C,13,4,9,36.85,,
56316,11220006,0,0,0,2428.19,,
56317,11220001,0,0,0,2428.19,,
56318,11220008,0,0,0,1831.86,,
56319,11220005,0,0,0,1831.86,,
56352,RDP154,0,0,0,6666.67,,
56353,RSB0070-085A,0,0,0,3617.78,,
56354,RSB0070-086A,0,0,0,4728.89,,
56355,RSB0070-087A,0,0,0,5973.33,,
56367,2880.91,0,0,0,69.81,,
56393,F38-2050B-1,0,0,0,131.68,,
56394,F38-2050R-1,0,0,0,131.68,,
56395,F38-2060B-1,2,2,0,71.59,,
56396,F38-2060R-1,4,0,4,71.59,,
56420,01-0385-01,1,1,0,4829.99,,
56421,01-0385-02,0,0,0,5252.40,,
56422,15504-101,0,0,0,1046.04,,
56423,15505-101,0,0,0,1280.81,,
56424,15014-101,2,0,2,518.11,,
56425,TT9X12E,0,0,0,687.93,,
56426,TT9X12EI,2,0,2,806.53,,
56427,15038-101,0,0,0,628.15,,
56428,15042-101,0,0,0,966.80,,
56429,15047-101,0,0,0,2134.78,,
56430,15056-002,5,2,3,219.63,,
56431,15057-001,4,2,2,219.63,,
56432,15058-001,7,4,3,219.63,,
56433,15066-001,0,0,0,239.60,,
56436,15086-001,0,0,0,14.74,,
56437,15092-001,8,3,5,12.96,,
56438,15093-001,6,3,3,24.14,,
56441,CAP0303,4,3,1,13.66,,
56442,15102-104,0,0,0,610.05,,
56443,CAP0304,4,2,2,2.17,,
56444,15103-104,1,0,1,568.88,,
56445,15113-101,0,0,0,508.25,,
56446,15114-101,0,0,0,540.20,,
56447,15115-101,0,0,0,548.64,,
56448,15116-101,0,0,0,588.40,,
56451,SBH-12,25,13,12,26.80,,
56452,SBR-13LI,18,9,9,34.09,,
56453,SBT-13,8,5,3,17.65,,
56455,SEP-10A,12,7,5,21.18,,
56462,940100170,4,2,2,104.64,,
56463,940100160,3,2,1,165.69,,
56464,940100150,3,1,2,191.85,,
56468,940100190,3,2,1,270.34,,
56469,940100210,4,2,2,279.06,,
56471,941000010,2,0,2,305.22,,
56474,8M0092073,4,2,2,189.88,,
56475,8M0092074,2,2,0,202.11,,
56480,8M0092070,20,15,5,396.33,,
56481,8M0092071,16,3,13,110.96,,
56482,8M0092068,2,0,2,60.17,,
56484,8M0092069,4,3,1,177.41,,
56487,8M0092063,6,5,1,64.15,,
56488,8M0092064,13,10,3,100.23,,
56489,8M0092072,2,0,2,17.09,,
56490,8M0092065,12,7,5,13.67,,
56491,8M0092066,12,6,6,18.99,,
56492,8M0092067,8,6,2,9.99,,
56515,IRIS740,1,0,1,1027.00,,
56520,30133-001D,3,0,3,20.24,,
56521,30133-002D,0,0,0,23.79,,
56522,30133-103D,5,0,5,28.93,,
56524,30142-202,2,2,0,56.80,,
56525,30142-104,0,0,0,86.61,,
56526,15107-001,0,0,0,12.44,,
56527,15107-002,0,0,0,11.54,,
56528,8M0095972,5,3,2,137.24,,
56529,8M0095973,2,2,0,54.99,,
56541,OCTAFMDRESYSA-9,1,1,0,1071.58,,
56544,AP3522,0,0,0,929.08,,
56548,MGA097B6,0,0,0,32.89,,
56549,MGA015PB6,3,2,1,11.83,,
56550,2000020942,4,4,0,118.24,,
56554,15120-001,0,0,0,228.19,,
56567,289-029,0,0,0,70.85,,
56568,15122-001,0,0,0,228.19,,
56633,TW5K85900,0,0,0,35.48,,
56669,808-9010,5,3,2,16.28,,
56672,7635,15,10,5,66.33,,
56676,MILSPK652B,0,0,0,45.43,,
56677,MILSPK652S,0,0,0,41.26,,
56691,001-500752,1,1,0,619.79,,
56701,P105072,0,0,0,114.92,,
56703,RL-ADM,0,0,0,63.00,,
56704,RL-ARM,0,0,0,81.56,,
56705,RL-RM,1,1,0,28.94,,
56706,RL-501,0,0,0,11.76,,
56707,RL-502,0,0,0,11.76,,
56708,RL-503,0,0,0,11.76,,
56709,RL-504,0,0,0,11.76,,
56711,RL-506,0,0,0,11.76,,
56712,RL-507,0,0,0,11.76,,
56761,"25 220",0,0,0,107.46,,
56762,"25 221",2,2,0,31.73,,
56771,416-BK,15,0,15,5.73,,
56796,710211-1,119,119,0,68.18,,
56809,A0-1800-CF,0,0,0,1552.38,,
56810,A0-1800-CFT,0,0,0,1743.77,,
56811,1852073,1,0,1,45.26,,
56834,C118-10,0,0,0,71.93,,
56835,C118-20,0,0,0,81.78,,
56844,B-81-WM,14,6,8,163.44,,
56845,010-11647-20,0,0,0,1312.49,,
56848,17288-1000,27,13,14,14.72,,
56850,MMGGX6800000,1,1,0,31.95,,
56851,MSVGGGX08000,0,0,0,15.97,,
56852,MSVGGGX10000,0,0,0,21.79,,
56853,MMGGX10120000,1,1,0,60.99,,
56881,3200-011,12,6,6,219.14,,
56882,358-100-10,0,0,0,108.57,,
56883,358-110-10,5,0,5,137.56,,
56884,94-181-02,7,3,4,12.16,,
56885,94-181-03,25,11,14,11.17,,
56886,94-238-03,13,8,5,26.59,,
56889,94-800-26,0,0,0,34.10,,
56896,94-571-00,6,2,4,36.53,,
56898,94-619-00,0,0,0,27.04,,
56899,94-620-00,2,2,0,45.45,,
56914,6080,7,1,6,24.13,,
56918,42,5,2,3,31.99,,
56925,M4AR,0,0,0,675.20,,
56934,010-12181-20,3,1,2,997.49,,
56935,010-12181-21,0,0,0,997.49,,
56936,010-12181-22,2,2,0,997.49,,
56941,900-4WPW,4,2,2,24.99,,
56943,900-6WP,4,2,2,43.23,,
56944,900-6WPW,0,0,0,43.23,,
56946,CSP6,7,2,5,56.72,,
56947,CSP6-F,1,1,0,59.99,,
56948,CSP6-PTC,2,0,2,88.50,,
56949,80-511-0001-01,17,7,10,24.99,,
56950,80-511-0002-01,19,9,10,24.99,,
56951,80-511-0003-01,22,15,7,25.99,,
56952,80-511-0004-01,17,9,8,24.99,,
56954,80-511-0005-01,9,0,9,28.59,,
56955,80-511-0006-01,9,9,0,24.99,,
56956,80-511-0007-01,13,9,4,28.59,,
56957,80-511-0008-01,14,9,5,24.99,,
56958,80-511-0010-01,16,7,9,29.99,,
56959,1100-BK,0,0,0,11.50,,
56961,1101-BK,4,2,2,13.80,,
56982,A80162,5,5,0,63.91,,
56983,A80161,2,2,0,63.91,,
56984,750S-01710,2,0,2,111.78,,
56987,WCPC-6,0,0,0,13.09,,
56988,WCPC-6.5,0,0,0,13.09,,
56989,WCPC-7,0,0,0,10.96,,
56990,WCPC-7.5,0,0,0,10.96,,
56991,WCPC-8,0,0,0,11.38,,
56992,WCPC-8.5,0,0,0,11.38,,
56993,WCPC-9,0,0,0,12.24,,
56994,WCPC-9.5,0,0,0,12.24,,
56995,WCPC-10,0,0,0,13.87,,
56996,WCPC-10.5,0,0,0,13.87,,
56997,WCPC-11,0,0,0,14.95,,
56998,WCPC-11.5,0,0,0,25.12,,
56999,WCPC-12,0,0,0,19.75,,
57000,WCPC-12.5,0,0,0,27.26,,
57001,WCPC-13,0,0,0,22.38,,
57002,WCPC-13.5,0,0,0,29.39,,
57003,WCPC-14,0,0,0,31.55,,
57004,WCPC-14.5,0,0,0,31.55,,
57005,WCPC-15,0,0,0,33.70,,
57006,WCPC-15.5,0,0,0,33.70,,
57010,710204-1,0,0,0,136.36,,
57013,SET0148,0,0,0,45.64,,
57014,SET0149,1,1,0,50.79,,
57015,SET0150,1,0,1,54.00,,
57016,OC-0422VEL8,1,0,1,213.96,,
57017,010-12122-10,11,4,7,18.74,,
57023,5310012,0,0,0,230.77,,
57024,5310112,2,2,0,229.63,,
57025,5310024,0,0,0,227.56,,
57026,5310124,0,0,0,266.03,,
57027,SMC12,1,0,1,96.15,,
57028,SMC24,0,0,0,118.59,,
57029,67650,0,0,0,82.50,,
57033,41321,5,3,2,25.25,,
57034,41331,0,0,0,26.67,,
57036,520-14,0,0,0,283.57,,
57037,T9025406,22,15,7,5.43,,
57045,58155,4,3,1,278.90,,
57047,58319,0,0,0,23.79,,
57048,500-0395-00,5,3,2,790.83,,
57054,441,3,3,0,4.21,,
57055,"GOTECH 1.0",0,0,0,752.96,,
57062,403902,7,3,4,11.13,,
57063,404152,5,3,2,11.50,,
57064,404172,5,1,4,12.62,,
57065,404202,6,4,2,13.19,,
57066,404252,7,5,2,15.56,,
57067,404302,6,3,3,16.55,,
57068,20711,2,2,0,22.99,,
57076,MD-6,10,10,0,46.56,,
57079,242-WH,1,1,0,7.15,,
57080,117WR-2,0,0,0,33.63,,
57081,60WR-2,0,0,0,33.63,,
57082,75WR-2,0,0,0,34.76,,
57083,164WR-2,1,0,1,42.54,,
57084,117WR-4,0,0,0,25.41,,
57085,60WR-4,0,0,0,26.55,,
57086,75WR-4,0,0,0,28.26,,
57087,175WR-4,1,1,0,28.35,,
57097,A80330,2,0,2,34.08,,
57109,010-12256-21,0,0,0,37.49,,
57110,010-12256-19,0,0,0,9.99,,
57145,117WR-1,0,0,0,25.41,,
57146,60WR-1,1,1,0,25.41,,
57147,75WR-1,0,0,0,26.55,,
57148,164WR-1,1,1,0,33.08,,
57149,117WR-3,0,0,0,42.54,,
57150,60WR-3,1,0,1,42.54,,
57151,75WR-3,0,0,0,42.80,,
57152,164WR-3,3,1,2,52.86,,
57163,385310076,19,18,1,34.45,,
57167,720080-1,0,0,0,42.65,,
57212,1139,6,4,2,52.15,,
57213,1408,4,1,3,190.85,,
57214,1147,2,0,2,112.34,,
57215,1148,3,2,1,110.70,,
57216,1522,4,1,3,98.73,,
57217,1216,4,2,2,167.16,,
57218,1455,0,0,0,80.14,,
57219,1450,3,0,3,107.27,,
57220,1457,0,0,0,138.08,,
57221,1456,0,0,0,175.46,,
57222,1200,5,3,2,287.71,,
57223,1225,4,2,2,294.63,,
57224,1463,0,0,0,257.81,,
57225,1464,2,0,2,316.27,,
57226,1227,0,0,0,503.71,,
57227,1223,2,2,0,422.33,,
57228,1217,0,0,0,673.30,,
57229,1222,0,0,0,547.05,,
57230,1201,0,0,0,685.22,,
57231,1221,0,0,0,969.86,,
57232,1210,3,3,0,178.23,,
57233,1228,4,2,2,311.33,,
57234,1214,3,2,1,186.91,,
57235,1206,0,0,0,235.34,,
57236,1230,0,0,0,326.84,,
57237,1202,3,3,0,326.84,,
57238,1208,1,0,1,188.14,,
57239,1231,0,0,0,188.15,,
57240,1502,0,0,0,222.92,,
57241,1190,1,1,0,279.85,,
57243,1193,0,0,0,422.77,,
57244,1168,0,0,0,218.59,,
57245,1218,1,1,0,1498.66,,
57248,1475,0,0,0,42.97,,
57249,1474,0,0,0,268.33,,
57250,1473,0,0,0,73.14,,
57251,1472,4,2,2,38.37,,
57252,1478,5,2,3,52.49,,
57253,7480,6,3,3,1.97,,
57254,7481,4,4,0,2.53,,
57255,7482,11,7,4,2.53,,
57256,7483,0,0,0,2.53,,
57257,7484,0,0,0,2.53,,
57258,7485,5,5,0,2.53,,
57259,7490,0,0,0,2.97,,
57260,7491,5,5,0,2.97,,
57261,7492,5,5,0,2.97,,
57262,7493,5,1,4,2.97,,
57263,7494,0,0,0,2.97,,
57264,7495,0,0,0,2.97,,
57272,010-12199-00,0,0,0,14.99,,
57273,0200MB0DP1,1,1,0,87.00,,
57274,SPK2218,10,2,8,6.17,,
57275,SPK1614,15,6,9,6.17,,
57276,6225-R,9,4,5,297.50,,
57278,A28162,8,2,6,108.32,,
57280,5290,0,0,0,32.32,,
57296,R70014,1,1,0,25.56,,
57297,68950,0,0,0,245.25,,
57315,600033-1,70,54,16,63.52,,
57316,600031-1,0,0,0,127.05,,
57317,600032-1,7,0,7,158.81,,
57321,2700K,0,0,0,28.29,,
57322,2701K,9,9,0,36.36,,
57323,2702K,10,10,0,44.59,,
57350,TY-KITW,14,11,3,10.58,,
57351,001-341-830-00,0,0,0,536.36,,
57353,760025-1,0,0,0,75.89,,
57354,"UFO X RV",6,4,2,164.40,,
57355,5266CR,0,0,0,22.43,,
57364,327,12,12,0,6.81,,
57373,KG1020-4,0,0,0,7.86,9.35,
57374,KG1020-9,0,0,0,18.33,23.38,
57381,010-12378-20,0,0,0,997.02,,
57382,010-12379-20,0,0,0,1177.50,,
57383,010-12380-20,0,0,0,1109.99,,
57386,MILPLATE1,1,0,1,13.07,,
57387,830ST-3-100-125,0,0,0,176.43,,
57388,830ST-5-100-125,0,0,0,195.75,,
57389,OC15SUK10,0,0,0,29.18,,
57391,137000-701-999-16,40,34,6,8.21,,
57396,0425-BK,0,0,0,9.68,,
57400,104110,8,5,3,15.95,,
57401,108910,2,1,1,32.88,,
57402,104310,2,1,1,15.95,,
57403,104710,3,2,1,15.95,,
57404,103910,2,2,0,15.95,,
57405,104210,6,3,3,15.95,,
57406,104610,3,2,1,15.95,,
57411,A80291,3,1,2,46.86,,
57412,A80292,1,0,1,63.91,,
57413,A0-0900-TEG,0,0,0,637.96,,
57414,A0-1500-CF,0,0,0,1360.99,,
57415,A0-1500-CFT,1,0,1,1552.38,,
57416,MI-001ST,0,0,0,120.37,,
57417,CA-0088,6,1,5,211.03,,
57421,40934,3,0,3,18.40,,
57422,40934CASE,0,0,0,149.25,,
57426,A80312,4,3,1,25.56,,
57427,A80247,12,3,9,63.91,,
57430,BCPC-6,0,0,0,13.09,,
57431,BCPC-6.5,0,0,0,13.09,,
57432,BCPC-7,0,0,0,10.96,,
57433,BCPC-7.5,0,0,0,10.96,,
57434,BCPC-8,0,0,0,11.38,,
57435,BCPC-8.5,0,0,0,11.38,,
57436,BCPC-9,0,0,0,12.24,,
57437,BCPC-9.5,0,0,0,12.24,,
57438,BCPC-10,0,0,0,13.87,,
57439,BCPC-10.5,0,0,0,13.87,,
57440,BCPC-11,0,0,0,14.95,,
57441,BCPC-11.5,0,0,0,25.12,,
57442,BCPC-12,0,0,0,19.75,,
57443,BCPC-12.5,0,0,0,27.26,,
57444,BCPC-13,0,0,0,22.38,,
57445,BCPC-13.5,0,0,0,29.39,,
57446,BCPC-14,0,0,0,31.55,,
57447,BCPC-14.5,0,0,0,31.55,,
57448,BCPC-15,0,0,0,33.70,,
57449,BCPC-15.5,0,0,0,33.70,,
57465,010-11129-00,0,0,0,20.99,,
57466," 106910",4,2,2,21.43,,
57467," 104510",3,2,1,15.95,,
57468,ZDIGDTV100,1,1,0,187.46,,
57473,SN2060A,4,4,0,97.99,,
57474,SN2011,2,2,0,89.99,,
57475,SN2010,4,3,1,124.99,,
57488,F17727,8,2,6,32.75,,
57501,36400-1000,15,8,7,20.25,,
57502,36400-0000,0,0,0,20.25,,
57503,010-11957-00,0,0,0,18.74,,
57510,HS2500HP,19,11,8,24.45,,
57512,010-11613-10,10,1,9,56.24,,
57517,30142-201,2,2,0,53.96,,
57525,001-167-890-10,1,0,1,59.09,,
57527,001-105-780-10,0,0,0,31.82,,
57530,001-105-810-10,0,0,0,47.27,,
57531,001-341-660-00,0,0,0,272.73,,
57536,PP4800-12,0,0,0,356.35,,
57537,MS-CL602,4,4,0,109.88,,
57538,1039,11,11,0,4.29,,
57539,1008,6,6,0,3.16,,
57542,24012000,0,0,0,1753.87,,
57543,24020800,0,0,0,834.77,,
57544,24021500,0,0,0,1309.22,,
57545,24022500,4,2,2,2296.47,,
57546,24095100,0,0,0,3965.15,,
57549,70403105,4,2,2,459.99,,
57560,81400100,0,0,0,41.38,,
57561,81500600,0,0,0,93.28,,
57562,81500700,0,0,0,168.49,,
57563,81500100,0,0,0,69.20,,
57564,81500200,1,0,1,100.03,,
57565,81500300,3,1,2,142.16,,
57566,81500350,0,0,0,303.13,,
57567,81500400,0,0,0,142.93,,
57568,81500500,0,0,0,312.16,,
57569,81400400,0,0,0,154.95,,
57570,81400500,2,0,2,188.05,,
57573,806-1055,0,0,0,580.28,,
57574,010-12117-08,1,1,0,14.99,,
57578,1154,10,10,0,5.58,,
57579,1011,1,1,0,3.36,,
57581,1004,2,2,0,2.64,,
57584,SET0044,0,0,0,545.60,,
57585,15101-104,0,0,0,556.80,,
57587,001-337-420-00,0,0,0,309.09,,
57589,001-337-450-00,0,0,0,259.09,,
57590,001-337-430-00,0,0,0,177.27,,
57591,001-337-440-00,0,0,0,231.82,,
57599,SVS880FMK,0,0,0,40.00,,
57601,65100,0,0,0,132.11,,
57607,43990-0051,3,1,2,22.83,,
57608,11944-7,4,4,0,7.63,,
57611,BT1-514-1,0,0,0,21.13,34.99,
57612,BT1-515-1,0,0,0,21.13,34.99,
57616,BT1-651-2,0,0,0,18.08,29.99,
57617,BT1-663-2,0,0,0,15.99,24.99,
57618,OCTAFG1012,0,0,0,385.00,,
57619,R70374,11,2,9,85.22,,
57620,R70439,5,3,2,29.82,,
57621,R70373,3,2,1,68.17,,
57625,SP-70-1,0,0,0,2029.30,,
57626,DVD5800,0,0,0,176.42,,
57641,26244GA,20,6,14,15.19,,
57643,27672,21,19,2,80.63,149.99,
57646,27902,231,0,231,17.23,,
57647,27903,81,6,75,23.82,,
57648,MC200,20,13,7,3.53,4.95,
57655,PP5050-19,0,0,0,370.90,,
57656,PP5200-12,0,0,0,392.72,,
57657,PP4408,0,0,0,269.08,,
57658,PP5205,0,0,0,392.72,,
57659,HRSB1107,0,0,0,254.61,,
57661,SSC300-01,3,2,1,316.00,,
57662,SSC300-01-KIT,2,1,1,556.00,,
57663,803500,0,0,0,166.49,,
57664,803500B,0,0,0,166.49,,
57665,805500,0,0,0,208.11,,
57666,805500B,0,0,0,208.11,,
57667,63070,0,0,0,294.52,,
57668,63071,0,0,0,279.55,,
57675,APT-150-01,35,15,20,255.94,,
57676,APT-250-01,7,4,3,261.56,,
57677,APT-GPS-01,2,2,0,111.94,,
57678,APT-LB-01,6,3,3,118.13,,
57679,APT-LB-GPS2-01,3,2,1,199.69,,
57680,APT6003,1,0,1,334.69,,
57684,SSM-64A,14,14,0,53.33,,
57685,010-11617-32,25,14,11,33.74,,
57686,010-11617-42,3,3,0,41.24,,
57687,010-12234-07,0,0,0,22.49,,
57688,010-12406-00,2,0,2,18.74,,
57758,10102G40,15,15,0,5.59,,
57759,10200G40,103,80,23,1.57,,
57760,10201G40,25,19,6,1.57,,
57766,10600G40,14,2,12,4.26,,
57768,10603G40,46,36,10,3.26,,
57770,45004G40,48,24,24,4.13,,
57774,58195,9,4,5,55.09,,
57775,58196,12,9,3,60.08,,
57776,58197,11,5,6,30.91,,
57777,58387,5,2,3,16.23,,
57785,FT1PXC,17,15,2,158.33,,
57786,500199,6,3,3,365.86,,
57787,500200,0,0,0,365.86,,
57811,740146-1,5,2,3,22.06,,
57812,740149-1,1,1,0,41.39,,
57813,780029-1,9,1,8,15.16,,
57819,710185-1,3,3,0,186.29,,
57820,790,160,64,96,11.25,,
57821,792,18,18,0,27.75,,
57829,ACDC1911,3,3,0,23.16,,
57833,740090-1,7,1,6,20.69,,
57841,720073-4,1,1,0,75.89,,
57885,1862014,2,0,2,106.72,,
57886,1866080,0,0,0,167.70,,
57887,1852074,0,0,0,25.41,,
57899,1810340,10,4,6,335.28,,
57900,1810244,7,3,4,72.64,,
57901,1810212,5,2,3,23.46,,
57902,1368562,0,0,0,964.39,,
57921,MILPLATE2,0,0,0,13.07,,
57943,EIC101,0,0,0,122.61,,
57962,3400,0,0,0,121.13,,199.98
57963,3500,5,1,4,169.41,,259.98
57965,YBP-5103,23,23,0,13.90,,19.98
57969,YBP-5203,0,0,0,16.46,,19.98
57973,3552,0,0,0,15.96,,21.98
57975,3554,0,0,0,15.96,,21.98
57976,3555,0,0,0,15.96,,21.98
57977,30803,32,26,6,12.20,,16.98
57980,010-11966-00,10,0,10,13.99,,
58046,32010,17,9,8,165.38,,
58047,CA-VAT-10-R,2,0,2,953.30,,
58049,1810225,2,1,1,181.61,,
58050,1810226,2,2,0,108.96,,
58051,IRIS090,3,0,3,481.00,,
58053,1001003,0,0,0,198.67,,
58054,1001008,0,0,0,168.83,,
58055,7001,0,0,0,292.00,,
58056,7008,0,0,0,265.33,,
58066,122000-500-020-16,6,4,2,33.99,,
58067,122000-500-040-16,4,4,0,44.00,,
58068,122000-500-060-16,2,0,2,37.99,,
58072,GP2205,0,0,0,363.62,,
58073,GP1205,0,0,0,363.62,,
58074,GP1524,0,0,0,276.35,,
58075,GP2524,0,0,0,276.35,,
58084,801310,2,0,2,52.99,,
58085,8013,0,0,0,9.97,,
58086,80301,0,0,0,56.71,,
58087,HRSB1201,0,0,0,7.94,,
58138,3000003654,0,0,0,72.35,,
58139,011,0,0,0,60.81,,
58140,144,3,1,2,31.25,,
58168,SW55450,3,3,0,14.03,,
58175,SRA-50,16,10,6,77.69,,
58180,01-0398,0,0,0,4777.78,,
58182,6018-R,2,2,0,664.78,,
58184,B4-509AA,2,1,1,3529.99,4556.00,
58186,010-12167-20,0,0,0,41.24,,
58187,MT300,1,0,1,248.46,,
58188,DBP5,0,0,0,22.79,,
58189,DFC5,11,9,2,8.99,,
58190,DFP5,4,0,4,12.05,,
58191,DFF5,0,0,0,12.05,,
58193,M77132,0,0,0,20.35,,
58195,10-24750-09,0,0,0,239.51,,
58199,3230WC,0,0,0,19.48,,
58200,3226WC,14,8,6,25.05,,
58227,TW4B047009J,2,2,0,33.33,,
58239,9351-2,10,5,5,11.58,,
58240,11370-7,3,2,1,11.70,,
58241,14233-7,6,1,5,21.92,,
58243,11778-2,2,0,2,38.93,,
58249,90-815-F,2,1,1,271.87,,
58250,96-280-F,2,2,0,17.55,,
58252,96-286-F,20,5,15,16.57,,
58256,2428-F,27,15,12,7.80,,
58257,2430-F,5,3,2,13.35,,
58320,001-337-410-00,0,0,0,78.18,,
58325,CLM100-01,0,0,0,336.00,,
58328,49024,0,0,0,28.12,44.99,
58329,0140,9,5,4,17.81,,
58330,0141,8,7,1,23.89,,
58335,0443,0,0,0,6.98,,
58338,0448-BK,0,0,0,14.13,,
58339,4338-121-E07,0,0,0,190.52,,
58341,2028,6,2,4,54.36,,
58342,2029,0,0,0,59.38,,
58370,2000023099,3,1,2,124.41,,
58378,2000026562,11,5,6,287.50,,
58398,019901,0,0,0,133.91,,
58399,011702,0,0,0,200.00,,
58413,10-904,0,0,0,34.38,,
58414,10-905,2,2,0,34.38,,
58450,44106-1000,34,0,34,7.35,,
58483,50050-2,0,0,0,266.60,,
58484,50051,0,0,0,126.67,,
58488,QCM-S,17,8,9,58.08,,
58490,QCM-N,15,0,15,32.26,,
58492,QCM-SR,6,5,1,71.00,,
58565,50053,0,0,0,299.93,,
58570,CA-0157-1,11,7,4,31.70,,
58571,CA-0157-2,9,4,5,47.54,,
58572,CA-0157-3,8,7,1,65.00,,
58573,CA-0157-4,0,0,0,83.46,,
58574,03-1570-100,5,2,3,11.38,,
58576,03-1108-RP,0,0,0,4.26,,
58577,17-1510-50W,2,2,0,24.38,,
58578,CA-0032,4,1,3,34.94,,
58579,CA-0033,4,2,2,70.69,,
58580,03-1033-AS,6,1,5,6.50,,
58581,1045,9,0,9,34.97,,
58582,1733,2,2,0,36.58,,
58584,770-EZ,34,21,13,43.33,,
58585,5045,35,27,8,20.94,,
58586,5046,6,6,0,33.33,,
58587,770-DP-EZ,8,3,5,57.48,,
58588,770-DP,9,4,5,47.33,,
58589,771-S-EZ,4,1,3,48.33,,
58590,7605,3,1,2,170.76,,
58591,7655,3,3,0,204.90,,
58592,771-S,7,4,3,38.40,,
58593,771-SFD,5,1,4,42.49,,
58594,772-DBC-EZ,5,2,3,60.54,,
58595,772-DBC,5,2,3,49.96,,
58596,701S,15,3,12,29.86,,
58597,701-PM,12,0,12,20.06,,
58598,701S-PM,15,0,15,30.74,,
58599,701-MD,22,4,18,133.43,,
58600,701-MD-D,5,1,4,142.18,,
58601,720-MDO,5,0,5,174.51,,
58603,80-724-0006-00,6,3,3,64.71,,
58604,80-708-0013-00,0,0,0,40.79,,
58606,80-911-0045-00,7,3,4,109.04,,
58607,54-27C4/DSP,6,4,2,7.85,,
58608,54-35C2/DSP,4,2,2,10.19,,
58609,701-KEY,29,20,9,7.43,,
58610,701-KEY-EP,18,4,14,8.85,,
58611,GP1800-20,0,0,0,312.72,,
58612,P105055,0,0,0,377.25,,
58613,P105056,0,0,0,603.00,,
58614,P105057,0,0,0,1002.08,,
58615,010-12255-00,0,0,0,142.49,,
58616,112507,0,0,0,87.55,,
58617,112527,18,6,12,87.93,,
58618,113117,27,19,8,88.10,,
58619,113127,0,0,0,88.10,,
58620,113197,35,8,27,88.10,,
58621,112807,4,1,3,92.49,,
58622,112827,7,4,3,92.49,,
58626,101326,4,2,2,120.06,,
58629,101334,5,3,2,353.68,,
58630,101335,0,0,0,352.99,,
58631,101336,3,1,2,352.99,,
58632,101346,4,2,2,536.67,,
58633,101347,0,0,0,528.39,,
58634,101348,7,2,5,536.15,,
58637,111807,0,0,0,163.44,,
58639,111827,0,0,0,164.07,,
58641,111831,0,0,0,167.74,,
58647,701-MDVS,9,1,8,152.52,,
58648,720-MDVSO,5,3,2,254.97,,
58649,80-701-0018-00,5,0,5,123.40,,
58650,720-MDO-EP,5,3,2,175.22,,
58651,80-724-0007-00,4,2,2,28.61,,
58652,710-140A,21,10,11,89.09,,
58653,714-140A-DVSR,4,2,2,121.57,,
58654,715-H,0,0,0,71.78,,
58655,715-V,0,0,0,71.78,,
58656,716-H-140A-DVSR,5,3,2,154.81,,
58657,716-V-140A-DVSR,0,0,0,154.81,,
58658,716-SQ-140A-DVSR,5,1,4,154.81,,
58659,715-S,0,0,0,91.12,,
58660,718-140A-DVSR,0,0,0,180.69,,
58661,717-140A-DVSR,18,2,16,268.85,,
58662,719-140A-DVSR,0,0,0,391.01,,
58663,80-716-0017-00,0,0,0,189.45,,
58664,80-716-0018-00,12,0,12,413.92,,
58665,80-716-0014-00,0,0,0,387.77,,
58666,80-716-0015-00,3,1,2,648.43,,
58667,80-716-0016-00,0,0,0,904.52,,
58668,80-700-0050-00,0,0,0,229.83,,
58669,80-700-0051-00,0,0,0,232.13,,
58670,80-700-0052-00,0,0,0,223.00,,
58673,CC-810,0,0,0,124.27,,
58674,CC-803N,4,2,2,309.75,,
58676,CC-5,0,0,0,33.79,,
58679,CC-BLANK,0,0,0,31.39,,
58688,A80346,13,8,5,34.08,,
58689,777-BB4S-500,28,14,14,64.36,,
58690,777-BB3S-650,32,25,7,70.60,,
58691,777-BB5S-650,36,21,15,94.96,,
58692,777-BB8S-650,24,12,12,133.48,,
58693,777-Z10W-200,14,10,4,25.69,,
58694,777-Z18W-200,2,0,2,39.95,,
58695,778-ANL,33,20,13,20.71,,
58696,778-ANL2S,35,26,9,42.06,,
58697,778-ANLTP,8,3,5,50.21,,
58698,778-T2S-400,0,0,0,42.06,,
58699,778-T2S-600,0,0,0,49.36,,
58700,IST-8MM-1S,6,1,5,10.56,,
58701,IST-8MM-2S,0,0,0,15.96,,
58702,IST-10MM-8MM,0,0,0,16.27,,
58704,IST-10MM-2S,4,2,2,16.59,,
58705,IST-8MM-1SPT,0,0,0,16.80,,
58706,IST-10MM-1SPT,3,0,3,17.35,,
58707,IS-6MM-1/DSP,2,0,2,8.64,,
58708,IS-6MM-1R/DSP,1,0,1,9.43,,
58709,IS-6MM-2/DSP,1,0,1,11.20,,
58710,BB-6W-2S/DSP,0,0,0,22.53,,
58711,BB-12W-2S/DSP,0,0,0,25.07,,
58712,BB-24W-2S/DSP,0,0,0,30.73,,
58713,BB-12W-2NC/DSP,0,0,0,32.87,,
58714,BB-4S-150A/DSP,0,0,0,30.55,,
58715,TB-118-6P/DSP,4,2,2,9.06,,
58717,706-4W,7,3,4,78.18,,
58718,706-2W,2,0,2,42.62,,
58719,707,6,2,4,95.64,,
58720,705-50A,0,0,0,84.08,,
58721,705-80A,4,2,2,84.08,,
58722,705-100A,2,0,2,84.08,,
58723,705-135A,0,0,0,84.08,,
58724,705-150A,0,0,0,84.08,,
58725,ATC-6W,0,0,0,24.80,,
58726,ATC-6WQC,0,0,0,24.80,,
58727,80-712-0039-00,10,5,5,15.27,,
58728,810-15-CX,1,1,0,56.00,,
58731,810-30-CX,0,0,0,84.00,,
58733,ZDIGDTVDA,2,1,1,67.46,,
58741,HX380,105,58,47,160.22,,
58762,77020200,1,1,0,299.99,,
58763,77030100,19,1,18,150.42,,
58765,77010050,2,1,1,129.99,,
58768,131902500,3,1,2,192.29,,
58805,GP1050-19,0,0,0,327.26,,
58806,900-DC,0,0,0,114.08,,
58807,OCTAFMDRSSYS12,0,0,0,1234.58,,
58809,901H,0,0,0,200.59,,
58810,901V,0,0,0,200.59,,
58811,CA82B-35R,0,0,0,2906.67,,
58812,902NMH,0,0,0,311.55,,
58813,902NMV,0,0,0,311.55,,
58814,904NM,0,0,0,393.76,,
58815,905NM,0,0,0,582.65,,
58817,764998,6,1,5,3.62,,
58818,765000,0,0,0,7.74,,
58819,765002,0,0,0,5.87,,
58820,765004,4,4,0,6.05,,
58821,765006,3,1,2,9.65,,
58822,765010,0,0,0,6.64,,
58823,765012,9,5,4,8.28,,
58824,750000,5,2,3,9.30,,
58825,760375,0,0,0,1.35,,
58826,760500,3,1,2,1.35,,
58827,301503,4,4,0,5.34,,
58828,301506,4,3,1,9.45,,
58829,304503,0,0,0,3.83,,
58830,304506,4,2,2,6.44,,
58831,306503,2,2,0,4.99,,
58832,906NMV,0,0,0,911.66,,
58834,OCTAFG0612,0,0,0,410.96,,
58838,OCTAFG1012,0,0,0,488.17,,
58841,OCTAFG1612,0,0,0,539.65,,
58847,NC36NM,0,0,0,920.33,,
58852,901V-DCSM,0,0,0,565.82,,
58865,902V-DCSM,0,0,0,628.48,,
58867,903-DCSM,0,0,0,814.24,,
58871,905V-DCSM,0,0,0,905.92,,
58880,900-AM,0,0,0,213.77,,
58883,902-AM,0,0,0,376.82,,
58885,904-AM,0,0,0,591.92,,
58887,905-AM,0,0,0,805.23,,
58889,906-AM,0,0,0,1014.60,,
58890,906V-AM,0,0,0,994.69,,
58891,907-AM,0,0,0,1470.10,,
58893,NC32Y-DCSM,0,0,0,1240.05,,
58897,M28-DCSM,0,0,0,1000.64,,
58898,M32-DCSM,0,0,0,1061.14,,
58947,010-01550-00,9,8,1,111.99,,139.99
58948,010-01550-10,5,2,3,175.99,,
58953,010-12439-00,8,8,0,9.74,,
58954,010-12439-01,9,6,3,14.99,,
58955,010-12440-00,1,1,0,11.24,,
58956,010-12440-01,0,0,0,11.24,,
58957,010-12440-02,0,0,0,11.24,,
58958,010-12401-00,0,0,0,119.99,,
58959,010-12401-20,0,0,0,97.49,,
58960,010-12402-00,7,4,3,149.99,,
58961,010-12403-00,2,1,1,134.99,,
58962,010-12404-00,8,4,4,157.49,,
58963,010-12404-10,2,2,0,434.99,,
58964,010-12405-00,3,1,2,236.24,,
58966,010-12407-00,0,0,0,22.49,,
58967,010-12407-02,0,0,0,22.49,,
58968,010-12445-11,0,0,0,3.74,,
58970,010-12445-30,0,0,0,5.24,,
58971,010-12445-22,6,3,3,22.49,,
58972,010-12445-32,1,0,1,22.49,,
58973,010-12445-00,17,8,9,17.24,,
58974,010-12445-12,0,0,0,3.74,,
58975,010-12445-21,0,0,0,3.74,,
58976,010-12445-31,0,0,0,3.74,,
58977,010-12445-10,0,0,0,18.74,,
58978,010-12234-06,0,0,0,14.99,,
58979,010-12462-00,0,0,0,74.99,,
58980,010-12357-00,0,0,0,18.74,,
58985,940800211,0,0,0,1496.39,,1739.99
58986,OC-0422BKA8,1,0,1,213.96,,
58987,OC-0432BKA116,4,2,2,263.37,,
58988,OC-0432VEL116,1,1,0,263.36,,
58989,OT-0442BKA15,2,0,2,544.53,,
58990,OT-0442VEL15,1,1,0,544.53,,
58992,F16-0151R-1,4,2,2,38.38,,
58994,F31-0790BXY-1,4,1,3,351.77,,
58995,F31-0770BSA-1,2,0,2,182.47,,
58996,F30-0861BSA-1,9,5,4,96.00,,
58999,F16-0810-1,0,0,0,249.46,,
59001,OT-3160CF,1,1,0,2192.41,,
59002,OT-4200CF,2,2,0,2619.47,,
59006,900-ACM6W-110V,0,0,0,256.43,,
59008,900-AC1-110V,1,0,1,288.48,,
59009,900-AC1,0,0,0,305.25,,
59010,HRC10812V,3,1,2,1844.59,2699.00,
59011,RC8612V,3,2,1,963.92,1414.00,
59012,RC121212V,0,0,0,2956.76,4189.00,
59013,900-ACCH-110V,0,0,0,166.74,,
59014,900-ACCH,0,0,0,279.99,,
59015,R62379,11,4,7,127.83,,
59016,900-ACM2-AM-110,0,0,0,328.25,,
59021,900-AC2H-AM-110,0,0,0,483.17,,
59028,900-AC2V-ACSM,0,0,0,868.36,,
59029,900-AC3-AM,0,0,0,792.48,,
59031,900-AC3-ACSM,0,0,0,1059.42,,
59032,900-AC4-ACSM-110,0,0,0,1099.86,,
59033,900-AC4-ACSM,0,0,0,1110.11,,
59044,BM30PW,2,2,0,81.60,113.90,
59045,BM30PG,0,0,0,81.60,113.90,
59046,BM30PB,6,6,0,81.60,113.90,
59047,BM50PW,6,6,0,93.18,130.05,
59048,BM50PG,1,1,0,93.18,130.05,
59049,BM50PB,3,3,0,93.18,130.05,
59050,BM30NT,0,0,0,114.49,159.80,
59110,2914,0,0,0,505.98,,
59164,BP3708,4,2,2,223.64,,
59165,BP3740,4,2,2,223.64,,
59167,BP9005,5,3,2,54.88,,
59168,BP9013,4,3,1,71.18,,
59169,BP9021,4,2,2,59.31,,
59170,BP4402,3,1,2,109.87,,
59171,BP4410,4,2,2,125.08,,
59172,BP0510,0,0,0,117.27,,
59174,BP0350,8,1,7,81.33,,
59176,82-962-001A,0,0,0,91.09,,
59177,BP1552,16,4,12,141.75,,
59178,BP1554,3,2,1,145.85,,
59179,GP4618,166,148,18,38.79,,
59180,GP0550,7,3,4,87.47,,
59181,GP0551,5,3,2,87.47,,
59182,GP0418,15,4,11,75.44,,
59183,GP0650,22,18,4,54.16,,
59184,SS5212,12,6,6,53.11,,
59185,SS1212,4,4,0,75.05,,
59186,SS1224,4,4,0,82.26,,
59187,BP2052,13,3,10,160.02,,
59188,BP2054,13,6,7,156.35,,
59189,BP4572,5,3,2,192.47,,
59190,BP4574,2,0,2,201.28,,
59191,LV1219,28,17,11,13.44,,
59192,RT2498,16,8,8,96.18,,
59193,RT2658,9,4,5,125.62,,
59199,S-7098P,2,1,1,5.13,,
59208,F600,6,3,3,438.58,,
59209,S600,7,3,4,437.61,,
59210,F700,5,1,4,525.19,,
59211,S700,4,2,2,522.79,,
59212,S1100,7,4,3,490.96,,
59213,F1100,4,2,2,498.33,,
59214,F600W,5,2,3,513.25,,
59215,F1200,4,2,2,610.03,,
59216,S1200,3,2,1,585.50,,
59221,PP4800-20,0,0,0,356.35,,
59222,PP5065,0,0,0,399.99,,
59224,PP5058,0,0,0,370.90,,
59225,PP4403,0,0,0,269.08,,
59226,PP5064,0,0,0,399.99,,
59227,PP5059,0,0,0,370.90,,
59228,PP4407,0,0,0,269.08,,
59229,RMX4800-20,0,0,0,436.35,,
59230,RMX4800-12,0,0,0,436.35,,
59232,RMX4800,0,0,0,421.81,,
59234,RMX4408,0,0,0,392.72,,
59235,RMX4407,0,0,0,392.72,,
59236,RMX4808,0,0,0,436.35,,
59238,ACC-FF-1536,9,4,5,7.42,,
59239,GP2050-20,0,0,0,327.26,,
59240,ACC-FF-1567,0,0,0,7.42,,
59241,ACC-FF-1659,3,2,1,13.74,,
59242,GP2050-19,0,0,0,327.26,,
59243,ACC-FF-1581,0,0,0,38.64,,
59244,GP1200-12,0,0,0,363.62,,
59245,GP2200-12,0,0,0,363.62,,
59246,GP1800-12,0,0,0,312.72,,
59248,GP2050-09,0,0,0,327.26,,
59249,GP1807,0,0,0,312.72,,
59250,GP1040-20,0,0,0,334.53,,
59251,A80350,0,0,0,341.66,,
59252,GP2040-20,0,0,0,334.53,,
59253,GP1080-19,0,0,0,385.44,,
59254,GP2080-19,0,0,0,385.44,,
59258,GP1170-12,0,0,0,385.44,,
59259,GP2170-12,0,0,0,385.44,,
59260,GP1040-09,0,0,0,334.53,,
59261,GP2040-09,0,0,0,334.53,,
59262,GP2040,0,0,0,319.99,,
59263,GP1170-09,0,0,0,385.44,,
59264,GP2170-09,0,0,0,385.44,,
59265,GP1174,0,0,0,385.44,,
59266,GP2174,0,0,0,385.44,,
59267,GP2082,0,0,0,385.44,,
59268,GP1082,0,0,0,385.44,,
59269,GP1170-05,0,0,0,385.44,,
59270,GP2170-05,0,0,0,385.44,,
59271,GP1504,0,0,0,276.35,,
59272,GP1514,0,0,0,276.35,,
59273,GP1600-04,0,0,0,341.81,,
59274,GP2504,0,0,0,276.35,,
59275,GP2514,0,0,0,276.35,,
59276,GP2600-04,0,0,0,341.81,,
59277,GP1040-19,0,0,0,334.53,,
59279,BEA3000,5,3,2,162.72,,
59280,GP2040-19,0,0,0,334.53,,
59281,GP1508,0,0,0,276.35,,
59282,"RLS- AM",4,2,2,31.93,,
59283,"RLS- 401",5,2,3,11.81,,
59284,"RLS- 402",0,0,0,20.11,,
59285,"RLS- 403",0,0,0,15.19,,
59286,"RLS- 404",0,0,0,15.19,,
59287,"MBR-300 PRO",1,0,1,299.99,,
59289,"RL- 508",4,3,1,23.60,,
59290,"RL- 509",2,0,2,17.73,,
59291,"RL- 510",0,0,0,12.10,,
59292,"RL- 511",0,0,0,12.10,,
59293,"MBR-700 PRO",1,0,1,999.99,,
59294,"RL- 512",0,0,0,12.10,,
59295,"RL- TETH",0,0,0,11.25,,
59296,GP1518,0,0,0,276.35,,
59297,GP1608,0,0,0,341.81,,
59298,GP2508,0,0,0,276.35,,
59299,GP2518,0,0,0,276.35,,
59300,GP2608,0,0,0,341.81,,
59301,GP2600-10,0,0,0,341.81,,
59302,GP1600-10,0,0,0,341.81,,
59303,GP1080-08,0,0,0,385.44,,
59304,GP2080-08,0,0,0,385.44,,
59305,TP325,0,0,0,159.99,,
59307,SG125,0,0,0,319.99,,
59308,SG225,0,0,0,319.99,,
59310,GP2065,0,0,0,363.62,,
59311,PP5066,0,0,0,399.99,,
59312,PP4500-01,0,0,0,276.35,,
59313,PP5050-01,0,0,0,370.90,,
59314,PP4500-06,0,0,0,276.35,,
59315,PP4500-05,0,0,0,276.35,,
59316,PP5050-02,0,0,0,370.90,,
59317,PP4900-02,0,0,0,356.35,,
59318,000-154-024,0,0,0,68.18,,
59319,PP4500-03,0,0,0,276.35,,
59321,PP4500-02,0,0,0,276.35,,
59322,PP4900-01,1,1,0,356.35,,
59323,RMX4500-01,0,0,0,399.99,,
59324,RMX4500-02,0,0,0,399.99,,
59325,RMX4900-01,0,0,0,436.35,,
59326,GP1066,0,0,0,363.62,,
59327,GP2066,0,0,0,363.62,,
59335,GP1040-26,0,0,0,334.53,,
59338,GP1040-23,0,0,0,334.53,,
59341,GP1040-29,0,0,0,334.53,,
59345,LLB-16CW-01-00,0,0,0,11.08,,
59346,GP1500-01,0,0,0,276.35,,
59347,LLB-45RU-91-K1,0,0,0,76.83,,
59348,LLB-45RE-91-K1,1,1,0,62.99,,
59349,GP1500-11,0,0,0,276.35,,
59351,GP1040-10,0,0,0,334.53,,
59353,GP1500-05,0,0,0,276.35,,
59354,GP1500-04,0,0,0,276.35,,
59355,GP1040-25,0,0,0,334.53,,
59357,FCV628,6,0,6,562.95,,
59358,FCV588,3,3,0,1089.45,,
59361,GP1040-24,0,0,0,334.53,,
59362,GP1500-02,0,0,0,276.35,,
59363,GP1040-28,0,0,0,334.53,,
59364,GP1040-27,0,0,0,334.53,,
59366,GP1040-22,0,0,0,334.53,,
59367,11501000,2,1,1,46.08,,
59368,GP1040-21,0,0,0,334.53,,
59369,TZ-100,0,0,0,329.41,,340.00
59370,TZ-101,0,0,0,411.76,,425.00
59371,TZ-102,0,0,0,411.76,,425.00
59372,TZ-103,0,0,0,247.06,,255.00
59374,TZ-104,0,0,0,123.53,,128.00
59376,SK129,0,0,0,181.81,,
59377,TZ-106,0,0,0,205.88,,213.00
59378,TZ-108,0,0,0,1235.29,,1275.00
59379,SK130,0,0,0,181.81,,
59380,TZ-109,0,0,0,1235.29,,1275.00
59381,TZ-110,0,0,0,411.76,,425.00
59382,TZ-111,0,0,0,1235.29,,1275.00
59383,TZ-112,0,0,0,1235.29,,1275.00
59386,TZ-116,0,0,0,823.53,,850.00
59387,TZ-117,0,0,0,823.53,,850.00
59394,DS0006,7,3,4,125.42,,
59395,LV1215,19,11,8,15.53,,
59396,F1100W,5,2,3,549.05,,
59397,S600W,4,2,2,494.88,,
59398,BP0527,3,1,2,118.31,,
59399,WM8284,7,3,4,272.88,,
59400,WM8484,1,1,0,283.52,,
59401,GP1354,39,5,34,29.04,,
59402,S360EW,5,3,2,601.74,,
59403,S1100W,0,0,0,582.40,,
59404,SS5012,11,5,6,28.92,,
59405,SS1012,9,6,3,34.28,,
59406,BE1482,3,3,0,88.52,,
59407,BE1484,4,2,2,99.72,,
59408,BE9003,18,9,9,34.29,,
59409,BE9006,17,10,7,55.53,,
59415,73-103-F,14,12,2,15.32,,
59421,WLOCKLP30,0,0,0,111.21,,
59427,USG-2,0,0,0,134.21,,
59428,DIN-KIT-2,0,0,0,13.15,,
59432,TKA01,0,0,0,6.90,,
59433,TKA02,0,0,0,5.03,,
59437,T70243,1,1,0,1639.99,,
59438,E70210,0,0,0,1595.99,,
59446,MRWT40,8,3,5,79.55,,
59454,MRGB65S,5,4,1,65.34,,
59455,SET0151,0,0,0,59.79,,
59476,L004CL0015ACJ,0,0,0,2107.59,,
59478,L006CL0015ACJ,0,0,0,6521.74,,
59479,L004CL0015ACI,0,0,0,2707.96,,
59480,L006CL0015ACI,0,0,0,2807.81,,
59481,P7904300AJ,0,0,0,41.00,,
59485,320899,2,1,1,84.23,,
59486,MI-1050-ORS,2,0,2,68.61,,
59488,CA-0172-MO,1,1,0,155.68,,
59489,CA-0175-MO,3,1,2,255.79,,
59491,03-1226-23S,2,0,2,16.05,,
59492,03-1226-23G,9,5,4,16.05,,
59495,"AL 01706",53,31,22,10.50,17.95,
59496,"AL 01710",7,3,4,49.74,69.95,
59497,"CR 01606",24,11,13,10.50,17.95,
59498,"CR 01610",5,3,2,49.74,69.95,
59499,940200200,4,3,1,322.66,,
59500,940200210,2,1,1,523.24,,
59501,14190-7,11,5,6,24.25,,
59502,14191-7,12,7,5,29.55,,
59511,E70344,4,3,1,1471.99,,
59513,308-0163-25,1,1,0,60.72,,
59514,308-0163-50,1,0,1,93.10,,
59515,308-0163-75,1,1,0,103.31,,
59516,308-0163-100,0,0,0,161.92,,
59517,308-0164-25,0,0,0,68.82,,
59518,308-0164-50,0,0,0,85.01,,
59519,308-0164-75,0,0,0,117.40,,
59520,308-0164-100,1,0,1,110.43,,
59521,4115028,12,2,10,20.95,,
59522,4113315,1,0,1,15.39,,
59523,4113746,5,4,1,154.16,,
59526,308-0251-30-00,0,0,0,87.49,,
59527,308-0252-30-00,0,0,0,87.49,,
59528,308-0253-30-00,0,0,0,335.10,,
59529,308-0254-30-00,0,0,0,335.10,,
59532,432-0019-22-00S,0,0,0,1880.89,,
59551,F31-2200BXY-4A,0,0,0,46.65,,
59552,F31-2230BXY-4A,0,0,0,59.62,,
59556,HRMK2103,0,0,0,236.24,,
59557,10-24664-09,3,1,2,239.51,,
59568,BE2002,2,1,1,81.40,,
59570,SI8284,4,2,2,248.02,,
59571,SI8484,4,2,2,286.84,,
59572,E70321,3,0,3,999.92,,
59593,CMP31B,10,4,6,99.99,,
59594,CMP31W,7,2,5,99.99,,
59596,6830,4,2,2,145.83,,
59597,6400-R,4,2,2,252.76,,
59598,6832,0,0,0,404.17,,
59612,TW4B019009J,1,1,0,33.33,,
59620,TW5K940009J,3,3,0,26.88,,
59668,010-11533-10,0,0,0,41.24,,
59683,250140101,0,0,0,124.38,,
59698,65109,0,0,0,86.24,,
59699,010-01966-00,10,1,9,472.49,,
59700,GP1800,0,0,0,298.17,,
59701,GP1900-01,0,0,0,319.99,,
59702,GP2040-22,0,0,0,334.53,,
59703,GP2040-21,0,0,0,334.53,,
59715,010-01960-00,6,3,3,74.99,,
59716,010-01960-01,7,4,3,74.99,,
59723,"67 100",4,2,2,19.13,,
59743,DT820BV-235-N2,2,1,1,374.97,,
59744,DT812BV-235-N2,0,0,0,374.97,,
59747,0443004PLB,0,0,0,201.01,,
59748,0443005PLB,0,0,0,225.26,,
59749,0443006PLB,0,0,0,300.74,,
59763,111801,0,0,0,149.18,,
59764,111800,2,0,2,150.57,,
59765,111803,0,0,0,164.07,,
59766,111802,4,0,4,150.57,,
59767,112203,6,6,0,22.79,,
59768,112204,0,0,0,22.79,,
59769,112205,0,0,0,21.82,,
59770,101227,4,0,4,22.79,,
59771,112223,14,8,6,22.79,,
59772,112224,15,6,9,22.79,,
59773,112225,6,2,4,22.79,,
59774,101228,4,4,0,22.79,,
59775,101049,7,3,4,17.43,,
59776,101050,11,5,6,17.43,,
59777,101051,0,0,0,17.43,,
59778,101225,0,0,0,17.43,,
59779,101052,0,0,0,17.43,,
59780,101053,10,6,4,17.43,,
59781,101054,0,0,0,17.43,,
59782,101226,0,0,0,17.43,,
59786,199276,0,0,0,1.29,,
59787,199277,0,0,0,2.71,,
59788,199280,0,0,0,1.70,,
59789,199281,0,0,0,4.08,,
59790,199284,0,0,0,2.03,,
59791,199285,2,2,0,4.69,,
59792,199274,0,0,0,1.29,,
59793,199275,0,0,0,2.71,,
59794,199278,0,0,0,1.70,,
59795,199279,0,0,0,4.08,,
59796,199282,0,0,0,2.03,,
59797,199283,0,0,0,5.09,,
59808,R70375,10,0,10,33.32,,
59812,IRHT-01,1,1,0,225.60,,
59815,TFTDBE-5H,4,2,2,60.80,,
59822,2073-F,3,3,0,106.88,,
59823,2074-F,1,1,0,126.37,,
59824,2075-F,5,3,2,147.44,,
59835,261-2319-00,4,0,4,55.39,,
59839,OC17SUK42,18,6,12,153.30,,
59852,B164-0-BL,0,0,0,950.00,,
59857,USB-62C,4,2,2,29.24,,
59858,MC70BK,5,3,2,20.36,,
59859,RA5001BK,0,0,0,96.15,,
59860,RA5001WH,0,0,0,96.15,,
59866,SC-USB-01,13,13,0,23.60,,
59867,RA5002BK,0,0,0,96.15,,
59868,RA5002WH,0,0,0,96.15,,
59869,RA5003BK,1,1,0,96.15,,
59870,RA5003WH,2,0,2,96.15,,
59876,18673-0001-P,4,2,2,36.04,,
59877,HYDBOLTCON,5,1,4,253.11,,
59878,3962.1,143,95,48,15.85,,
59879,3963.1,193,86,107,11.54,,
59880,3964.1,207,90,117,18.38,,
59881,3965.1,200,105,95,13.42,,
59882,"ANGLE FINDER",2,1,1,12.76,,
59884,010-01966-11,1,1,0,1274.99,,
59885,27626,58,38,20,65.39,114.99,
59886,27646,52,20,32,97.97,174.99,
59889,010-01961-00,3,1,2,157.49,,
59890,010-01961-10,0,0,0,551.24,,
59891,010-01961-11,2,2,0,1049.99,,
59896,BP4772,5,2,3,133.12,,
59898,BP4774,2,0,2,137.86,,
59921,242243,4,3,1,17.36,,
59922,252243,10,0,10,2.03,,
59923,242264,4,1,3,30.22,,
59924,252264,3,3,0,3.22,,
59925,242294,4,2,2,42.79,,
59926,5557-P12A7,8,4,4,36.05,,
59927,119005,0,0,0,288.57,,
59928,14192-7,4,0,4,32.24,,
59929,14193-7,2,2,0,43.15,,
59930,14194-7,6,3,3,27.33,,
59931,14195-7,4,4,0,41.11,,
59932,12048-4,13,6,7,10.58,,
59933,12049-4,4,4,0,18.79,,
59934,9097-5,4,4,0,8.18,,
59935,9098-5,14,8,6,8.34,,
59936,11930-4,4,2,2,64.52,,
59939,58040-3012,0,0,0,830.11,,
59940,58040-3024,0,0,0,830.11,,
59944,58240-3012,3,0,3,830.11,,
59946,58240-3024,0,0,0,830.11,,
59947,SVC-KIT-DBL,1,1,0,137.22,,
59948,68551,2,0,2,118.50,,
59950,010-01966-10,6,4,2,712.49,,
59954,DS0005,11,3,8,100.36,,
59957,010-12152-10,0,0,0,17.24,,
59961,RA5004BK,3,0,3,96.15,,
59962,RA5004WH,2,2,0,96.15,,
59966,341010,0,0,0,5.13,,
59968,343010,0,0,0,5.13,,
59971,346010,5,2,3,4.59,,
59972,347010,5,0,5,5.13,,
59974,331066,4,0,4,3.47,,
59977,334066,2,0,2,3.47,,
59979,336066,42,0,42,3.47,,
59980,337066,15,15,0,3.47,,
59982,339066,12,9,3,2.33,,
59999,703005,2,0,2,18.21,,
60000,703006,4,2,2,76.37,,
60001,703040,3,1,2,192.63,,
60002,703050,5,0,5,131.00,,
60003,703060,3,1,2,46.14,,
60005,702027,5,4,1,26.94,,
60006,702030,4,2,2,36.21,,
60007,230612,8,3,5,1.80,,
60008,210612,5,2,3,10.60,,
60009,220612,34,1,33,21.69,,
60010,RA5005BK,0,0,0,96.15,,
60011,RA5005WH,0,0,0,96.15,,
60012,RA5201BK,3,0,3,83.33,,
60013,RA5201WH,3,2,1,83.33,,
60014,S15-504,2,2,0,39.62,,
60015,RA5202BK,2,0,2,96.15,,
60016,RA5202WH,1,1,0,96.15,,
60017,199264,8,1,7,25.13,,
60018,RA5203BK,2,0,2,85.23,,
60019,199265,3,1,2,37.69,,
60020,199266,0,0,0,44.14,,
60021,RA5203WH,0,0,0,96.15,,
60022,199267,0,0,0,25.13,,
60023,199268,0,0,0,40.26,,
60024,199269,0,0,0,47.16,,
60025,150BBIW,29,10,19,16.87,,
60031,700,12,4,8,26.60,,
60032,701,5,5,0,22.91,,
60033,721,10,2,8,49.25,,
60034,720,25,15,10,65.07,,
60035,IST-10MM-1S,6,1,5,10.73,,
60036,702-2S,6,2,4,31.96,,
60039,301103,0,0,0,1.49,,
60040,301106,0,0,0,7.98,,
60041,301124,4,4,0,14.21,,
60042,301148,6,4,2,5.02,,
60043,302103,10,10,0,1.76,,
60044,302106,6,1,5,9.77,,
60045,302124,0,0,0,17.16,,
60046,302148,8,5,3,5.91,,
60047,303103,21,16,5,2.07,,
60048,303106,4,0,4,12.15,,
60049,303124,5,1,4,21.58,,
60050,303148,6,0,6,7.41,,
60051,303603,13,10,3,2.28,,
60052,303606,6,2,4,11.62,,
60053,303624,2,1,1,20.44,,
60054,303648,5,0,5,7.37,,
60055,304103,8,4,4,2.38,,
60056,304106,5,2,3,6.81,,
60057,304124,4,4,0,12.15,,
60058,304148,10,1,9,8.28,,
60059,304602,0,0,0,1.76,,
60060,304603,2,1,1,2.38,,
60061,304606,10,4,6,6.81,,
60062,304624,0,0,0,12.15,,
60063,304648,7,4,3,8.28,,
60065,305103,14,4,10,2.67,,
60066,305106,10,1,9,7.98,,
60067,305124,5,1,4,14.21,,
60068,305148,21,14,7,9.77,,
60069,305602,2,1,1,2.53,,
60070,305603,6,3,3,2.66,,
60071,305624,9,3,6,14.21,,
60072,305648,14,3,11,9.77,,
60073,306103,5,5,0,4.16,,
60074,306106,10,1,9,10.09,,
60075,306124,4,3,1,18.06,,
60076,306148,18,8,10,15.38,,
60078,306602,3,3,0,2.95,,
60079,306603,5,2,3,4.16,,
60080,306606,3,2,1,10.09,,
60081,306624,4,3,1,18.06,,
60082,306648,15,5,10,15.38,,
60083,306924,5,2,3,17.10,,
60084,307103,2,2,0,5.34,,
60085,307106,0,0,0,8.97,,
60086,307124,2,2,0,17.16,,
60087,307148,5,0,5,19.51,,
60088,307624,2,2,0,16.26,,
60089,307648,1,0,1,19.74,,
60090,307906,0,0,0,9.05,,
60216,44412-1045,6,4,2,33.79,,
60219,44412-2045,9,4,5,43.94,,
60248,180003,10,2,8,4.46,,
60249,100010,2,0,2,9.77,,
60250,100025,2,0,2,22.02,,
60251,100050,0,0,0,38.38,,
60252,100099,0,0,0,71.60,,
60253,180103,4,2,2,4.46,,
60254,100110,3,1,2,9.77,,
60255,100125,1,1,0,22.02,,
60256,100150,1,1,0,38.38,,
60257,100199,0,0,0,71.60,,
60258,180203,0,0,0,4.46,,
60259,100210,0,0,0,9.77,,
60260,100225,0,0,0,22.02,,
60261,100250A,8,6,2,38.38,,
60262,100299,0,0,0,71.60,,
60263,180303,0,0,0,4.46,,
60264,100310,4,2,2,9.77,,
60265,100325,0,0,0,22.02,,
60266,100350,4,3,1,38.38,,
60267,100399,0,0,0,71.60,,
60268,180403,5,3,2,4.46,,
60269,100410,0,0,0,9.77,,
60270,100425,0,0,0,22.02,,
60271,100450,0,0,0,38.38,,
60272,100499,0,0,0,71.60,,
60273,180503,0,0,0,4.46,,
60274,100510,3,2,1,9.77,,
60275,100525,0,0,0,22.02,,
60276,100550,2,2,0,38.38,,
60277,100599,0,0,0,71.60,,
60278,180603,4,1,3,4.46,,
60313,SP-400-RB,1,0,1,36.49,,
60321,100610,4,2,2,9.77,,
60322,100625,0,0,0,22.02,,
60323,100650,0,0,0,38.38,,
60324,100699,0,0,0,71.60,,
60325,180703,2,2,0,4.46,,
60326,100710,5,3,2,9.77,,
60327,100725,0,0,0,22.02,,
60328,100750,0,0,0,38.38,,
60329,100799,0,0,0,71.60,,
60330,180803,8,5,3,4.46,,
60331,100810,3,0,3,9.77,,
60332,100825,1,1,0,22.02,,
60333,100850,0,0,0,38.38,,
60334,100899,0,0,0,71.60,,
60335,180903,4,4,0,4.46,,
60336,100910,0,0,0,9.77,,
60337,100925,0,0,0,22.02,,
60338,100950,0,0,0,38.38,,
60339,100999,0,0,0,71.60,,
60340,181003,2,2,0,4.46,,
60341,101010,5,1,4,9.77,,
60342,101025,0,0,0,22.02,,
60343,101050,0,0,0,38.38,,
60344,101099,0,0,0,71.60,,
60345,101910,7,5,2,11.09,,
60346,101925,0,0,0,26.71,,
60347,101950,0,0,0,49.40,,
60348,182003,8,4,4,4.33,,
60349,102025,8,5,3,26.71,,
60350,102050,1,0,1,49.40,,
60351,102099,0,0,0,81.83,,
60352,182103,3,0,3,4.33,,
60353,102110,7,4,3,11.09,,
60354,102125,3,1,2,26.71,,
60355,102150,0,0,0,49.40,,
60356,102199,0,0,0,81.83,,
60357,182203,4,1,3,4.33,,
60358,102210,9,2,7,11.09,,
60359,102225,2,0,2,26.71,,
60360,102250,0,0,0,49.40,,
60361,102299,0,0,0,81.83,,
60362,182303,4,2,2,4.33,,
60363,102310,8,5,3,11.09,,
60364,102325AA,0,0,0,26.71,,
60365,102350,0,0,0,49.40,,
60366,102399,0,0,0,81.83,,
60367,182403,2,0,2,4.33,,
60368,102425,0,0,0,26.71,,
60369,102450,0,0,0,49.40,,
60370,102499,0,0,0,81.83,,
60371,94-181-04,14,9,5,9.25,,
60376,AK1557,9,2,7,26.64,,
60378,100400-200-004-16,37,19,18,62.86,,
60405,010-11413-10,0,0,0,78.75,,
60409,182503,2,1,1,4.33,,
60410,102510,5,3,2,11.09,,
60411,102525,0,0,0,26.71,,
60412,102550,2,2,0,49.40,,
60413,102599,0,0,0,81.83,,
60414,182603,6,3,3,4.33,,
60415,102610,5,2,3,11.09,,
60416,102625,0,0,0,26.71,,
60417,102650,0,0,0,49.40,,
60418,182703,5,2,3,4.33,,
60419,102710,4,2,2,11.09,,
60420,102725,0,0,0,26.71,,
60421,102750,0,0,0,49.40,,
60422,102799,0,0,0,81.83,,
60423,182803,6,1,5,4.33,,
60424,102825,5,2,3,26.71,,
60425,102850,2,0,2,49.40,,
60426,102899,0,0,0,81.83,,
60427,182903,5,3,2,4.33,,
60428,102910,15,12,3,11.09,,
60429,102925,4,2,2,26.71,,
60430,102950,0,0,0,49.40,,
60431,102999,0,0,0,81.83,,
60432,183003,4,2,2,4.33,,
60433,103025,0,0,0,26.71,,
60434,103050,0,0,0,49.40,,
60435,103099,0,0,0,81.83,,
60477,121910,5,0,5,23.26,,
60478,121925,12,3,9,54.35,,
60479,121950,3,2,1,102.90,,
60481,121725,1,1,0,69.39,,
60482,121750,2,2,0,131.67,,
60484,121799,3,2,1,258.32,,
60486,121510,19,4,15,37.20,,
60487,121525,5,5,0,89.27,,
60488,121550,0,0,0,170.82,,
60489,121599,0,0,0,336.17,,
60491,121310,6,2,4,53.11,,
60492,121325,3,3,0,129.00,,
60493,121350,3,1,2,248.35,,
60494,121125,10,2,8,185.71,,
60496,121140,4,2,2,296.21,,
60497,121180,0,0,0,640.28,,
60498,120905,6,1,5,67.35,,
60499,120925,0,0,0,316.07,,
60500,120705,8,5,3,116.28,,
60521,FVSLTB152700A00,4,0,4,42.84,,
60526,189130,0,0,0,11.54,,
60527,189131,6,2,4,11.54,,
60528,189134,0,0,0,14.49,,
60529,189135,0,0,0,14.49,,
60530,189136,0,0,0,17.65,,
60531,189137,1,1,0,17.65,,
60532,189140,6,2,4,14.12,,
60533,189141,3,2,1,14.12,,
60534,189144,2,0,2,17.95,,
60535,189145,6,3,3,17.95,,
60536,189146,0,0,0,22.62,,
60537,189147,0,0,0,22.62,,
60542,121710,27,7,20,29.27,,
60557,TZ-114,0,0,0,823.53,,850.00
60565,001-409-510-00,0,0,0,177.27,,
60571,COK-0001B-2,9,6,3,16.17,,
60572,COK-0001T-2,10,7,3,24.63,,
60573,COK-0004G-2,3,1,2,7.03,,
60575,COK-0017-2,15,12,3,4.58,,
60576,COK-0018-2,6,4,2,12.25,,
60577,COK-0020-2,3,0,3,26.03,,
60578,COK-0022-2,4,2,2,27.33,,
60579,COK-0021-2,0,0,0,19.40,,
60580,COK-0043-1,0,0,0,91.23,,
60581,F16-1200-2,5,2,3,8.58,,
60582,RK-0002MP,3,2,1,148.40,,
60583,RK-0003MP,3,3,0,323.83,,
60584,RK-0003PB,4,2,2,329.65,,
60585,119250,0,0,0,175.87,,
60587,010-04284-00,0,0,0,157.49,,
60588,010-04283-00,1,1,0,119.99,,
60589,1175-BUCKET,0,0,0,181.28,,
60600,CA-0025-TG,0,0,0,121.98,,
60608,6303-0001-P,6,4,2,21.78,,
60614,010-12466-01,18,2,16,12.69,,
60625,FVSGANBTQ110A00,0,0,0,29.04,,
60629,FVSGEL110000A00,0,0,0,34.99,,
60630,FVSGEL125000A00,0,0,0,34.99,,
60631,FVSGEL140000A00,0,0,0,34.99,,
60634,S-3514,0,0,0,53.70,,
60635,S-3515,0,0,0,67.84,,
60636,S-3516,2,0,2,30.60,,
60637,S-3517,1,0,1,46.09,,
60638,6844C,6,2,4,27.85,,
60639,6846C,2,2,0,42.11,,
60641,S-5085P,0,0,0,5.91,,
60642,S-5086P,3,3,0,5.91,,
60649,A80275,2,0,2,99.99,,
60650,A80274,1,1,0,70.82,,
60651,A80310,2,1,1,166.66,,
60652,B4-619W2,0,0,0,5746.07,7036.00,
60654,210,0,0,0,5.97,,8.98
60655,270,0,0,0,4.83,,6.98
60656,272,3,0,3,8.04,,10.98
60657,274,9,1,8,6.41,,8.98
60658,276,12,3,9,7.97,,10.98
60659,278,0,0,0,4.19,,5.98
60661,281,3,3,0,10.91,,14.98
60662,282,13,1,12,3.54,,4.98
60663,284,0,0,0,7.69,,10.98
60664,285,0,0,0,22.39,,29.98
60665,288,0,0,0,9.17,,12.98
60666,293,8,8,0,15.30,,21.98
60667,294,0,0,0,28.16,,41.38
60671,10423,5,3,2,19.99,,
60716,6007,0,0,0,1160.70,,
60720,GPA021S,1,1,0,400.00,,
60721,ASK904B.64,8,0,8,165.97,,
60722,35AC,0,0,0,2.08,,
60723,MUSB35,7,7,0,12.67,,
60724,124925,3,1,2,56.44,,
60725,124950,1,0,1,102.22,,
60726,124999,0,0,0,199.11,,
60727,124725,3,1,2,69.39,,
60728,124799,0,0,0,258.33,,
60729,124502,4,0,4,15.80,,
60730,124525,5,1,4,89.41,,
60731,124550,1,1,0,170.82,,
60732,124599,2,0,2,334.68,,
60733,124325,3,1,2,128.29,,
60734,124350,4,2,2,246.93,,
60735,124102,8,4,4,23.45,,
60736,124125,6,4,2,193.93,,
60737,124140,3,1,2,296.21,,
60738,124180,0,0,0,640.28,,
60739,123905,1,0,1,67.35,,
60740,123910,4,3,1,130.61,,
60741,123950,0,0,0,654.61,,
60742,123705,0,0,0,102.29,,
60743,123710,0,0,0,198.91,,
60744,126710,3,2,1,52.99,,
60745,126725,0,0,0,106.41,,
60746,126750,0,0,0,210.07,,
60747,126510,3,1,2,74.37,,
60748,126525,0,0,0,145.73,,
60749,126550,0,0,0,285.20,,
60750,126310,3,2,1,103.35,,
60751,126325,1,0,1,204.40,,
60752,126350,0,0,0,403.77,,
60753,154010,7,3,4,65.98,,
60754,154030,4,2,2,145.29,,
60755,154510,4,2,2,50.11,,
60756,154525,0,0,0,117.49,,
60757,153110,19,2,17,28.44,,
60758,153125,1,0,1,59.88,,
60759,153150,0,0,0,117.04,,
60760,141410,5,2,3,119.44,,
60761,141425,1,1,0,249.99,,
60762,153010,3,1,2,28.55,,
60763,153050,0,0,0,124.15,,
60777,260-11795,0,0,0,38.05,,
60778,260-11796,3,2,1,22.99,,
60782,333-11797,0,0,0,56.20,,
60783,333-11798,0,0,0,56.20,,
60784,333-11799,0,0,0,56.20,,
60785,350-11800,2,0,2,16.19,,
60788,310-11801,0,0,0,16.19,,
60791,301-11802,2,0,2,16.19,,
60792,382-11803,0,0,0,16.19,,
60794,382-11804,3,2,1,12.99,,
60795,332-11805,1,0,1,16.19,,
60796,150-11806,0,0,0,26.67,,
60809,184203,5,2,3,4.71,,
60810,104225,0,0,0,37.00,,
60811,104250,0,0,0,66.54,,
60812,104299,0,0,0,129.37,,
60813,184303,3,2,1,4.71,,
60814,104325,0,0,0,37.00,,
60815,104350,0,0,0,66.54,,
60816,104399,0,0,0,129.37,,
60817,184403,6,4,2,4.71,,
60818,104410,3,0,3,15.95,,
60819,104425,0,0,0,37.00,,
60820,104450,0,0,0,66.54,,
60821,104499,0,0,0,129.37,,
60822,184503,0,0,0,4.71,,
60823,104525,2,2,0,37.00,,
60824,104550,0,0,0,66.54,,
60825,104599,0,0,0,129.37,,
60826,184603,10,1,9,4.71,,
60827,104625,0,0,0,37.00,,
60828,104650,0,0,0,66.54,,
60829,184703,51,45,6,4.71,,
60830,104725,2,2,0,35.28,,
60831,104750,0,0,0,66.54,,
60832,184803,13,9,4,4.71,,
60833,104825,3,1,2,37.00,,
60834,104850,2,2,0,66.54,,
60835,104899,0,0,0,129.37,,
60836,184903,3,1,2,4.71,,
60837,104910,7,3,4,15.95,,
60838,104925,4,2,2,37.00,,
60839,104950,0,0,0,66.54,,
60840,104999,0,0,0,129.37,,
60841,185003,5,2,3,4.71,,
60842,105025,3,1,2,37.00,,
60843,105050,2,2,0,66.54,,
60844,105099,0,0,0,129.37,,
60845,186003,0,0,0,4.61,,
60846,106002,3,2,1,9.21,,
60847,106025,4,2,2,54.26,,
60848,106040,3,1,2,79.82,,
60849,106102,0,0,0,9.21,,
60850,106110,4,2,2,21.43,,
60851,106125,0,0,0,54.26,,
60852,106140,3,0,3,79.82,,
60853,106199,0,0,0,191.29,,
60854,106202,0,0,0,9.21,,
60855,106210,4,2,2,21.43,,
60856,106225,0,0,0,54.26,,
60857,106240,0,0,0,79.82,,
60858,106299,0,0,0,191.29,,
60859,106302,5,2,3,9.21,,
60860,106325,0,0,0,54.26,,
60861,106340,0,0,0,79.82,,
60862,106399,0,0,0,191.29,,
60863,106499,0,0,0,191.29,,
60864,106502,0,0,0,9.21,,
60865,106510,4,2,2,21.43,,
60866,106525,0,0,0,54.26,,
60867,106540,0,0,0,79.82,,
60868,106599,0,0,0,191.29,,
60869,106602,0,0,0,9.21,,
60870,106610,0,0,0,21.43,,
60871,106625,0,0,0,54.26,,
60872,106640,0,0,0,79.82,,
60873,106702,2,2,0,9.21,,
60874,106710,0,0,0,21.43,,
60875,106725,0,0,0,54.26,,
60876,106740,0,0,0,79.82,,
60877,186803,3,3,0,4.61,,
60878,106802,9,3,6,9.21,,
60879,106825,6,4,2,54.26,,
60880,106840,3,1,2,79.82,,
60881,106899,0,0,0,191.29,,
60882,P10068,2,2,0,204.60,,
60883,188003,0,0,0,4.61,,
60884,108002,4,2,2,14.40,,
60885,108025,2,0,2,80.52,,
60886,108050,4,2,2,155.74,,
60887,108099,0,0,0,286.15,,
60888,108102,0,0,0,14.40,,
60889,108110,0,0,0,32.88,,
60890,108125,0,0,0,80.52,,
60891,108150,2,2,0,149.99,,
60893,108199,0,0,0,286.15,,
60894,108202,0,0,0,14.40,,
60895,108210,5,4,1,32.88,,
60896,108225,0,0,0,80.52,,
60897,108250,0,0,0,155.74,,
60898,108299,0,0,0,286.15,,
60899,108302,3,1,2,14.40,,
60900,108325,0,0,0,80.52,,
60901,108350,0,0,0,155.74,,
60902,108399,0,0,0,286.15,,
60903,108502,0,0,0,14.40,,
60904,108510,0,0,0,32.88,,
60905,108525,0,0,0,80.52,,
60906,108550,0,0,0,155.74,,
60907,108599,0,0,0,286.15,,
60908,188803,0,0,0,4.61,,
60909,108802,2,2,0,14.40,,
60910,108825,2,0,2,80.52,,
60911,108850,4,2,2,155.74,,
60912,108899,0,0,0,286.15,,
60913,108902,3,0,3,14.40,,
60914,PSW5,0,0,0,16.00,,
60915,108925,0,0,0,80.52,,
60916,108950,0,0,0,155.74,,
60917,108999,0,0,0,286.15,,
60918,109002,3,2,1,14.40,,
60919,109010,2,1,1,32.88,,
60920,109025,3,2,1,80.52,,
60921,109050,0,0,0,155.74,,
60922,109099,0,0,0,286.15,,
60923,109302,3,2,1,14.40,,
60924,109310,0,0,0,32.88,,
60925,109325,0,0,0,80.52,,
60926,109350,0,0,0,155.74,,
60927,109399,0,0,0,286.15,,
60928,3764.1,0,0,0,14.23,,
60980,MC0075-3130,2,2,0,52.88,,
60981,MC0075-1132,0,0,0,52.88,,
60984,S8101512,6,4,2,47.08,,
60985,010-11969-00,2,0,2,27.99,,
60987,WFPC-6,0,0,0,14.20,,
60988,WFPC-6.5,0,0,0,14.20,,
60989,WFPC-7,0,0,0,16.03,,
60990,WFPC-7.5,0,0,0,16.03,,
60991,WFPC-8,0,0,0,16.79,,
60992,WFPC-8.5,0,0,0,16.79,,
60993,WFPC-9,0,0,0,18.71,,
60994,WFPC-9.5,0,0,0,18.71,,
60995,WFPC-10,0,0,0,23.53,,
60996,WFPC-10.5,0,0,0,23.53,,
60997,WFPC-11,0,0,0,24.61,,
60998,WFPC-11.5,0,0,0,25.68,,
60999,WFPC-12,0,0,0,26.22,,
61000,WFPC-12.5,0,0,0,27.29,,
61001,WFPC-13,0,0,0,28.37,,
61002,WFPC-13.5,0,0,0,29.45,,
61003,WFPC-14,0,0,0,31.59,,
61004,WFPC-14.5,0,0,0,31.59,,
61005,WFPC-15,0,0,0,33.71,,
61006,WFPC-15.5,0,0,0,33.71,,
61014,142012304,0,0,0,46.41,,
61038,2020,15,14,1,13.04,,
61039,326103,2,1,1,4.43,,
61040,326106,2,0,2,7.65,,
61041,326124,0,0,0,14.64,,
61042,326148,8,5,3,16.14,,
61043,326202,7,6,1,3.29,,
61044,326603,5,2,3,4.47,,
61045,326606,2,2,0,7.65,,
61046,326624,4,0,4,14.64,,
61047,326648,9,5,4,16.14,,
61048,327124,7,3,4,11.94,,
61049,327148,2,1,1,19.51,,
61050,327202,0,0,0,4.17,,
61051,327606,0,0,0,6.59,,
61052,327624,8,4,4,11.94,,
61053,327648,6,4,2,19.51,,
61054,316825,6,3,3,34.47,,
61055,316925,4,2,2,21.62,,
61056,317825,9,8,1,36.34,,
61057,317925,2,1,1,21.62,,
61058,320825,5,3,2,41.59,,
61059,320925,5,3,2,24.57,,
61060,320999,4,2,2,49.13,,
61061,7928,4,4,0,10.80,,
61062,7929,1,1,0,8.13,,
61063,7930,59,5,54,8.13,,
61064,7931,2,2,0,10.24,,
61065,7932,8,5,3,10.24,,
61066,7933,0,0,0,10.24,,
61067,7934,3,3,0,10.00,,
61068,7935,6,3,3,10.00,,
61069,7936,0,0,0,13.59,,
61070,7937,5,3,2,13.59,,
61071,7938,5,0,5,13.59,,
61072,7939,2,2,0,13.59,,
61118,MILREM70,1,0,1,57.93,89.95,
61194,E70342,0,0,0,70.82,,
61195,E70339,2,0,2,158.32,,
61196,E70340,2,1,1,258.32,,
61197,E70341,0,0,0,258.32,,
61229,FLKMT0000000A00,1,0,1,135.76,,
61231,30266-001,0,0,0,274.78,,
61232,30267-001D,0,0,0,21.99,,
61233,30268-001D,0,0,0,14.14,,
61234,30268-002D,0,0,0,14.14,,
61235,30281-001D,0,0,0,45.54,,
61245,300-036,0,0,0,1256.36,,1601.85
61246,400-404,0,0,0,38.44,,49.01
61252,62-541-MARINE,0,0,0,49.94,,
61254,62-541-MARINE-RLY-NC,0,0,0,52.44,,
61257,62-542-MARINE,12,8,4,49.94,,
61258,62-542-MARINE-RLY-NC,9,9,0,52.44,,
61267,SA-1000XL,0,0,0,36.19,,
61268,SA-6200,0,0,0,21.56,,
61270,010-C1134-00,0,0,0,84.99,,
61271,010-C1130-00,0,0,0,84.99,,
61273,010-C1131-00,0,0,0,84.99,,
61274,010-C1133-00,0,0,0,84.99,,
61317,F16-0006L,15,12,3,85.03,,
61318,F16-0005A,16,10,6,141.31,,
61322,P1120Z-41HAE,3,3,0,102.44,,
61323,A3120Z-41HAE,3,0,3,89.63,,
61325,SEMF06,10,10,0,39.00,,
61335,F16-0800-1,0,0,0,271.08,,
61336,F31-0780BXY-1,5,2,3,290.92,,
61337,F31-0781BXY-1,1,0,1,290.92,,
61338,BFPC-10.5,0,0,0,23.53,,
61339,BFPC-11.5,0,0,0,25.68,,
61342,10040001,0,0,0,2762.94,,
61345,001-248-170-00,0,0,0,340.91,,
61346,52520-1000,3,2,1,512.86,,
61374,MM3-VNA-027,0,0,0,227.27,,
61378,001-341-820-00,0,0,0,386.36,,
61407,111002,9,2,7,20.57,,
61408,111005,4,3,1,36.68,,
61409,111025,2,1,1,136.37,,
61410,111050,0,0,0,267.44,,
61411,111099,0,0,0,518.29,,
61412,111302,2,2,0,20.57,,
61413,111305,3,1,2,36.68,,
61414,111325,3,2,1,136.37,,
61415,111350,0,0,0,267.44,,
61416,111399,0,0,0,518.29,,
61417,111505,3,2,1,36.68,,
61418,111525,1,0,1,136.37,,
61419,111550,0,0,0,267.44,,
61420,111702,0,0,0,20.57,,
61421,111705,0,0,0,36.68,,
61422,111710,0,0,0,55.43,,
61423,111725,0,0,0,136.37,,
61424,111750,0,0,0,267.44,,
61425,111799,0,0,0,518.29,,
61427,111905,4,2,2,36.68,,
61428,111925,5,3,2,136.37,,
61429,111950,0,0,0,267.44,,
61430,111999,0,0,0,518.29,,
61431,112005,10,5,5,49.39,,
61432,112025,0,0,0,214.76,,
61433,112050,0,0,0,417.17,,
61434,112075,0,0,0,670.59,,
61435,112305,6,2,4,49.39,,
61436,112325,4,1,3,214.76,,
61437,112350,0,0,0,417.17,,
61438,112375,0,0,0,613.34,,
61439,112505,5,4,1,49.39,,
61440,112525,0,0,0,214.76,,
61441,112550,0,0,0,417.17,,
61442,112575,0,0,0,670.59,,
61443,112702,7,3,4,25.45,,
61444,112705,0,0,0,49.39,,
61445,112710,5,2,3,89.17,,
61446,112725,0,0,0,214.76,,
61447,112750,0,0,0,417.17,,
61448,112775,0,0,0,613.34,,
61449,112902,4,2,2,25.45,,
61450,112905,3,2,1,49.39,,
61451,112910,2,1,1,89.17,,
61452,112925,0,0,0,214.76,,
61453,112950,0,0,0,417.17,,
61454,112975,0,0,0,613.34,,
61456,GSE-1939BSA30-C,0,0,0,325.10,,
61468,"WB 201-50",14,4,10,25.26,37.95,
61469,"SM 10250-50",17,6,11,24.97,34.95,
61471,E66071,0,0,0,229.16,,
61472,R109C-LH,0,0,0,2806.82,,
61476,S72-0632,0,0,0,458.06,,
61487,BFPC-6,0,0,0,14.20,,
61488,BFPC-6.5,0,0,0,14.20,,
61489,BFPC-7,0,0,0,16.03,,
61490,BFPC-7.5,0,0,0,16.03,,
61491,BFPC-8,0,0,0,16.79,,
61492,BFPC-8.5,0,0,0,16.79,,
61493,BFPC-9,0,0,0,18.71,,
61494,BFPC-9.5,0,0,0,18.71,,
61495,BFPC-10,0,0,0,23.53,,
61496,BFPC-11,0,0,0,24.61,,
61497,BFPC-12,0,0,0,26.22,,
61498,BFPC-12.5,0,0,0,27.29,,
61499,BFPC-13,0,0,0,28.37,,
61500,BFPC-13.5,0,0,0,29.45,,
61501,BFPC-14,0,0,0,31.59,,
61502,BFPC-14.5,0,0,0,31.59,,
61503,BFPC-15,0,0,0,33.71,,
61504,BFPC-15.5,0,0,0,33.71,,
61507,210613,25,5,20,5.38,,
61513,010-01504-00,0,0,0,127.99,,
61518,1160-F,0,0,0,74.13,,
61519,73-106-F,19,11,8,14.24,,
61520,96-306-F,5,5,0,29.45,,
61537,360-406,16,8,8,40.97,,
61538,323-479,11,5,6,25.77,,
61541,360-430,33,24,9,38.31,,
61543,010-11351-40,2,0,2,33.74,,
61544,323-478,11,3,8,28.80,,
61546,360-003,9,4,5,35.21,,
61547,MM3-FNA-022,0,0,0,90.91,,
61564,58356,24,15,9,41.80,,
61565,58358,22,15,7,40.97,,
61567,"PB 101-50",7,5,2,24.12,34.95,
61568,GS-380XL,8,4,4,1799.99,,
61574,MM3-VNA-022,0,0,0,227.27,,
61575,R70257,0,0,0,21.30,,
61577,65-541WHT,0,0,0,49.94,,
61578,72-0676,0,0,0,77.56,,
61580,11865-4,3,1,2,33.00,,
61582,11830-2,0,0,0,10.74,,
61585,385320007,0,0,0,20.52,,
61586,30140-001D,0,0,0,14.31,,
61587,70568-001,0,0,0,40.83,,
61588,113550,0,0,0,645.95,,
61589,114540,0,0,0,771.01,,
61592,360-410,6,2,4,38.21,,
61593,360-801,4,1,3,35.59,,
61598,340-020,3,2,1,46.64,,
61601,340-786,0,0,0,131.88,,
61605,230-604,7,4,3,19.53,,
61606,230-404,4,2,2,16.72,,
61607,230-515,0,0,0,16.72,,
61608,230-504,0,0,0,16.72,,
61609,600-802,34,24,10,5.14,,
61613,226-001,0,0,0,31.40,,
61614,226-007,3,2,1,31.89,,
61615,226-163,1,1,0,27.99,,
61616,226-162,3,0,3,36.25,,
61618,226-456,3,1,2,149.99,,
61621,CBL-10M-IRID,0,0,0,194.44,,
61622,CBL-15M-IRID,4,3,1,219.99,,
61623,CBL-20M-IRID,1,1,0,275.00,,
61641,226-615,4,2,2,29.99,,
61642,226-618,3,1,2,33.25,,
61644,226-620,3,1,2,33.25,,
61645,226-623,3,1,2,33.25,,
61646,226-625,2,0,2,35.39,,
61647,226-627,2,0,2,35.39,,
61648,226-630,2,0,2,38.28,,
61649,226-633,0,0,0,38.28,,
61650,226-635,2,2,0,34.99,,
61651,226-640,1,1,0,44.15,,
61652,226-645,0,0,0,46.63,,
61653,226-660,3,2,1,53.73,,
61654,226-666,3,3,0,62.64,,
61655,226-680,0,0,0,64.59,,
61656,226-690,0,0,0,76.95,,
61657,600-880,0,0,0,10.16,,
61658,600-878,0,0,0,6.88,,
61659,600-879,0,0,0,10.36,,
61661,600-840,0,0,0,5.92,,
61662,600-815,9,0,9,4.42,,
61663,RMX4500,0,0,0,385.44,,
61666,A0-SIDE-175,0,0,0,1424.79,,
61667,A1-2000-MIN,0,0,0,1854.35,,
61678,HTM-3-ORANGEWO,0,0,0,91.23,,
61680,FAP7011C-A,0,0,0,933.33,,
61682,1238SC,7,6,1,44.87,,
61685,114117,0,0,0,90.88,,
61686,MBB300C-01,0,0,0,1302.40,,
61687,PT-0-1.5PSI-01,3,2,1,151.20,,
61691,113005,4,1,3,63.12,,
61692,113025,0,0,0,297.41,,
61693,113050,0,0,0,645.95,,
61694,113505,18,1,17,63.12,,
61695,113525,4,2,2,297.41,,
61696,113905,4,1,3,63.12,,
61697,113925,0,0,0,297.41,,
61698,113950,0,0,0,590.80,,
61699,114005,5,0,5,101.88,,
61700,114025,0,0,0,470.28,,
61701,114040,0,0,0,771.01,,
61702,114505,6,2,4,101.88,,
61703,114525,1,0,1,470.28,,
61704,114905,4,2,2,101.88,,
61705,114925,0,0,0,470.28,,
61706,114940,0,0,0,822.41,,
61707,115002,0,0,0,92.55,,
61708,115005,1,0,1,129.77,,
61709,115030,0,0,0,732.82,,
61710,115502,1,0,1,92.55,,
61711,115505,3,1,2,129.77,,
61712,115530,0,0,0,732.82,,
61713,115902,0,0,0,92.55,,
61714,115905,0,0,0,129.77,,
61715,115930,0,0,0,732.82,,
61716,116002,4,3,1,79.90,,
61717,116005,3,0,3,149.68,,
61718,116025,0,0,0,813.40,,
61719,116502,0,0,0,79.90,,
61720,116505,6,2,4,149.68,,
61721,116525,0,0,0,813.40,,
61722,116902,0,0,0,79.90,,
61723,116905,4,2,2,149.68,,
61724,116925,0,0,0,743.96,,
61725,117002,6,3,3,102.00,,
61726,117020,0,0,0,783.96,,
61727,117502,8,7,1,102.00,,
61728,117520,0,0,0,717.04,,
61729,117902,5,3,2,102.00,,
61730,117920,0,0,0,717.04,,
61734,E70097,2,1,1,1932.05,,
61737,010-11422-00,0,0,0,29.39,,
61740,E70346,3,1,2,655.25,,
61747,151750,0,0,0,488.71,,
61748,0440-BK-4,2,2,0,6.96,,
61749,0440-BK-8,11,11,0,9.40,,
61751,0282-BK,11,11,0,23.23,,
61760,FX-7-AS,0,0,0,274.55,,
61761,FX-11-AS,9,9,0,320.42,,
61763,E70327,13,4,9,469.73,,
61770,A80351,14,3,11,99.00,,
61772,P101,21,11,10,466.00,,
61777,G-3040C,7,5,2,12.33,,
61778,G-3040SSC,8,4,4,29.24,,
61779,G-31120C,3,2,1,29.99,,
61780,G-31120SSC,1,0,1,75.08,,
61781,G-3120C,4,2,2,12.33,,
61782,G-3120SSC,0,0,0,27.51,,
61783,G-3140C,6,6,0,12.33,,
61784,G-3140SSC,0,0,0,27.92,,
61785,G-3320C,10,6,4,12.33,,
61786,G-3320SSC,1,1,0,30.72,,
61787,G-3330C,2,2,0,12.33,,
61788,G-3340C,4,1,3,12.33,,
61789,G-3340SSC,4,1,3,30.72,,
61790,G-3360C,0,0,0,12.33,,
61791,G-3360SSC,7,2,5,30.72,,
61792,G-3420C,2,2,0,12.33,,
61793,G-3420SSC,0,0,0,32.21,,
61794,G-3430C,5,3,2,12.33,,
61796,G-3440SSC,4,2,2,32.21,,
61797,G-3460C,6,6,0,12.33,,
61798,G-3460SSC,4,2,2,32.21,,
61799,G-3490C,0,0,0,12.33,,
61800,G-3480C,2,2,0,12.33,,
61801,G-3490SSC,2,2,0,36.13,,
61802,G-34120C,0,0,0,12.33,,
61803,G-34120SSC,0,0,0,36.13,,
61804,G-3520C,0,0,0,12.33,,
61805,G-3530C,0,0,0,12.33,,
61806,G-3550C,0,0,0,12.33,,
61807,G-3590C,2,0,2,12.33,,
61809,G-3620C,0,0,0,12.33,,
61810,G-3620SSC,0,0,0,31.45,,
61812,G-3630C,0,0,0,12.33,,
61813,112528,10,6,4,73.08,,
61814,G-3630SSC,2,0,2,31.45,,
61815,G-3640C,0,0,0,12.33,,
61816,G-3640SSC,1,0,1,31.45,,
61817,G-3650C,0,0,0,12.33,,
61818,G-3660C,3,2,1,12.33,,
61819,G-3660SSC,2,2,0,34.92,,
61820,G-3690C,0,0,0,12.33,,
61821,G-3690SSC,0,0,0,34.92,,
61822,G-6624C,0,0,0,12.33,,
61823,G-6624SSC,0,0,0,32.23,,
61833,G-3020C,5,3,2,12.33,,
61843,G-3020SSC,6,2,4,29.24,,
61847,LMJ-1,10,4,6,35.04,,
61850,MM3-VNA-026,0,0,0,227.27,,
61875,MCU004,0,0,0,355.56,,
61883,RA5204BK,0,0,0,96.15,,
61897,96-262-F,9,9,0,28.12,,
61915,LLB-48FW-82-00,0,0,0,21.32,,
61925,M265C-LH,0,0,0,1236.08,,
61928,P102983,0,0,0,406.20,,
61934,ES-5000-01,0,0,0,331.25,,
61942,B164-20-BL,0,0,0,917.61,,
61949,010-11425-05,0,0,0,24.49,,
61950,808-1802,4,2,2,100.80,,
61952,010-10718-01,9,5,4,10.99,,
61969,SA1200S,2,1,1,76.44,,
61970,010-11251-74,0,0,0,23.99,,
61973,010-11251-86,0,0,0,31.99,,
61974,010-11251-90,0,0,0,31.99,,
61975,010-11251-85,0,0,0,31.99,,
61985,010-12390-21,0,0,0,26.24,,
61986,010-12390-11,2,0,2,22.49,,
61987,131310,9,4,5,75.13,,
61988,A-5-WHITE,0,0,0,201.47,,
62005,741S-02037,0,0,0,233.30,,
62026,4018,0,0,0,517.68,,
62030,FNTCDEX06000A00,0,0,0,47.92,,
62036,150510,0,0,0,47.32,,
62037,150525,0,0,0,107.02,,
62040,E70305,0,0,0,98.00,,
62043,7879CR,0,0,0,35.17,,
62044,5262CRR,0,0,0,23.83,,
62050,001-122-870-10,0,0,0,445.45,,
62054,7010CAWBX,0,0,0,99.21,119.00,
62055,7010CABBX,0,0,0,99.21,119.00,
62061,41970,9,7,2,42.97,,
62062,41951,6,4,2,23.19,,
62066,58355,4,0,4,40.97,,
62067,58357,7,2,5,40.97,,
62079,"NF-4 WHITE",7,4,3,35.40,,
62084,3154,3,3,0,18.63,,26.98
62085,3130,0,0,0,9.63,,14.98
62087,YBP-5100,0,0,0,19.94,,28.98
62088,120,0,0,0,11.89,,16.98
62089,975,9,0,9,35.33,,49.98
62090,2461,7,7,0,41.79,,59.98
62091,2462,11,11,0,41.79,,59.98
62092,2402,0,0,0,8.63,,11.98
62093,2403,3,3,0,8.63,,11.98
62094,2404,0,0,0,8.63,,11.98
62095,YBP-0301,0,0,0,12.21,,17.98
62096,YBP-0305,0,0,0,12.21,,17.98
62097,YBP-0701,5,3,2,14.77,,19.98
62098,YBP-0801,0,0,0,11.63,,16.98
62099,273,0,0,0,6.97,,10.33
62100,134,29,9,20,7.13,,9.98
62102,760H,0,0,0,8.51,,12.98
62103,833H,0,0,0,10.27,,15.98
62104,855H,0,0,0,12.53,,18.98
62131,MC0075-9002,11,8,3,43.42,,
62132,MC0075-9001,0,0,0,52.88,,
62135,1480,0,0,0,452.91,,
62151,RH5999-9001,14,10,4,16.03,,
62168,DRS6AX,0,0,0,3640.95,,4495.00
62189,31631-0092,10,6,4,142.75,,
62194,2061-5,5,0,5,8.36,,
62198,ZIDIGIK,1,1,0,214.99,,
62200,2130,37,13,24,4.00,,
62201,2132,58,31,27,4.00,,
62203,2133,38,10,28,4.00,,
62204,2134,12,0,12,4.00,,
62232,RA5204WH,3,1,2,96.15,,
62237,T234,0,0,0,237.49,,
62243,56580,2,1,1,72.38,,
62244,53700,10,7,3,60.97,119.99,
62246,53710,23,7,16,60.97,119.99,
62247,53715,6,1,5,60.97,119.99,
62248,53720,10,6,4,60.97,119.99,
62249,53725,10,2,8,60.97,119.99,
62250,53730,14,8,6,60.97,119.99,
62251,53735,24,20,4,60.97,119.99,
62252,53740,9,5,4,60.97,119.99,
62253,53745,18,6,12,60.97,119.99,
62254,53750,20,3,17,60.97,119.99,
62261,A80371,5,0,5,17.03,,
62262,A80372,3,3,0,17.03,,
62266,13515,19,13,6,46.69,,
62278,ENP-REMOTE,1,1,0,129.99,,
62318,RODE38,0,0,0,243.00,,
62319,RODE51,1,1,0,432.00,,
62320,RODE52,2,2,0,333.60,,
62322,RODE53,0,0,0,418.20,,
62328,"18753-0178  ",7,5,2,45.30,,
62332,0420-BK,0,0,0,21.75,,
62336,010-11251-44,1,1,0,21.99,,
62354,1363559,18,11,7,764.71,,
62368,1358958,15,7,8,2660.11,,
62371,1358955,0,0,0,1662.50,,
62373,1358965,22,4,18,1750.00,,
62379,001-325-990-00,0,0,0,554.55,,
62388,1854035,19,11,8,53.36,,
62389,1862051,0,0,0,57.16,,
62390,1866070,17,5,12,79.91,,
62392,1866550,0,0,0,133.62,,
62393,1866650,12,10,2,245.59,,
62395,1866670,0,0,0,23.24,,
62396,1866155,11,11,0,114.40,,
62398,410190-1,19,10,9,190.82,,
62400,410200-1,16,12,4,234.18,,
62405,410150-1,4,0,4,105.32,,
62406,410170-1,0,0,0,175.53,,
62425,740155-1,3,3,0,45.45,,
62429,750013-1,0,0,0,1572.40,,1799.99
62442,600050-1,20,0,20,97.40,,149.99
62460,010-12445-33,2,2,0,22.49,,
62463,010-11976-00,0,0,0,3.49,,
62470,SET0015,0,0,0,274.50,,
62479,SCM-10-BB-20,5,2,3,378.96,,539.00
62481,SCM-10-GW-20,0,0,0,378.96,,539.00
62486,SCM-10-AG-20,0,0,0,378.96,,539.00
62491,SCM-10-UB-20,0,0,0,378.96,,539.00
62493,SCM-10-CR-20,0,0,0,378.96,,539.00
62494,SCM-6-BB-20,2,0,2,282.50,,399.00
62495,SCM-6-GW-20,1,1,0,253.93,,399.00
62501,SCM-6-AG-20,1,0,1,253.93,,399.00
62503,SCM-6-UB-20,0,0,0,282.50,,399.00
62506,SCM-6-CR-20,0,0,0,282.50,,399.00
62513,SCM-4-BB-20,2,0,2,201.25,,299.00
62514,SCM-4-GW-20,0,0,0,201.25,,299.00
62517,SCM-4-AG-20,1,0,1,180.90,,299.00
62522,SCM-4-UB-20,0,0,0,201.25,,299.00
62527,SCM-4-CR-20,0,0,0,201.25,,299.00
62538,SCM-AL-LED-16,1,1,0,119.99,,169.00
62539,SCM-AL-LED-8,5,3,2,83.00,,112.00
62540,SCM-CL-BB-4PACK,2,0,2,88.84,,129.95
62541,SCM-CL-GW-4PACK,0,0,0,88.84,,129.95
62542,SCM-CL-CR-4PACK,0,0,0,88.84,,129.95
62543,SCM-CL-RGB-4PACK,2,0,2,106.62,,149.95
62544,SCM-CL-BB-SS-4PACK,0,0,0,97.65,,139.95
62545,SCM-CL-GW-SS-4PACK,0,0,0,97.65,,139.95
62546,SCM-CL-CR-SS-4PACK,0,0,0,97.65,,139.95
62547,SCM-CL-RGB-SS-4PACK,0,0,0,110.44,,159.95
62550,SCM-PD,0,0,0,178.04,,269.00
62552,SCM-PD-PLUS,0,0,0,299.97,,419.00
62554,SCM-TT-10,0,0,0,120.99,,169.00
62555,SCM-TT-6,0,0,0,120.99,,169.00
62556,SCM-TT-4,0,0,0,120.99,,169.00
62559,131710,2,1,1,38.10,,
62560,131725,0,0,0,93.98,,
62561,131750,0,0,0,174.96,,
62562,131799,0,0,0,344.73,,
62563,RL-513,1,1,0,16.29,,
62564,131525,3,3,0,127.35,,
62567,131302,8,5,3,29.55,,
62568,131325,1,1,0,186.20,,
62569,131370,0,0,0,521.32,,
62570,131130,2,2,0,317.84,,
62571,131150,1,0,1,574.85,,
62572,130902,6,3,3,72.32,,
62573,130905,2,0,2,103.63,,
62574,130910,0,0,0,203.06,,
62575,130705,4,1,3,201.22,,
62576,130710,4,2,2,394.30,,
62577,133710,6,2,4,75.28,,
62578,133725,0,0,0,170.35,,
62579,133510,4,1,3,78.40,,
62580,133525,4,2,2,192.57,,
62581,133590,0,0,0,637.95,,
62583,133310,5,3,2,107.15,,
62584,133325,4,2,2,259.55,,
62585,151025,0,0,0,104.87,,
62586,151050,0,0,0,202.06,,
62587,151725,0,0,0,249.55,,
62588,151550,7,0,7,246.76,,
62589,151560,0,0,0,475.22,,
62591,199300,3,3,0,1.70,,
62592,199301,0,0,0,3.60,,
62593,199302,0,0,0,30.55,,
62594,199303,0,0,0,1.97,,
62595,199304,0,0,0,4.69,,
62596,199305,0,0,0,42.72,,
62597,199306,0,0,0,2.36,,
62598,199307,0,0,0,5.85,,
62599,199308,0,0,0,48.69,,
62600,199309,0,0,0,1.70,,
62601,199310,0,0,0,3.60,,
62602,199311,0,0,0,32.63,,
62603,199312,0,0,0,1.97,,
62604,199313,0,0,0,4.69,,
62607,199315,0,0,0,2.36,,
62608,199316,0,0,0,5.85,,
62610,199318,0,0,0,4.05,,
62611,199319,0,0,0,18.15,,
62613,199321,0,0,0,19.39,,
62614,199322,0,0,0,3.60,,
62616,220011,5,4,1,24.95,,
62617,309000,7,1,6,68.19,,
62618,309001,0,0,0,62.52,,
62619,309101,9,0,9,62.52,,
62620,309201,1,0,1,80.67,,
62621,703023,4,2,2,28.14,,
62622,703075,4,1,3,22.06,,
62623,6396-AIS-R,2,0,2,349.25,,
62624,NPT2000,0,0,0,290.90,,
62644,G10307,5,2,3,10.85,,
62697,TW4B07700JV,92,92,0,28.49,,
62739,RODE59,0,0,0,459.60,,
62740,RODE60,0,0,0,561.60,,
62741,8M0107522,2,2,0,72.99,,
62744,11870-0005,0,0,0,1262.25,,
62754,11841-002,0,0,0,155.55,,
62755,15170-001,64,10,54,288.41,,
62756,11841-004,0,0,0,180.29,,
62757,15169-001,4,4,0,169.81,,
62758,15171-001,1,1,0,366.63,,
62783,P100735,6,2,4,92.81,,
62825,15270-001,3,0,3,365.56,,
62826,30343-001,13,7,6,133.01,,
62835,30340-001,7,3,4,256.63,,
62836,15271-001,0,0,0,484.75,,
62837,30342-001,0,0,0,363.70,,
62838,11841-101,8,0,8,105.28,,
62841,114127,0,0,0,90.88,,
62865,11841-102,2,0,2,118.00,,
62866,11841-103,0,0,0,131.43,,
62867,11841-104,0,0,0,143.44,,
62868,11841-105,0,0,0,152.63,,
62873,11841-001,6,0,6,142.14,,
62874,11841-003,0,0,0,168.28,,
62875,11841-005,0,0,0,189.48,,
62876,11941-001,0,0,0,174.64,,
62877,11941-002,0,0,0,185.24,,
62878,11941-003,4,0,4,192.30,,
62879,11941-004,0,0,0,199.36,,
62880,11941-005,0,0,0,206.43,,
62884,50480-001,0,0,0,70.29,,
62885,50480-021,0,0,0,80.94,,
62890,GX6000,29,13,16,400.56,,
62894,SSM-70H,23,6,17,99.99,,
62896,SCU-30,8,4,4,99.99,,
62897,SCU-31,5,2,3,79.99,,
62899,S32-0619-0100,0,0,0,411.75,,
62900,410160-1,22,22,0,149.21,,
62901,SP0530,0,0,0,4.50,,
62903,2210012,3,2,1,265.63,,
62905,4445,0,0,0,20.57,,
62912,4132,13,3,10,48.75,,
62921,88800,0,0,0,1822.46,2699.95,
62922,88805,0,0,0,1574.96,2099.95,
62939,88969,0,0,0,543.54,879.95,
62945,A10-140,0,0,0,19.69,,
62985,A80322,1,0,1,2099.17,,
62986,A80327,3,2,1,108.32,,
62991,36143,18,17,1,7.21,,
63000,91105,6,6,0,4.75,,
63003,IF1500AIS,0,0,0,518.18,,
63008,2129,12,4,8,4.00,,
63009,2131,12,4,8,4.00,,
63010,2135,20,20,0,4.00,,
63011,2136,10,0,10,4.00,,
63012,2137,7,7,0,4.00,,
63018,WH1A,3,2,1,30.13,,
63026,001-423-430-00,0,0,0,681.82,,
63029,397,2,2,0,20.63,,
63030,382,7,4,3,11.57,,
63035,1482,6,4,2,79.99,,
63036,1483,3,1,2,187.50,,
63055,010-12117-05,0,0,0,82.49,,
63056,010-10647-01,0,0,0,153.99,,
63070,SC27,3,1,2,231.75,,
63075,SILVERSTEER2.0B,0,0,0,999.45,,
63077,172002,0,0,0,1051.83,,
63078,68131,0,0,0,437.49,699.99,
63172,142102,6,3,3,54.88,,
63173,BM-BT,1,1,0,99.00,,
63174,142203,6,3,3,68.60,,
63175,142305,0,0,0,86.89,,
63176,142001,0,0,0,41.16,,
63178,142300,4,3,1,69.79,,
63179,142311,5,5,0,85.63,,
63180,142314,5,5,0,104.59,,
63183,2701A,11,3,8,25.81,,
63184,150025,6,4,2,15.77,,
63185,150050,6,2,4,26.29,,
63186,150025NL,4,2,2,14.98,,
63187,150050NL,4,2,2,25.98,,
63188,150SPP,1,0,1,53.73,,
63189,199117G,8,4,4,72.56,,
63190,40240,0,0,0,56.25,89.99,
63191,199119G,6,3,3,82.43,,
63195,12VBPS3,12,9,3,18.44,,
63196,12VBRS3,12,9,3,21.52,,
63197,12VCPS3,52,34,18,42.32,,
63214,63072,0,0,0,231.96,,
63216,SS60-SLTD/12,0,0,0,355.56,,
63220,44001,16,8,8,25.94,,
63221,06120,2,0,2,273.93,,
63222,06150,3,1,2,292.19,,
63223,07100,6,3,3,410.92,,
63324,31201111,0,0,0,224.28,,
63325,31201311,3,1,2,224.28,,
63326,31211111,4,2,2,224.28,,
63327,31211311,2,1,1,224.28,,
63329,31221311,0,0,0,224.28,,
63331,31301212,5,3,2,241.49,,
63332,31301312,5,2,3,241.49,,
63333,31301412,3,1,2,241.49,,
63334,31502311,6,2,4,295.15,,
63335,31502321,0,0,0,295.15,,
63336,31431130,3,1,2,301.23,,
63339,31431330,3,2,1,301.23,,
63341,31431540,1,0,1,301.23,,
63342,31431740,5,3,2,301.23,,
63343,31431940,0,0,0,251.61,,
63344,31432130,7,3,4,301.23,,
63345,31432140,0,0,0,301.23,,
63346,21431130,7,4,3,83.54,,
63347,21431330,1,0,1,83.54,,
63348,21432130,2,1,1,83.54,,
63349,11501100,2,1,1,46.08,,
63350,31511710,6,2,4,385.26,,
63351,31511720,3,2,1,385.26,,
63352,31511910,4,2,2,385.26,,
63353,31511920,2,0,2,385.26,,
63354,31512110,3,3,0,385.26,,
63355,31512120,3,2,1,385.26,,
63356,31512310,2,0,2,385.26,,
63357,31512320,1,0,1,385.26,,
63358,37068-2000,6,3,3,84.85,,
63359,501202,0,0,0,13.37,,
63360,501208,16,2,14,14.99,,
63361,77040020,0,0,0,18.76,,
63362,77040050,3,0,3,21.58,,
63363,77040100,17,3,14,25.33,,
63364,77040300,4,2,2,28.15,,
63381,001-421-520-00,0,0,0,354.55,,
63382,001-421-530-00,0,0,0,372.73,,
63383,001-421-540-00,0,0,0,572.73,,
63384,001-421-550-00,0,0,0,745.45,,
63394,20310003,0,0,0,441.69,,
63407,COK-0024,7,4,3,51.38,,
63408,MX8715CR,0,0,0,430.27,,
63409,EIC001,0,0,0,103.94,,
63410,RC1010CAP24V,0,0,0,1892.65,2681.00,
63416,68110,0,0,0,360.00,,
63426,010-01616-30,0,0,0,862.49,,
63427,12850,3,3,0,144.99,,
63428,13750,0,0,0,155.13,,
63429,13850,3,3,0,154.78,,
63430,010-11417-10,7,4,3,119.99,,
63431,010-11417-20,0,0,0,487.49,,
63458,010-12401-10,0,0,0,97.49,,
63459,010-12402-10,0,0,0,149.99,,
63462,104300-500-001-17,0,0,0,23.33,,
63463,104300-105-001-17,5,0,5,23.33,,
63478,121900-100-004-17,7,1,6,31.99,,
63480,121900-100-005-17,1,1,0,37.14,,
63481,121700-706-004-17,3,3,0,52.99,,
63483,121700-706-005-17,5,3,2,52.99,,
63487,10-262,8,5,3,29.56,,
63490,SUPER-TRI,0,0,0,83.37,,
63512,010-01550-01,23,4,19,111.99,,
63594,ME70BT,14,7,7,107.99,,
63598,MARCAC2R,4,4,0,9.35,,
63599,MARCAC4R,0,0,0,12.90,,
63600,MARCAC6R,10,9,1,14.89,,
63601,MARCAYMFFR,11,4,7,7.57,,
63604,FA1702,0,0,0,1151.11,,
63606,WD-OPNARY-01,2,1,1,111.94,,
63607,WD-RAD-01,3,1,2,111.94,,
63608,RLS-405,5,2,3,20.50,,
63609,A10-901,11,5,6,35.44,,
63633,88539,2,2,0,88.62,107.99,
63661,HRMK1502,0,0,0,40.01,,
63675,HX210,0,0,0,96.13,,
63676,VLH-3000A,12,4,8,280.39,,
63723,A80048,0,0,0,1385.86,,
63724,A80328,0,0,0,68.17,,
63743,F38-8800W-1,6,6,0,80.92,,
63780,GP1059,0,0,0,327.26,,
63782,GP1080-06,0,0,0,385.44,,
63783,GP1080-07,0,0,0,385.44,,
63784,GP1080-09,0,0,0,385.44,,
63785,GP1080-20,0,0,0,385.44,,
63786,GP1170-14,0,0,0,385.44,,
63787,GP1170-15,0,0,0,385.44,,
63788,GP1170-63,0,0,0,385.44,,
63789,GP1170-64,0,0,0,385.44,,
63790,GP1213,0,0,0,363.62,,
63791,GP1302,0,0,0,276.35,,
63792,GP1402,0,0,0,312.72,,
63793,GP1500-16,0,0,0,276.35,,
63794,GP1500-17,0,0,0,276.35,,
63795,GP1600-11,0,0,0,341.81,,
63796,GP1600-12,0,0,0,341.81,,
63797,GP1600-13,0,0,0,341.81,,
63798,GP1808,0,0,0,312.72,,
63799,GP1900,0,0,0,305.44,,
63800,GP1900-09,0,0,0,319.99,,
63801,GP1900-13,0,0,0,319.99,,
63802,GP2040-23,0,0,0,334.53,,
63803,GP2040-29,0,0,0,334.53,,
63804,GP2040-30,0,0,0,334.53,,
63805,GP2040-95,0,0,0,334.53,,
63806,GP2050-95,0,0,0,327.26,,
63807,GP2050-98,0,0,0,327.26,,
63808,GP2053,0,0,0,327.26,,
63809,GP2080-06,0,0,0,385.44,,
63810,GP2080-07,0,0,0,385.44,,
63811,GP2080-09,0,0,0,385.44,,
63812,GP2080-20,0,0,0,385.44,,
63813,GP2170-14,0,0,0,385.44,,
63815,GP2170-15,0,0,0,385.44,,
63816,GP2170-63,0,0,0,385.44,,
63817,GP2170-64,0,0,0,385.44,,
63818,GP2500-16,0,0,0,276.35,,
63819,GP2500-17,0,0,0,276.35,,
63820,GP2600-09,0,0,0,341.81,,
63821,GP2600-11,0,0,0,341.81,,
63822,GP2600-12,0,0,0,341.81,,
63823,GP2600-13,0,0,0,341.81,,
63824,PED4400-C,0,0,0,254.53,,
63825,PED4401-C,0,0,0,269.08,,
63826,PED4402-C,0,0,0,269.08,,
63827,PED4403-C,0,0,0,269.08,,
63828,C-1B-R,0,0,0,143.75,,
63829,PED4404-C,0,0,0,269.08,,
63830,PED4405-C,0,0,0,269.08,,
63831,PED4406-C,0,0,0,269.08,,
63832,C-1C-R,0,0,0,156.25,,
63833,PED4407-C,0,0,0,269.08,,
63834,P-1B-R,0,0,0,231.25,,
63835,P-1C-R,0,0,0,237.50,,
63836,P-1BS-R,1,1,0,281.25,,
63837,P-1CS-R,0,0,0,287.50,,
63838,PED4408-C,0,0,0,269.08,,
63839,P-1BNV-R,0,0,0,237.50,,
63840,PED4409-C,0,0,0,269.08,,
63841,P-1CNV-R,0,0,0,243.75,,
63843,PED4410-C,0,0,0,269.08,,
63844,PED4500-01-C,0,0,0,276.35,,
63845,P-2BS-R,5,3,2,406.25,,
63846,PED4500-02-C,0,0,0,276.35,,
63847,P-2BNV-R,0,0,0,343.75,,
63848,PED4500-03-C,0,0,0,276.35,,
63849,PED4500-05-C,0,0,0,276.35,,
63850,PED4500-06-C,0,0,0,276.35,,
63852,PED4500-C,0,0,0,261.81,,
63853,PED4600-00-C,0,0,0,509.08,,
63854,PED4600-01-C,0,0,0,305.44,,
63855,PED4600-03-C,0,0,0,305.44,,
63856,PED4600-04-C,0,0,0,305.44,,
63857,G-1B-R,1,1,0,225.00,,
63858,PED4600-05-C,0,0,0,305.44,,
63859,PED4800-12-C,0,0,0,356.35,,
63860,PED4800-20-C,0,0,0,356.35,,
63861,G-1C-R,5,2,3,231.25,,
63862,PED4800-C,0,0,0,341.81,,
63863,PED4808-C,0,0,0,356.35,,
63864,PED4814-C,0,0,0,356.35,,
63865,G-1BB-R,0,0,0,243.75,,
63866,PED4900-01-C,0,0,0,356.35,,
63867,PED4900-02-C,0,0,0,356.35,,
63868,G-1CB-R,6,2,4,256.25,,
63870,C30503BM30PB,6,6,0,355.04,495.55,
63871,PED4900-04-C,0,0,0,356.35,,
63872,G-2BB-R,0,0,0,412.50,,
63873,PED4900-09-C,0,0,0,356.35,,
63875,G-2B-R,0,0,0,393.75,,
63876,C30503BM30PG,0,0,0,355.04,495.55,
63877,PED4900-C,0,0,0,341.81,,
63878,PED5050-01-C,0,0,0,370.90,,
63879,PED5050-19-C,0,0,0,370.90,,
63880,C30503BM30PW,2,2,0,355.04,495.55,
63881,PED5050-C,0,0,0,356.35,,
63883,BOLT1212ED,1,0,1,433.41,,
63884,FS-T01-R,0,0,0,123.75,,
63885,PED5059-C,0,0,0,370.90,,
63886,B30ASSYPB,6,6,0,158.33,221.00,
63887,PED5100-01-C,0,0,0,356.35,,
63888,PED5100-C,0,0,0,341.81,,
63889,B30ASSYPG,0,0,0,158.33,221.00,
63890,B30ASSYPW,0,0,0,158.33,221.00,
63891,B50ASSYPG,5,5,0,190.62,266.05,
63893,B50ASSYPB,4,4,0,190.62,266.05,
63896,PED5200-C,0,0,0,378.17,,
63897,FS-A01-R,0,0,0,136.25,,
63899,B50ASSYPW,0,0,0,190.62,266.05,
63906,PP4402-C,0,0,0,269.08,,
63907,PP4403-C,0,0,0,269.08,,
63908,PP4404-C,0,0,0,269.08,,
63909,PP4405-C,0,0,0,269.08,,
63910,PP4406-C,0,0,0,269.08,,
63911,PP4407-C,0,0,0,269.08,,
63912,PP4408-C,0,0,0,269.08,,
63913,PP4409,0,0,0,269.08,,
63914,PP4409-C,0,0,0,269.08,,
63915,PP4410,0,0,0,269.08,,
63916,PP4410-C,0,0,0,269.08,,
63917,PP4500,0,0,0,261.81,,
63920,PP4500-01-C,0,0,0,276.35,,
63921,PP4500-02-C,0,0,0,276.35,,
63922,PP4500-03-C,0,0,0,276.35,,
63923,PP4500-05-C,0,0,0,276.35,,
63924,PP4500-06-C,0,0,0,276.35,,
63927,PP4500-C,0,0,0,261.81,,
63928,PP4600-00,0,0,0,290.90,,
63931,PP4600-01,0,0,0,305.44,,
63934,PP4600-03,0,0,0,305.44,,
63936,PP4600-04,0,0,0,305.44,,
63938,PP4600-05,0,0,0,305.44,,
63940,PP4800-12-C,0,0,0,356.35,,
63941,PP4800-20-C,0,0,0,356.35,,
63943,PP4800-C,0,0,0,341.81,,
63944,PP4811-C,0,0,0,356.35,,
63946,PP4814-C,0,0,0,356.35,,
63947,PP4818-C,0,0,0,356.35,,
63948,PP4900,0,0,0,341.81,,
63949,PP4900-01-C,0,0,0,356.35,,
63950,PP4900-02-C,0,0,0,356.35,,
63953,PP4900-04-C,0,0,0,356.35,,
63954,PP4900-09,0,0,0,356.35,,
63955,PP4900-09-C,0,0,0,356.35,,
63958,PP4900-C,0,0,0,341.81,,
63959,PP5030-01,0,0,0,399.99,,
63960,PP5050-01-C,0,0,0,370.90,,
63961,PP5050-02-C,0,0,0,370.90,,
63962,PP5050-19-C,0,0,0,370.90,,
63963,PP5050-C,0,0,0,356.35,,
63964,PP5052-C,0,0,0,370.90,,
63965,PP5053,0,0,0,370.90,,
63966,PP5053-C,0,0,0,370.90,,
63967,PP5058-C,0,0,0,370.90,,
63968,PP5060-01,0,0,0,399.99,,
63969,PP5100,0,0,0,341.81,,
63970,PP5100-01,0,0,0,356.35,,
63971,PP5100-01-C,0,0,0,356.35,,
63972,PP5100-C,0,0,0,341.81,,
63973,PP5200-01,0,0,0,392.72,,
63974,PP5200-01-C,0,0,0,392.72,,
63975,PP5200-12-C,0,0,0,392.72,,
63976,PP5200-C,0,0,0,378.17,,
63977,PP5201-C,0,0,0,392.72,,
63978,PP5202-C,0,0,0,392.72,,
63979,PP5203-C,0,0,0,392.72,,
63980,PP5204-C,0,0,0,392.72,,
63981,PP5205-C,0,0,0,392.72,,
63982,PP5213,0,0,0,392.72,,
63983,PP5213-C,0,0,0,392.72,,
63984,RMX4102,0,0,0,363.62,,
63985,RMX4600,0,0,0,399.99,,
63986,RMX4600-04,0,0,0,414.53,,
63987,RMX4900,0,0,0,421.81,,
63988,RMX4900-09,0,0,0,436.35,,
63990,B30ASSYNT,0,0,0,192.44,268.60,
63991,PP4400-C,0,0,0,254.53,,
63992,PP4401-C,0,0,0,269.08,,
63993,PP4808-C,0,0,0,356.35,,
63995,LLB-47FW-82-00,2,1,1,40.99,,
64002,LLB-05WD-81-00,0,0,0,17.17,,
64005,1479,3,2,1,65.16,,
64007,260WR-2,0,0,0,25.41,,
64008,E70328,10,5,5,476.24,,
64009,E70329,4,0,4,595.10,,
64013,SPD-7S-W,0,0,0,335.25,,
64019,A80355,0,0,0,21.30,,
64020,A80356,0,0,0,21.30,,
64025,1106-B,0,0,0,621.65,,
64026,A80357,9,6,3,21.30,,
64029,"BP 03511-3A-3PK",12,6,6,22.85,32.95,
64030,29043-0000,5,0,5,17.12,,
64031,"BP 03511-6A-6PK",6,3,3,45.71,65.95,
64032,"BP 03511-10A-10PK",3,1,2,76.18,109.95,
64040,A-4-WHITE,5,5,0,100.09,,
64041,A10-364,7,3,4,22.50,,
64044,FOURTECH06,0,0,0,155.73,,
64045,FOURTECH07,0,0,0,155.73,,
64046,FOURTECH08,0,0,0,155.73,,
64047,FOURTECH09,0,0,0,155.73,,
64048,FOURTECH10,0,0,0,155.73,,
64049,FOURTECH11,0,0,0,155.73,,
64050,FOURTECH12,1,0,1,155.73,,
64051,FOURTECH13,6,5,1,155.73,,
64052,FOURTECH14,2,2,0,155.73,,
64053,FOURTECH15,0,0,0,155.73,,
64054,FOURTECH16,1,1,0,155.73,,
64055,FOURTECH17,0,0,0,155.73,,
64056,FOURTECH18,0,0,0,155.73,,
64057,FOURTECH19,0,0,0,151.20,,
64058,FOURTECH20,0,0,0,155.73,,
64059,T101,7,3,4,149.84,,
64060,T103,0,0,0,203.26,,
64061,X52,8,2,6,143.07,,
64080,M81134,0,0,0,2145.82,,
64083,1020-F,18,12,6,50.83,,
64084,1020-B-F,3,3,0,50.83,,
64085,1022-F,11,4,7,57.09,,
64086,1022-B-F,8,2,6,57.09,,
64087,1201-F,0,0,0,100.49,,
64088,1206-F,0,0,0,100.49,,
64089,1193-F,4,2,2,47.72,,
64090,1163-F,3,1,2,74.13,,
64091,1008-B-F,21,14,7,26.87,,
64092,91-118-F,6,6,0,21.93,,
64093,91-410-F,1,0,1,11.51,,
64094,91-200-F,0,0,0,6.29,,
64096,90-810-F,0,0,0,139.73,,
64100,2506P-F,10,2,8,17.75,,
64101,2606B-F,13,9,4,17.80,,
64102,2608B-F,18,8,10,29.37,,
64103,2064-F,0,0,0,199.67,,
64104,2084-F,4,2,2,217.95,,
64107,91-531-F,4,4,0,8.51,,
64108,91-536-F,7,5,2,9.37,,
64109,91-561-F,1,1,0,5.89,,
64110,91-562-F,10,0,10,5.89,,
64111,91-566-F,14,7,7,5.89,,
64120,AN-MAP7,3,0,3,199.99,445.50,
64121,012102W,4,2,2,322.83,,
64122,012101B,0,0,0,322.83,,
64123,012103BW,0,0,0,446.47,,
64125,29090-5000,91,51,40,168.69,,
64126,29120-5000,12,0,12,183.81,,
64127,29120-5100,0,0,0,217.60,,
64128,37010-3092,17,9,8,419.88,,
64129,37010-3094,3,0,3,473.28,,
64130,37010-4092,4,3,1,473.28,,
64131,37010-4192,9,5,4,482.83,,
64132,37010-4094,0,0,0,473.28,,
64133,37010-4194,0,0,0,482.83,,
64134,37045-3092,5,3,2,603.27,,
64135,37245-3092,2,2,0,603.27,,
64136,37045-3094,0,0,0,603.27,,
64137,37245-3094,0,0,0,603.27,,
64138,37245-4092,2,0,2,603.27,,
64139,37245-4192,3,1,2,612.73,,
64140,37045-4092,5,3,2,603.27,,
64141,37045-4192,4,2,2,612.73,,
64142,37045-4094,0,0,0,603.27,,
64143,37045-4194,0,0,0,612.73,,
64144,37245-4094,0,0,0,603.27,,
64145,37245-4194,0,0,0,612.73,,
64159,25SA,14,10,4,72.32,,
64160,25SA-24,5,3,2,77.95,,
64161,MSVANDTZN075QL,0,0,0,112.53,,
64162,20SA,9,9,0,89.36,,
64163,27SA,16,5,11,109.86,,
64164,MSVANDTZN150QL,0,0,0,94.75,,
64165,24DA,11,7,4,19.53,,
64166,25DA,24,9,15,26.06,,
64167,25DA-24,20,12,8,29.36,,
64168,20DA,15,4,11,40.63,,
64169,20DA-24,12,8,4,44.38,,
64170,27DA,18,8,10,46.26,,
64171,27DA-24,2,0,2,50.77,,
64172,6009,0,0,0,667.16,,
64177,A80308,3,2,1,38.34,,
64178,F008002,0,0,0,62.19,,
64212,A80332,0,0,0,25.56,,
64215,A80278,0,0,0,242.89,,
64223,AP000A1HA,3,3,0,502.94,,
64224,AP000A1BC,4,0,4,502.39,,
64258,"2061 02061",0,0,0,0.78,,
64259,"2061TP 02",0,0,0,5.56,,
64267,012301W,2,0,2,153.04,,
64268,012302B,0,0,0,153.04,,
64269,012304W,0,0,0,279.53,,
64270,012305B,5,5,0,258.26,,
64271,012307C,1,1,0,320.93,,
64272,012308W,0,0,0,383.05,,
64273,012309B,3,1,2,383.05,,
64274,012311C,3,1,2,392.16,,
64275,011416,0,0,0,50.22,88.00,
64276,011417,0,0,0,59.89,,
64277,011418,0,0,0,71.14,159.00,
64281,E70310,19,14,5,237.20,,
64284,A80370,13,6,7,38.34,,
64290,101475,0,0,0,112.85,,
64291,101476,0,0,0,127.32,,
64292,101477,2,2,0,127.32,,
64295,101186,7,2,5,121.93,,
64296,101187,0,0,0,121.93,,
64297,101325,0,0,0,120.06,,
64298,111903,0,0,0,167.39,,
64301,111909,0,0,0,184.26,,
64304,111928,0,0,0,169.37,,
64305,111929,0,0,0,191.30,,
64310,101283,30,7,23,95.73,,
64312,115117,3,3,0,94.77,,
64313,115118,0,0,0,80.45,,
64314,115119,2,0,2,80.45,,
64315,115127,4,4,0,94.77,,
64316,115128,0,0,0,80.45,,
64317,115129,2,2,0,80.45,,
64318,116113,2,0,2,30.99,,
64319,116117,3,0,3,88.10,,
64320,116118,5,0,5,73.12,,
64321,116119,3,0,3,73.12,,
64323,116127,0,0,0,88.10,,
64324,116128,0,0,0,73.12,,
64325,116129,0,0,0,73.12,,
64327,116197,3,0,3,88.10,,
64328,116198,0,0,0,70.07,,
64329,116199,8,0,8,59.99,,
64336,1732,8,8,0,66.53,,
64338,1741,10,5,5,50.72,,
64340,1821,16,10,6,11.33,,
64341,1839,8,5,3,253.10,,
64342,1841,2,0,2,275.11,,
64351,5007100,2,0,2,57.03,,
64352,5194,8,4,4,45.62,,
64354,5196,10,5,5,38.62,,
64355,5502100,17,5,12,57.03,,
64357,6004,7,4,3,24.00,,
64358,6004200,9,7,2,24.00,,
64359,7197,4,4,0,12.16,,
64361,7399,8,5,3,15.34,,
64362,7517,0,0,0,157.38,,
64363,7615,3,1,2,103.81,,
64374,7903,2,0,2,2.39,,
64375,7903200,0,0,0,2.39,,
64379,7812-S-7,6,2,4,82.85,,
64380,7201-P-7,3,2,1,38.99,,
64381,CA50BL-12HR,0,0,0,2888.89,,
64383,7202-P-7,2,0,2,49.67,,
64385,5558-P12A7,2,1,1,36.07,,
64386,5550-PA20-7,7,4,3,38.29,,
64387,5557-PV12A7,5,3,2,36.39,,
64389,5551-PA20-7,8,5,3,45.65,,
64393,A80367,7,3,4,12.77,,
64394,MCK508WB.6,10,6,4,96.53,,
64401,LLB-21BC-21-00,0,0,0,8.31,,
64402,LLB-21BW-21-00,0,0,0,8.31,,
64406,ZDIGWS,2,1,1,494.96,,
64411,E70363-00-NAG,23,8,15,517.12,,
64413,E70366-00-NAG,9,0,9,876.49,,
64415,E70368-00-NAG,9,0,9,1843.53,,
64417,E70364-00-NAG,0,0,0,632.08,,
64421,E70364-02-NAG,0,0,0,707.08,,
64433,142400,8,7,1,114.33,,
64434,142410,9,7,2,132.62,,
64436,142415,5,2,3,150.91,,
64437,142420,11,8,3,178.35,,
64441,142411,13,11,2,139.02,,
64446,5006100,2,0,2,20.43,,
64450,TEC-BNT,10,0,10,10.96,,
64456,E70369-00-NAG,2,2,0,2174.73,,
64459,PO512-WC-20,0,0,0,161.44,,
64469,5350-PA12-7,7,1,6,27.99,,
64470,5358-P12-7,0,0,0,26.96,,
64471,5350-PA20-7,2,2,0,29.99,,
64475,6354W7,12,5,7,15.83,,
64480,300-036-B,0,0,0,1256.36,,1601.85
64481,31221111,4,2,2,224.28,,
64483,3125,17,7,10,4.22,,
64484,SHC-19,20,18,2,52.50,,
64509,09-1050-12,1,0,1,12.64,,
64511,3530,0,0,0,12.84,,18.98
64515,R70159,6,0,6,38.34,,
64516,S-226KEY,15,4,11,3.75,,
64517,AS0511,7,3,4,26.08,,
64541,OC17SUK42,18,14,4,131.49,,
64546,T70266,3,2,1,1679.99,,
64549,DU-RBH-20-R,0,0,0,112.50,,
64550,DU-RCH-20-R,0,0,0,118.75,,
64551,DU-SBH-20-R,0,0,0,118.75,,
64552,011807,0,0,0,52.61,,
64558,GP1040-31,0,0,0,334.53,,
64559,GP2040-31,0,0,0,334.53,,
64560,GP2050-21,0,0,0,327.26,,
64561,GP1800-13,0,0,0,312.72,,
64562,RMX4800-13,0,0,0,436.35,,
64563,PP4800-13-C,0,0,0,356.35,,
64564,PP4800-13,0,0,0,356.35,,
64565,PED4800-13-C,0,0,0,356.35,,
64568,CS2308402,6,2,4,46.48,,
64574,E70430,2,1,1,623.63,,
64583,CA50BL-24HR,0,0,0,4391.11,,
64585,CA28F-38M,0,0,0,3111.11,,
64587,A2C1102950001,12,0,12,67.40,81.89,
64588,A2C1102960001,3,0,3,91.17,110.69,
64592,FW0814,3,2,1,95.49,,
64593,FW1214,3,2,1,95.49,,
64594,FW1215,5,3,2,95.49,,
64595,FW1225,5,2,3,90.62,,
64598,RT3000,2,1,1,54.74,,
64600,BP2552B,11,3,8,209.18,,
64601,BP2554B,3,1,2,252.71,,
64602,P10-2512WHA27-1C,0,0,0,24.08,,
64606,P10-2524WHA27-1C,4,2,2,44.40,,
64607,P10-5012BLK27-1C,5,3,2,43.27,,
64608,P10-5012SFM27-1C,1,1,0,43.27,,
64609,P10-5012WHA27-1C,3,2,1,43.27,,
64610,P10-5024BLK27-1C,6,3,3,81.85,,
64612,P10-5024WHA27-1C,6,3,3,81.85,,
64613,P10-7512BLK27-1C,0,0,0,63.78,,
64615,P10-7512WHA27-1C,1,0,1,63.78,,
64617,P10-7524WHA27-1C,3,2,1,119.95,,
64618,P14-5012WHA27-1C,0,0,0,46.73,,
64619,P14-7512WHA27-1C,0,0,0,68.68,,
64621,80-601-0020-00,0,0,0,104.55,,
64623,710S-00607,0,0,0,518.90,,
64624,720S-00585,0,0,0,549.56,,
64625,720S-00614,0,0,0,698.82,,
64646,P10-2506WHA12-1C,7,3,4,11.44,,
64647,P10-2512WHA12-1C,0,0,0,16.63,,
64683,M81203,0,0,0,3008.32,,
64686,3117,0,0,0,461.20,,
64687,SET0152,0,0,0,64.93,,
64695,PO512-WC-10,0,0,0,161.44,,
64699,0440-BK-1,12,12,0,4.40,,
64705,0301DP6A,6,0,6,8.45,,
64707,001-190-440-00,0,0,0,136.36,,
64718,6128C,2,2,0,32.25,,
64719,CA-0160-MO,2,1,1,365.12,,
64722,IS216,2,0,2,32.80,,
64723,NM-NB1-NF-05.0,1,0,1,54.40,,
64724,NM-NB1-NF-10.0,1,0,1,77.60,,
64725,PT-0-50PSI-01,0,0,0,162.40,,
64732,010-12127-00,0,0,0,22.49,,
64734,740157-1,0,0,0,129.87,,
64742,115123,4,0,4,81.04,,
64745,710262-1,8,4,4,280.32,,
64746,710264-1,0,0,0,346.14,,
64748,740159-1,0,0,0,31.04,,
64750,740162-1,3,3,0,24.14,,
64752,720096-1,7,7,0,37.94,,
64753,720096-2,0,0,0,51.74,,
64760,710263-1,0,0,0,297.84,,
64767,4021,0,0,0,226.62,,319.00
64768,4211,1,1,0,149.99,,229.00
64772,740157-1NB,0,0,0,117.29,,
64780,ZE355,0,0,0,16.07,,
64781,BP2918,0,0,0,117.56,157.00,
64790,3875C1,35,35,0,7.58,,
64842,R599C-LH,0,0,0,4037.50,,
64853,010-12224-01,0,0,0,56.24,,
64878,520T-BLD,0,0,0,200.00,,
64880,CA200B-8B/30,0,0,0,662.22,,
64895,81300300,0,0,0,369.34,,
64908,1331,10,4,6,18.97,,
64936,HG30,0,0,0,93.60,133.00,
64976,DM260G,0,0,0,140.00,266.00,
64977,DM260B,3,0,3,140.00,266.00,
64979,SF100G,0,0,0,254.00,451.25,
64980,SF100B,2,0,2,254.00,451.25,
64982,DS100,0,0,0,243.75,351.50,
64984,CORD50,1,0,1,32.00,42.75,
64987,FL50,4,0,4,115.00,142.45,
64988,WM5,5,0,5,72.00,136.80,
64989,WM10,0,0,0,112.00,212.80,
64993,PUMPHRP11-24,0,0,0,720.00,,
65003,CC3003P,2,2,0,26.61,,
65012,001-247-240-00,0,0,0,145.45,,
65014,BOLT912ED,8,4,4,404.55,,
65016,000-040-720,0,0,0,40.91,,
65019,372,1,1,0,34.00,,
65020,373,22,13,9,37.76,,
65022,3015-P,0,0,0,15.09,,
65023,360,15,13,2,58.85,,
65024,3016-P,0,0,0,18.56,,
65025,361,4,0,4,74.53,,
65028,380,20,8,12,74.20,,
65029,3024-P,0,0,0,17.64,,
65031,363,30,16,14,58.85,,
65032,364,13,0,13,74.53,,
65034,383,41,17,24,74.20,,
65037,47200,0,0,0,151.71,,
65040,40220,20,11,9,16.21,,
65041,80220,7,1,6,21.63,,
65042,40230,8,4,4,20.72,,
65043,80230,16,11,5,27.65,,
65044,40240,11,0,11,28.37,,
65045,80240,14,10,4,37.81,,
65046,40245,15,4,11,28.78,,
65047,80245,23,13,10,38.38,,
65048,40400,8,5,3,32.62,,
65049,80400,6,6,0,46.62,,
65050,40410,7,1,6,39.60,,
65051,80410,17,13,4,49.94,,
65052,40420,7,1,6,44.24,,
65053,80420,13,8,5,57.11,,
65054,8418,93,70,23,19.49,,
65055,8424,18,7,11,22.46,,
65056,8118,8,2,6,16.54,,
65057,8124,52,9,43,21.87,,
65065,1818,12,12,0,9.99,,
65066,2918,51,41,10,11.10,,
65067,3018,44,24,20,11.10,,
65068,3118,34,23,11,11.10,,
65069,3218,6,0,6,11.10,,
65070,4118,24,13,11,11.43,,
65071,4218,20,16,4,11.10,,
65072,4318,26,2,24,11.10,,
65073,4418,25,20,5,11.10,,
65114,01-0387,0,0,0,3896.10,,
65118,2818,34,17,17,11.10,,
65127,60749,13,5,8,16.32,,
65128,60750,7,6,1,18.49,,
65129,60752,3,2,1,24.50,,
65130,57933,36,24,12,11.94,,
65137,1139,8,6,2,19.07,,
65138,921,12,6,6,44.50,,
65139,922,15,6,9,55.97,,
65140,971,7,3,4,19.82,,
65144,960,0,0,0,39.83,,
65145,961,0,0,0,39.83,,
65148,962,3,3,0,16.81,,
65149,965,5,4,1,28.36,,
65150,57925,5,5,0,7.73,,
65151,57926,11,5,6,7.96,,
65152,57928,0,0,0,7.96,,
65170,A80321,0,0,0,1304.34,,
65181,600015,0,0,0,22.69,,
65184,010-11428-03,0,0,0,9.80,,
65187,805Q,12,6,6,8.57,,
65189,805G,4,1,3,21.28,,
65190,810Q,4,4,0,8.57,,
65191,810G,3,3,0,25.32,,
65192,800Q,0,0,0,8.57,,
65193,800G,6,4,2,21.28,,
65194,830,9,4,5,11.03,,
65195,825Q,9,3,6,9.84,,
65198,815Q,1,0,1,11.27,,
65199,850Q,1,1,0,11.11,,
65200,846P,4,0,4,6.99,,
65201,410,7,1,6,11.12,,
65203,435,22,12,10,3.89,,
65205,001-409-540-00,0,0,0,413.64,,
65207,010-12105-10,0,0,0,18.74,,
65209,"TS 1001",23,12,11,15.56,,
65210,"TS 1002",0,0,0,40.88,,
65212,"TC 2000",12,3,9,16.44,,
65213,"TC 2001",5,1,4,31.75,,
65214,"TB 3001",10,7,3,10.95,,
65222,IRID-GO-INST-KIT,1,1,0,425.00,,
65246,P66-DT-HB,0,0,0,167.33,,
65247,TM258-HB,0,0,0,793.47,,
65248,TM-258-14HB,0,0,0,793.47,,
65249,TM260-HB,0,0,0,987.78,,
65250,TM260-14HB,0,0,0,987.78,,
65251,B60-12-HB,0,0,0,280.68,,
65252,B60-20-HB,1,1,0,280.68,,
65253,B164-0-HB,0,0,0,917.61,,
65254,B164-12-HB,0,0,0,917.61,,
65255,B164-20-HB,0,0,0,917.61,,
65256,B164-0-14HB,0,0,0,917.61,,
65257,B164-12-14HB,0,0,0,917.61,,
65258,B164-20-14HB,0,0,0,917.61,,
65259,B117-DT-HB,0,0,0,240.29,,
65260,S3-0502,1,0,1,1199.99,,
65261,P79-HB,0,0,0,140.34,,
65263,1525,0,0,0,32.57,,
65269,7410,4,0,4,29.28,,
65270,7411,0,0,0,29.28,,
65271,7412,3,0,3,29.28,,
65272,7413,11,5,6,29.28,,
65273,7574,5,5,0,28.96,,
65274,7414,8,1,7,29.28,,
65275,7575,5,4,1,28.96,,
65276,7415,0,0,0,29.28,,
65277,7416,6,2,4,29.28,,
65278,7577,5,2,3,28.96,,
65279,7417,3,0,3,29.28,,
65280,7540,6,4,2,25.85,,
65281,7541,9,5,4,25.85,,
65282,7542,10,10,0,25.85,,
65284,7543,0,0,0,25.85,,
65285,7545,11,6,5,25.85,,
65286,7546,15,6,9,25.85,,
65287,7547,8,5,3,25.85,,
65288,7548,10,5,5,25.85,,
65289,7549,8,6,2,25.85,,
65294,000-159-643,0,0,0,95.45,,
65299,20200,2,0,2,113.68,181.89,
65300,13828,0,0,0,29.11,,
65303,BP0535,3,1,2,138.06,,
65308,7721,2,2,0,291.67,,
65309,6627,11,2,9,14.06,,
65317,1360,0,0,0,6.04,,
65318,1225,12,7,5,5.60,,
65320,11736,68,32,36,2.97,,
65322,1725,14,8,6,26.63,,
65323,1726,4,3,1,17.18,,
65324,83553,0,0,0,691.54,,
65325,46054,5,0,5,63.68,,
65332,001-041-560,0,0,0,45.45,,
65341,42030X,0,0,0,44.24,,
65351,010-11089-01,16,14,2,18.74,,
65353,RC1210CAP24V,0,0,0,2994.15,4092.00,
65354,980650001,3,1,2,392.41,,
65355,959941001,0,0,0,130.38,,
65356,959941011,0,0,0,130.38,,
65357,959900001,5,2,3,110.13,,
65358,959900011,6,4,2,110.13,,
65359,959908001,0,0,0,110.13,,
65360,959908011,1,1,0,110.13,,
65361,959909001,3,1,2,117.72,,
65362,959909011,2,1,1,117.72,,
65364,959900211,5,3,2,116.46,,
65366,959908211,4,2,2,116.46,,
65367,959909201,5,2,3,117.72,,
65368,959909211,4,3,1,117.72,,
65369,959940201,1,0,1,127.85,,
65370,959940211,4,1,3,127.85,,
65371,980520501,2,1,1,70.89,,
65372,980520511,7,6,1,70.89,,
65373,980520811,7,5,2,125.32,,
65374,980520901,1,1,0,125.32,,
65375,980520911,0,0,0,125.32,,
65376,980620811,4,4,0,137.97,,
65377,980620801,0,0,0,137.97,,
65378,980620901,0,0,0,137.97,,
65379,980620911,0,0,0,137.97,,
65380,980960201,0,0,0,69.62,,
65381,980960211,3,1,2,69.62,,
65382,980960231,0,0,0,78.48,,
65383,980960241,5,2,3,78.48,,
65384,980960301,1,1,0,93.67,,
65385,980960311,0,0,0,93.67,,
65388,980960341,7,4,3,103.80,,
65389,980960351,6,2,4,103.80,,
65390,980960461,2,0,2,112.66,,
65391,980960471,3,1,2,112.66,,
65392,980573021,0,0,0,117.72,,
65393,980740011,4,2,2,208.86,,
65394,980950071,0,0,0,183.54,,
65395,980950081,2,0,2,183.54,,
65396,980950061,2,2,0,183.54,,
65398,958109021,10,6,4,35.44,,
65399,958109011,5,5,0,30.38,,
65400,958109111,1,0,1,25.26,,
65401,958109121,0,0,0,35.44,,
65402,958110011,0,0,0,30.38,,
65403,958110021,5,5,0,35.44,,
65404,958110111,0,0,0,30.38,,
65405,958110121,4,4,0,35.44,,
65406,958109511,0,0,0,31.65,,
65407,958109521,1,1,0,36.71,,
65408,958109611,0,0,0,31.65,,
65409,958109621,6,6,0,36.71,,
65410,958110511,3,3,0,31.65,,
65411,958110521,0,0,0,36.71,,
65413,958110621,0,0,0,36.71,,
65414,959950121,1,1,0,127.85,,
65415,959951121,4,2,2,127.85,,
65416,980630002,0,0,0,107.59,,
65419,980630102,2,2,0,107.59,,
65421,980629001,2,2,0,112.66,,
65422,980629501,2,2,0,125.32,,
65424,959700101,3,3,0,59.49,,
65425,959700701,0,0,0,59.49,,
65427,980704001,1,1,0,77.22,,
65431,DRS12AX,1,0,1,3964.95,,4895.00
65434,980869301,4,3,1,22.78,,
65435,980869401,6,3,3,22.78,,
65436,980869501,0,0,0,22.78,,
65437,980869601,5,0,5,22.78,,
65440,980500521,1,0,1,25.32,,
65441,980500541,2,2,0,21.52,,
65442,980500721,6,0,6,25.32,,
65443,980502221,4,1,3,26.58,,
65444,980502241,0,0,0,24.05,,
65445,980507221,8,6,2,22.78,,
65446,980507241,2,1,1,17.09,,
65447,980507251,0,0,0,17.09,,
65449,958121001,3,2,1,54.43,,
65450,958121011,1,0,1,55.70,,
65451,958121101,0,0,0,55.70,,
65452,5287,19,8,11,2.91,,
65453,5235100,19,13,6,12.41,,
65454,5236100,7,3,4,11.92,,
65455,5237100,20,10,10,11.92,,
65456,5239100,11,3,8,11.92,,
65457,5240100,8,6,2,11.92,,
65458,5241100,12,10,2,11.92,,
65459,5242100,11,7,4,11.92,,
65460,5243100,11,10,1,11.92,,
65461,5244100,12,4,8,11.92,,
65462,5245100,19,10,9,11.92,,
65463,958121111,0,0,0,55.70,,
65464,958123001,1,1,0,49.37,,
65465,958124401,6,4,2,40.51,,
65466,002984335,7,4,3,39.24,,
65467,002984385,4,1,3,39.24,,
65468,002984345,7,3,4,39.24,,
65469,002984395,4,1,3,39.24,,
65470,002984315,6,4,2,43.04,,
65471,002984365,1,0,1,43.04,,
65472,002984325,4,3,1,39.24,,
65473,002984375,1,1,0,39.24,,
65474,002984305,0,0,0,39.24,,
65475,002984355,0,0,0,39.24,,
65477,002984535,0,0,0,58.23,,
65478,002984601,5,3,2,79.75,,
65479,002984505,2,1,1,59.49,,
65480,002984565,3,2,1,59.49,,
65485,003562025,13,0,13,17.09,,
65487,003562045,0,0,0,18.35,,
65489,003562005,2,2,0,17.09,,
65491,003562015,8,2,6,17.09,,
65492,003562115,1,0,1,15.00,,
65494,003361002,34,18,16,63.29,,
65495,003361012,17,12,5,64.56,,
65496,003361022,10,1,9,62.03,,
65497,002843011,5,2,3,18.99,,
65498,706729011,0,0,0,5.57,,
65500,998502001,3,2,1,125.32,,
65501,156,6,2,4,12.86,,
65512,003562035,5,2,3,17.09,,
65513,1942,0,0,0,2026.84,,
65514,60754,2,2,0,31.96,,
65515,966,0,0,0,32.06,,
65516,967,6,6,0,23.70,,
65532,010-01962-00,4,2,2,119.99,,
65533,010-01962-10,1,1,0,356.24,,
65534,010-11868-20,0,0,0,322.49,,
65535,010-11868-21,0,0,0,322.49,,
65536,010-11868-22,0,0,0,322.49,,
65537,010-12465-00,0,0,0,187.49,,
65538,010-11937-21,1,0,1,824.99,,
65539,010-12187-20,5,2,3,3119.99,,
65540,010-12182-20,0,0,0,2418.74,,
65541,010-11643-20,0,0,0,2459.99,,
65542,010-11812-20,0,0,0,1274.99,,
65543,010-12188-20,1,0,1,3097.49,,
65547,1866680,12,10,2,121.21,,
65548,3116,0,0,0,314.32,,
65549,3118,6,1,5,479.78,,
65550,11990,12,4,8,13.66,,
65569,ATPSENSTD,4,3,1,65.00,,
65570,SCH-11,58,24,34,7.50,,
65573,A80464,13,3,10,363.74,,
65574,A80465,2,0,2,1099.99,,
65575,T70318,1,1,0,1891.66,,
65576,T70319,3,0,3,1891.66,,
65583,3113,7,3,4,144.56,,
65585,A80018,0,0,0,701.08,,
65586,A80475,1,1,0,98.00,,
65587,A80476,2,0,2,106.52,,
65588,A80477,0,0,0,166.18,,
65589,A80485,0,0,0,55.39,,
65590,SC-USB-02,29,17,12,31.48,,
65591,DS-H10,10,6,4,18.54,,
65600,A80510,3,1,2,367.01,,
65606,R70527,5,0,5,46.86,,
65609,OCTAF1212BP12,0,0,0,865.67,,
65611,ZDIGSPLK1500,1,1,0,262.46,,
65616,8806LP2,6,2,4,47.18,,
65617,8806LPG2,8,3,5,52.39,,
65619,NM-NG1-NF-00.5,0,0,0,33.28,,
65620,58103-1012,5,3,2,417.72,,
65625,001-122-910,0,0,0,172.73,,
65627,27SA-24,4,2,2,115.49,,
65629,81300400,4,2,2,369.34,,
65630,010-12165-02,0,0,0,16.44,,
65644,FAP6310,0,0,0,1688.89,,
65649,010-12390-30,0,0,0,78.75,,
65652,S00-00522-24,4,2,2,12.69,,
65668,A10-210PB,1,1,0,25.31,,
65715,AF45,9,4,5,30.17,,
65716,AF90,15,11,4,14.48,,
65718,71928P,8,1,7,1.91,,
65721,71955T,15,5,10,13.73,,
65722,T-FITTING,3,0,3,13.87,,
65724,71861H,2,0,2,49.48,,
65727,71004K,8,4,4,2.28,,
65728,"UNION 62CA-6",0,0,0,8.48,,
65729,"MD 38 NI COM FT",20,12,8,21.24,,
65733,"UPS BLKHD T-FIT",2,1,1,63.81,,
65734,"UPS T-FITTING",2,0,2,45.96,,
65738,"UPS 4-4 FLO-SS",5,4,1,112.93,,
65740,40878B,0,0,0,20.77,,
65744,42838Z,0,0,0,33.67,,
65745,40736E-UC94,2,0,2,18.37,,
65748,40735C,6,5,1,18.92,,
65749,40822X,4,2,2,34.63,,
65750,40736E,1,0,1,17.99,,
65751,73115F,8,6,2,34.80,,
65753,40736E-SVS,3,0,3,44.08,,
65754,A80488,0,0,0,55.39,,
65757,RF41200,3,3,0,32.83,50.22,
65779,010-12586-00,4,3,1,19.56,,
65780,010-12588-00,2,2,0,13.91,,
65781,010-12590-00,0,0,0,13.03,,
65782,010-12587-00,0,0,0,19.56,,
65784,010-12591-00,3,2,1,11.13,,
65789,TU95-50,2,2,0,158.57,,
65791,171CA-6-4,11,6,5,27.07,,
65803,RCM5,1,1,0,125.00,,
65812,F16-0080,5,3,2,62.78,,
65813,F40-0018WHC-A,12,10,2,4.69,,
65820,184003,31,8,23,4.71,,
65823,77010310,17,10,7,296.59,,
65824,DST800L-235-N2,0,0,0,554.57,,
65825,33-409-01,0,0,0,95.40,,
65827,221HF012,6,2,4,935.98,,
65838,1812ATP,2,1,1,870.26,,
65845,010-12528-02,12,4,8,48.74,,
65846,010-12531-00,47,28,19,18.74,,
65854,B501BT/L,3,2,1,429.44,,
65855,B501CHT/L,0,0,0,429.44,,
65856,B501B/L,3,2,1,374.73,,
65857,B501CH/L,0,0,0,368.52,,
65862,B502BT/L,0,0,0,749.20,,
65863,B502CHT/L,1,1,0,753.16,,
65864,B502B/L,3,2,1,642.79,,
65865,B502CH/L,4,2,2,596.03,,
65871,R70376,0,0,0,34.08,,
65891,940300050,3,0,3,579.99,,
65892,941300010,0,0,0,654.06,,
65899,941100020,2,1,1,779.99,,
65905,000-176-666-10,0,0,0,78.18,,
65906,SCR-24-CC-BZ-10,6,6,0,438.99,,635.00
65908,SCR-24-BW-BZ-10,0,0,0,431.74,,625.00
65909,SCR-24-GW-BZ-10,0,0,0,431.74,,625.00
65910,SCR-24-BB-BZ-10,0,0,0,431.74,,625.00
65915,A503-31CBBR-HE,2,1,1,128.05,,
65916,LL-101-PRO,3,0,3,67.07,,
65918,15099-001,5,3,2,23.43,,
65923,NEW-12V-24V-7A,0,0,0,377.78,,
65924,NEW-12V-24V-16A,0,0,0,711.11,,
65937,MC14X06,2,0,2,34.32,,
65939,MC14X10,4,2,2,38.00,,
65940,MC14X12,4,1,3,39.84,,
65941,MC14X14,2,0,2,41.69,,
65942,MC14X16,6,2,4,43.53,,
65943,MC14X18,3,2,1,45.37,,
65944,MC14X20,1,1,0,36.13,,
65945,MC14X22,0,0,0,49.07,,
65947,MC14X26,0,0,0,52.75,,
65948,MC14X28,0,0,0,54.60,,
65949,MC14X30,2,0,2,56.44,,
65950,MC14X32,0,0,0,67.51,,
65951,MC14X34,0,0,0,76.13,,
65952,MC14X36,0,0,0,84.68,,
65953,MC36X06,0,0,0,31.92,,
65954,MC36X08,0,0,0,31.69,,
65955,MC36X10,4,2,2,33.55,,
65956,MC36X12,0,0,0,37.45,,
65957,MC36X14,0,0,0,39.29,,
65958,MC36X16,0,0,0,41.13,,
65959,MC36X18,1,0,1,42.97,,
65960,MC36X20,2,2,0,44.83,,
65961,MC36X22,0,0,0,46.67,,
65962,MC36X24,0,0,0,48.83,,
65963,MC36X26,4,3,1,51.07,,
65964,MC36X28,0,0,0,52.16,,
65965,MC36X30,0,0,0,55.51,,
65966,MC36X32,0,0,0,67.51,,
65967,MC36X34,0,0,0,76.13,,
65968,MC36X36,0,0,0,84.68,,
65969,MC36X38,0,0,0,100.20,,
65974,MC5X08,0,0,0,34.08,,
65975,MC5X10,2,0,2,35.92,,
65976,MC5X12,3,1,2,37.77,,
65977,MC5X14,4,0,4,39.61,,
65978,MC5X16,7,5,2,41.45,,
65979,MC5X18,0,0,0,43.31,,
65981,MC5X22,3,2,1,46.99,,
65983,MC5X26,4,2,2,51.07,,
65984,MC5X28,2,0,2,53.25,,
65985,MC5X30,1,1,0,41.99,,
65986,MC5X32,0,0,0,66.28,,
65987,MC5X34,0,0,0,76.13,,
65988,MC5X36,0,0,0,84.68,,
65990,MC5X38,0,0,0,93.25,,
65991,MC0X06,3,2,1,24.76,,
65992,MC0X08,2,2,0,25.81,,
65993,MC0X10,4,2,2,28.68,,
65994,MC0X12,1,0,1,31.15,,
65995,MC0X14,6,2,4,34.16,,
65996,MC0X16,5,2,3,36.88,,
65997,MC0X18,8,2,6,39.79,,
65998,MC0X20,0,0,0,42.71,,
65999,MC0X22,4,2,2,45.64,,
66000,MC0X24,1,1,0,48.57,,
66001,MC0X26,3,1,2,51.53,,
66002,MC0X28,3,1,2,54.41,,
66003,MC0X30,2,0,2,57.33,,
66004,MC0X32,4,2,2,71.48,,
66005,MC0X34,0,0,0,75.47,,
66006,MC0X36,0,0,0,79.45,,
66007,MC0X38,0,0,0,83.40,,
66015,LNZ-512S,0,0,0,51.11,,
66025,SET0090,0,0,0,172.80,,
66028,545-5010-7,11,11,0,27.70,,
66030,MGR450B,9,0,9,105.00,,
66036,RLS-508-401,3,2,1,67.33,,
66037,RLS-509-401,2,0,2,61.45,,
66043,RLS-513-401,1,1,0,60.03,,
66048,010-12491-01,1,0,1,19.99,,
66053,010-12236-00,0,0,0,314.99,,
66054,010-12236-01,0,0,0,397.49,,
66055,010-12236-02,0,0,0,547.49,,
66056,010-12239-00,0,0,0,14.99,,
66060,010-12237-00,0,0,0,14.99,,
66062,010-12239-01,0,0,0,14.99,,
66063,010-12237-01,0,0,0,14.99,,
66065,010-12520-00,0,0,0,55.99,,
66071,RLS-509-405,2,0,2,70.15,,
66073,010-12098-00,36,28,8,18.74,,
66075,010-12020-00,7,0,7,6.99,,
66100,980950051,2,0,2,183.54,,
66103,66502-1,43,18,25,17.10,,
66104,001-409-520-00,0,0,0,222.73,,
66105,A06075,22,14,8,35.52,,
66106,A06076,13,3,10,35.52,,
66109,11969-4,2,0,2,23.81,,
66110,13710-4,0,0,0,43.08,,
66112,117553-7,2,0,2,10.68,,
66113,3020-D,7,5,2,51.39,,
66120,SP4919SL/XS,1,1,0,218.08,,
66126,A80500,0,0,0,68.17,,
66128,010-12006-11,10,4,6,22.49,,
66135,02840300A,3,2,1,473.33,,
66149,LFVL-8,23,23,0,437.08,,
66150,LFVL-10,21,21,0,499.00,,
66153,FND,36,36,0,3.79,,
66157,29550,1,0,1,15.83,,
66158,29551,9,9,0,11.99,,
66159,29552,26,11,15,4.63,,
66161,29751,11,11,0,7.70,,
66162,LMB-EXTSHORT,0,0,0,194.63,,
66165,165T-B54,7,3,4,1688.89,,
66166,136,0,0,0,163.76,,
66168,055-43250-7,0,0,0,18.36,,
66177,83550,0,0,0,576.22,,
66208,68810,0,0,0,52.25,,
66215,1PPOT,21,15,6,21.84,,
66232,ZDIGAIT1500N2K,3,1,2,562.46,,
66237,3876-3,118,10,108,7.91,,
66238,AR-6493,9,6,3,26.76,,
66240,R70384,0,0,0,136.35,,
66247,TM260-BL,0,0,0,987.78,,
66256,A80438,2,0,2,346.46,,
66257,A80011,0,0,0,1642.65,,
66269,1854053,0,0,0,159.81,,
66277,15140-001,8,0,8,16.69,,
66286,A80440,5,2,3,149.99,,
66288,F16-2525,4,3,1,41.83,,
66289,100-357-172-10,2,0,2,22.73,,
66292,300-038,0,0,0,2042.68,,2604.41
66295,SET0087,0,0,0,56.40,,
66303,1341,9,3,6,7.73,,
66305,000-159-688,0,0,0,100.00,,
66306,BP-T901P,1,0,1,591.46,,
66308,S3-0506_A,3,1,2,524.99,,
66319,B4A02753,0,0,0,630.88,,
66322,GP1900-06,0,0,0,319.99,,
66342,RFLAERTR,9,9,0,21.11,,
66345,FPF6,0,0,0,15.38,,
66347,SACP6,0,0,0,8.33,,
66348,SACP8,2,2,0,9.64,,
66349,FSB1223,0,0,0,21.33,,
66350,FSB1631,1,1,0,33.03,,
66351,6033,3,1,2,58.66,,
66352,6126SC,0,0,0,52.54,,
66353,SET0089,0,0,0,88.80,,
66354,BP65S,0,0,0,30.86,,
66365,F106877,7,0,7,47.08,,
66367,F12066,5,0,5,35.53,,
66374,RMX4500-08,0,0,0,399.99,,
66378,44020120,4,2,2,416.20,,
66384,B275C-LHW-MM,2,0,2,1797.44,,
66386,DSM410-01,0,0,0,476.00,,
66392,001-435-870-00,0,0,0,86.36,,
66402,58359,5,2,3,183.34,,
66405,STC,9,4,5,265.63,,
66407,SP4157,0,0,0,63.00,,
66408,1015,10,6,4,15.03,,
66409,1016,66,57,9,15.03,,
66411,11311,40,20,20,11.57,,
66412,11312,15,15,0,11.57,,
66413,11313,21,19,2,12.06,,
66414,375,5,5,0,12.22,,
66415,19308,0,0,0,230.63,,
66423,GP1800-07,0,0,0,312.72,,
66425,R70523,1,0,1,42.60,,
66426,L10-1003-1,4,2,2,1384.23,,
66427,L10-1002-1,5,0,5,255.97,,
66428,L10-1003BAG,0,0,0,323.18,,
66434,P102923,0,0,0,117.64,,
66448,83554,0,0,0,1054.10,,
66449,83557,0,0,0,593.21,,
66450,83562,0,0,0,744.82,,
66451,CAM-MM-02,0,0,0,263.81,,
66452,CAM-PT-150-02,0,0,0,230.63,,
66453,CAM-PT-300-02,1,1,0,243.00,,
66454,010-11599-10,105,70,35,79.98,,
66462,7879CR-FI,0,0,0,49.28,,
66463,41500500,0,0,0,34.71,,
66466,SHC-18,11,5,6,52.50,,
66484,MARCAC9,14,5,9,16.15,,
66490,MM3-VNA-024,0,0,0,227.27,,
66491,0150,5,0,5,20.01,,
66492,0151,1,1,0,23.53,,
66493,0152,0,0,0,25.03,,
66499,INTTYPES,2,1,1,788.24,,
66500,INTTYPET,0,0,0,831.71,,
66501,INTTYPER,0,0,0,659.52,,
66502,INTTYPEH,2,1,1,718.02,,
66503,INTTYPEA,3,2,1,125.38,,
66504,INTREMOTE,2,2,0,40.96,,
66505,132000-400-004-18,11,4,7,110.21,,
66527,PO414DWC-10,0,0,0,172.82,,
66529,BHW4025,0,0,0,49.06,,
66530,ATPDISPBR,3,2,1,162.39,,
66531,ATPBRCABLE,0,0,0,34.67,,
66532,1710C-13C-KIT,1,1,0,1689.29,,
66537,010-12445-13,4,0,4,15.74,,
66550,PT109,3,1,2,7.90,,
66555,4158-163-E75,0,0,0,321.23,,
66563,131252,2,1,1,10.60,,
66564,141250,0,0,0,17.67,,
66565,161250,3,0,3,21.20,,
66566,620106,0,0,0,11.30,,
66567,620206,2,2,0,14.13,,
66568,620306,0,0,0,17.67,,
66569,861600,5,2,3,35.34,,
66571,137401,0,0,0,56.56,,
66572,144900,0,0,0,12.71,,
66573,145000,3,0,3,17.67,,
66574,146000,0,0,0,28.27,,
66575,777101,0,0,0,69.87,,
66576,787010,2,0,2,80.43,,
66584,344010,6,6,0,6.43,,
66585,RF1135-20,4,2,2,3.82,,
66586,RF1136,0,0,0,6.94,,
66587,354010,0,0,0,7.71,,
66588,RF2330,0,0,0,16.53,25.29,
66589,364010,1,1,0,9.64,,
66591,374010,2,2,0,11.57,,
66592,RF3124,0,0,0,90.41,138.33,
66593,374110,8,0,8,12.86,,
66596,386001,12,11,1,10.60,,
66597,RF3132,0,0,0,78.65,120.33,
66598,387001,8,0,8,12.01,,
66600,360710,0,0,0,5.79,,
66601,370710,0,0,0,6.43,,
66602,RF44140,0,0,0,77.22,118.15,
66603,705001,0,0,0,10.93,,
66604,RF44188,0,0,0,76.50,101.15,
66605,708001,19,10,9,16.07,,
66606,RF444,0,0,0,30.14,46.10,
66608,2350000,8,2,6,3.21,,
66610,2360001,23,13,10,5.14,,
66611,2370002,0,0,0,6.43,,
66612,RF62100,0,0,0,135.19,,
66613,RF66100,0,0,0,31.33,47.94,
66614,RF72100,0,0,0,171.44,236.07,
66633,0301DP5,0,0,0,4.80,,
66636,R409C-LWM,0,0,0,4204.83,,
66642,GP1200-14,0,0,0,363.62,,
66647,331-548,0,0,0,27.84,,
66669,001-470-970-00,0,0,0,427.27,,
66673,212513,0,0,0,167.37,267.79,
66680,SM-ACC-SNAP,5,1,4,31.26,,38.47
66682,SM-ACC-INFR,3,1,2,109.84,,135.19
66683,SM-ACC-REED,2,2,0,14.94,,18.38
66684,SM-ACC-EPIR,7,3,4,118.29,,145.59
66685,SM-ACC-SHOR,5,3,2,59.14,,72.79
66687,SM-ACC-DCRE,4,2,2,22.81,,28.07
66692,142006,4,1,3,58.44,,
66693,142100,0,0,0,45.73,,
66694,142208,7,3,4,72.88,,
66697,00900-40,0,0,0,7.10,,
66700,00900-37A,12,5,7,2.97,,
66706,7717N,6,0,6,15.20,,
66730,TS1029,0,0,0,10.41,,
66740,RA-259-239-G,12,0,12,10.84,,
66742,136400,2,2,0,40.12,,
66745,07200,7,3,4,538.77,,
66746,06200,7,3,4,344.44,,
66749,010-11078-01,64,34,30,41.24,,
66750,010-11351-50,0,0,0,33.74,,
66755,16870,72,40,32,3.59,,
66756,16871,6,2,4,8.07,,
66757,16873,36,3,33,8.97,,
66782,601CH-28,0,0,0,3005.88,,
66783,603CH-30,0,0,0,3817.06,,
66784,602BR-24,0,0,0,2566.24,,
66785,825ST-1,0,0,0,75.00,,
66786,827-14,0,0,0,29.25,,
66788,521-125AL,0,0,0,421.50,,
66789,1404-5,0,0,0,21.75,,
66790,733CG-32-40-GR,0,0,0,270.00,,
66791,733CG-15-20-GR,0,0,0,201.75,,
66792,733CG-22-30-GR,0,0,0,246.00,,
66793,733CG-42-60-GR,0,0,0,385.50,,
66794,733CG-15-20-GR1,0,0,0,257.25,,
66795,733CG-22-30-GR1,0,0,0,293.25,,
66796,733CG-32-40-GR1,0,0,0,319.50,,
66797,733CG-42-60-GR1,0,0,0,409.50,,
66799,737TK-95-28,0,0,0,1436.75,,
66801,737TK-C-28,0,0,0,1468.25,,
66802,737WH-95-28,0,0,0,871.50,,
66803,737WH-C-28,0,0,0,902.13,,
66804,761TK-95,0,0,0,754.25,,
66805,761TK-C-28,0,0,0,754.25,,
66806,761WH-95,0,0,0,522.38,,
66807,761WH-C-28,0,0,0,546.88,,
66808,878TK-1-125,2,0,2,174.75,,
66809,878WH-1-125,0,0,0,156.75,,
66810,878TK-2-125,0,0,0,174.75,,
66811,878WH-2-125,0,0,0,174.75,,
66812,1401-3,0,0,0,96.75,,
66815,1405-24,0,0,0,57.00,,
66816,1405-14,0,0,0,48.00,,
66817,1405-12,0,0,0,39.75,,
66819,CLIP-AIS,0,0,0,301.23,,
66831,A503-11AAG-HE,1,0,1,128.05,,
66833,GP2050-16,0,0,0,327.26,,
66841,F14215,30,20,10,8.99,,
66842,F14216,0,0,0,14.75,,
66843,F12811,0,0,0,11.53,,
66845,725001,1,0,1,11.57,,
66847,F12637,2,2,0,18.68,,
66848,108401,1,1,0,11.57,,
66849,108700,0,0,0,12.86,,
66850,F13758,0,0,0,16.36,,
66851,F14060,1,1,0,12.41,,
66852,181250,12,6,6,31.81,,
66856,464810,5,0,5,8.36,,
66857,465100,14,14,0,9.19,,
66858,500000,2,2,0,16.26,,
66859,500089,0,0,0,11.42,,
66860,FUR-DWN-CBL,0,0,0,59.09,,
66861,500101,0,0,0,11.30,,
66862,500102,0,0,0,11.30,,
66863,500010,0,0,0,14.13,,
66864,620210,0,0,0,21.20,,
66865,620310,0,0,0,24.74,,
66868,SCR-24-AG-BZ-10,0,0,0,431.74,,625.00
66870,222113,2,2,0,193.12,308.99,
66872,106113,1,1,0,218.87,350.19,
66874,262113,10,9,1,243.75,389.99,
66877,110113,1,1,0,283.25,453.19,
66879,1710BL-13B-KIT,2,0,2,573.75,,
66886,7531,1,0,1,542.96,,
66890,"98 075",0,0,0,149.75,,
66897,760200,0,0,0,24.74,,
66898,760301,2,2,0,31.81,,
66900,374310,0,0,0,12.86,,
66909,EOS130-BK,4,1,3,41.44,,
66911,344987,0,0,0,3.21,,
66912,345500,11,5,6,6.43,,
66913,2375002,0,0,0,6.43,,
66914,2373005,18,18,0,9.64,,
66915,2361800,0,0,0,5.14,,
66920,100103,5,5,0,10.60,,
66921,530006,2,2,0,17.67,,
66923,620292,5,5,0,14.13,,
66925,613306,0,0,0,28.27,,
66957,E70481-00-NAG,0,0,0,1921.59,,
66958,PTS-1,0,0,0,176.99,,
66959,PTS-2,5,5,0,292.03,,
66960,ARM101,0,0,0,109.94,,
66961,ARM101WP,0,0,0,17.00,,
66962,AD200,2,2,0,17.00,,
66967,E70483-00-NAG,2,0,2,4241.59,,
66969,E70371-00-NAG,0,0,0,2161.59,,
66971,470000,6,6,0,12.86,,
66972,R70484,26,16,10,17.03,,
66973,MMC-12G,4,1,3,95.00,,
66975,E70372-00-NAG,0,0,0,3201.59,,
66977,E70373-00-NAG,1,1,0,4641.59,,
66978,50080-3,0,0,0,11.36,,
66985,A80490,10,2,8,59.65,,
66997,P12074,0,0,0,470.40,,
66998,P12073,3,1,2,458.40,,
66999,GP1050-15,0,0,0,327.26,,
67002,010-12117-10,0,0,0,14.99,,
67007,"PW 02685",17,11,6,11.15,18.95,
67010,"KR 41511",6,6,0,16.54,25.95,
67011,"CA 03516-6",8,3,5,27.96,35.95,
67012,Z60-8266VEL26-2,4,2,2,45.67,,
67013,Z60-7279VEL27.5-2,4,2,2,35.65,,
67014,Z60-7288VEL30.75-2,5,3,2,44.13,,
67015,Z10-4067BLY60MM,6,4,2,33.95,,
67016,Z10-4085BLY60MM,3,2,1,42.46,,
67017,FW-240M-RG,0,0,0,99.29,,
67018,FW-240M-BG,0,0,0,99.29,,
67019,FW-240A-RG,0,0,0,108.56,,
67020,FW-240A-BG,0,0,0,108.56,,
67024,BPA,0,0,0,46.40,,
67032,M6385,0,0,0,32.87,,
67033,M180132,16,4,12,12.45,,
67034,M180232,0,0,0,11.03,,
67035,M180332,4,0,4,10.82,,
67045,220161,1,1,0,27.98,,
67046,220162,6,2,4,27.98,,
67047,220163,4,2,2,34.07,,
67049,710265-1,0,0,0,280.32,,
67052,817-1000,4,1,3,449.62,,
67053,817-2000,7,5,2,628.97,,
67055,817-1050,0,0,0,579.01,,
67056,817-2080,12,7,5,773.44,,
67057,808-0817-01,22,7,15,57.14,,
67058,808-9817,9,4,5,24.84,,
67059,ECP135,0,0,0,78.92,89.95,
67060,ECPL38,0,0,0,165.76,189.00,
67061,1831050,5,3,2,47.06,,
67062,1830110,2,2,0,67.23,,
67063,1854051,1,0,1,191.63,,
67070,1810440,2,0,2,1504.02,,
67071,1810441,2,0,2,1504.02,,
67072,1810442,4,0,4,1504.02,,
67073,1810443,3,1,2,1504.02,,
67075,1810445,0,0,0,1504.02,,
67076,1810450,3,1,2,1575.64,,2199.99
67077,1810451,0,0,0,1575.64,,2199.99
67078,1810452,12,6,6,1575.64,,2199.99
67079,1810453,0,0,0,1575.64,,2199.99
67081,1810455,2,0,2,1575.64,,2199.99
67082,1810462,2,0,2,1862.13,,2599.99
67083,1810463,1,0,1,1862.13,,2599.99
67084,1810247,0,0,0,106.46,,
67085,1810248,10,4,6,85.16,,
67086,1810249,6,4,2,91.71,,
67087,1810257,5,3,2,127.75,,
67089,A80333,0,0,0,8.51,,
67092,010-12342-00,0,0,0,79.98,,
67093,136200,0,0,0,28.27,,
67095,757004,0,0,0,45.68,,
67096,112300,0,0,0,28.27,,
67097,134830,0,0,0,19.03,,
67099,RC1010CAP12V,0,0,0,1828.13,2681.00,
67101,3875-3,13,7,6,6.63,,
67115,767000,0,0,0,79.19,,
67129,EVO-2212,1,1,0,1351.59,1950.60,
67130,EVO-3012,1,1,0,1555.49,2321.40,
67131,EVO-2224,0,0,0,1351.59,1950.60,
67132,EVO-4024,1,1,0,1600.00,2309.10,
67134,EVO-RC,1,1,0,102.27,147.60,
67135,SAM-1500C-12,0,0,0,276.82,399.50,
67136,SAM-100-12,0,0,0,25.57,36.90,
67137,SAM-250-12,1,1,0,46.02,66.50,
67138,LHC,0,0,0,359.05,,
67139,SAM-450-12,0,0,0,55.23,79.70,
67141,SAM-800-12,2,2,0,80.68,116.50,
67155,SAM-1000-12,0,0,0,98.86,142.70,
67156,SAM-1500-12,0,0,0,169.77,245.10,
67157,SAM-2000-12,2,2,0,231.48,334.10,
67158,SAM-3000-12,0,0,0,344.32,496.90,
67159,PSE-12125A,1,1,0,258.41,372.90,
67160,PSE-12175A,0,0,0,312.50,451.00,
67162,PSE-24125A,0,0,0,211.02,304.50,
67164,PSE-24275A,0,0,0,602.27,869.20,
67165,SSW-350-12A,0,0,0,91.93,132.60,
67166,SSW-600-12A,1,1,0,151.25,218.20,
67170,PST-300-12,0,0,0,171.02,246.80,
67171,PST-600-12,0,0,0,228.41,329.60,
67173,PST-1500-12,0,0,0,465.68,724.30,
67174,PST-2000-12,1,1,0,663.41,957.40,
67175,PST-3000-12,2,2,0,932.16,1345.40,
67176,PST-300-24,0,0,0,171.02,246.80,
67177,PST-600-24,0,0,0,212.50,329.60,
67178,PST-1000-24,0,0,0,411.59,594.00,
67179,PST-1500-24,1,1,0,501.82,724.30,
67180,PST-2000-24,1,1,0,615.91,957.40,
67181,PST-3000-24,1,1,0,921.69,1345.40,
67182,STS-30,0,0,0,203.98,294.40,
67183,SBR-27LI,7,6,1,30.00,,
67185,FW-330M-HV,0,0,0,102.38,,
67186,FW-330A-HV,0,0,0,114.75,,
67187,SEC-1215UL,2,2,0,139.32,201.10,
67188,SEC-1230UL,2,2,0,195.11,281.70,
67189,SEC-1250UL,2,2,0,354.55,511.70,
67190,SEC-1280UL,1,1,0,503.52,726.70,
67191,SEC-2415UL,1,1,0,195.11,281.70,
67192,SEC-2425UL,1,1,0,351.48,507.30,
67193,SEC-2440UL,1,1,0,503.52,726.70,
67194,900-RC,1,1,0,28.07,40.50,
67195,RC-15,0,0,0,16.25,23.40,
67196,RC-15A,1,1,0,26.14,37.70,
67198,RC-300,1,1,0,59.89,86.40,
67199,SAM-RC,0,0,0,25.57,36.90,
67213,DC-1000-KIT,0,0,0,113.75,164.10,
67214,DC-2000-KIT,0,0,0,133.98,193.30,
67215,DC-2500-KIT,0,0,0,202.16,291.80,
67216,DC-3500-KIT,0,0,0,397.61,573.80,
67217,7462,0,0,0,42.76,,
67218,3131,13,9,4,32.09,,
67220,DC-FA-100,0,0,0,30.11,43.50,
67221,DC-FA-200,2,2,0,30.11,43.50,
67223,DC-FA-300,0,0,0,30.11,43.50,
67224,MRBF-100,2,2,0,11.93,17.20,
67225,MRBF-200,3,3,0,11.93,17.20,
67226,MRBF-300,3,3,0,11.93,17.20,
67227,7532,0,0,0,691.06,,
67228,DC-FB-2,1,1,0,25.23,36.40,
67229,JLLN-400,1,1,0,97.50,140.70,
67230,CFB2-400,2,2,0,119.09,171.90,
67232,BF16,0,0,0,76.73,107.10,
67233,GP1040-40,0,0,0,334.53,,
67241,BG-200,1,1,0,183.12,279.40,
67242,BW-01,0,0,0,38.18,55.10,
67243,BW-03,2,2,0,68.98,99.50,
67244,ACR-160,0,0,0,101.36,146.40,
67245,SDC-15,0,0,0,68.98,99.60,
67246,SDC-23,3,3,0,77.16,111.40,
67247,SDC-5,0,0,0,33.30,48.10,
67248,SDC-12,0,0,0,44.32,63.90,
67249,SDC-30,0,0,0,110.23,159.10,
67250,SDC-60,0,0,0,265.45,383.00,
67251,IDC-100A-12,0,0,0,113.41,163.60,
67252,IDC-100B-12,0,0,0,113.41,163.60,
67253,IDC-100C-12,0,0,0,113.41,163.60,
67254,IDC-100D-12,0,0,0,113.41,163.60,
67255,IDC-100A-24,0,0,0,113.41,163.60,
67256,IDC-100C-24,0,0,0,113.41,163.60,
67257,IDC-200A-12,0,0,0,130.68,188.60,
67258,IDC-200B-12,0,0,0,130.68,188.60,
67259,IDC-200C-12,0,0,0,130.68,188.60,
67260,IDC-200D-12,0,0,0,130.68,188.60,
67261,IDC-200A-24,0,0,0,130.68,188.60,
67262,IDC-200B-24,0,0,0,130.68,188.60,
67263,IDC-200C-24,0,0,0,130.68,188.60,
67264,IDC-360A-12,0,0,0,251.70,363.30,
67265,IDC-360B-12,0,0,0,251.70,363.30,
67266,IDC-360C-12,0,0,0,251.70,363.30,
67267,IDC-360D-12,0,0,0,251.70,363.30,
67268,IDC-360A-24,0,0,0,251.70,363.30,
67269,IDC-360B-24,0,0,0,251.70,363.30,
67270,IDC-360C-24,0,0,0,251.70,363.30,
67271,STEP7,0,0,0,83.75,120.80,
67272,STEP10,0,0,0,116.59,168.30,
67273,STEP20,0,0,0,242.39,349.80,
67276,59001,0,0,0,21.36,,
67277,59000,0,0,0,44.01,,
67295,93-303,37,16,21,15.40,,
67296,93-304,22,22,0,12.06,,
67297,C3-803,102,65,37,5.35,,
67298,C3-805,68,26,42,5.35,,
67299,C3-810,70,11,59,5.35,,
67300,C7-10,90,48,42,12.78,,
67301,C7-10-02,3,3,0,14.00,,
67302,S3-0503,1,0,1,1282.07,,
67303,F7-53,0,0,0,6.96,,
67304,F7-73,32,25,7,9.78,,
67305,M1-15-61-8,0,0,0,43.79,,
67306,M1-20-32-48,6,6,0,55.99,,
67307,M1-20-81-48,0,0,0,69.21,,
67309,M1-2A-11-1,0,0,0,24.06,,
67310,M1-2A-13-5,22,4,18,11.99,,
67311,90919,255,149,106,10.47,,
67312,90923,202,73,129,10.47,,
67313,90925,176,65,111,10.47,,
67314,90927,97,49,48,10.47,,
67316,90891,24,24,0,8.00,,
67317,90893,279,159,120,8.00,,
67318,90892,140,65,75,8.00,,
67325,131550,3,1,2,244.11,,
67329,188024,61,46,15,10.51,,
67330,106096,85,40,45,15.24,,
67336,710273-1,0,0,0,65.11,,
67344,MFC-2BS,2,2,0,12.99,,
67345,MFC-2NS,4,3,1,12.99,,
67346,MFC-3BS,11,6,5,23.73,,
67347,MFC-3NS,0,0,0,23.73,,
67348,MFC-4BS,3,0,3,28.86,,
67352,MFC-4NS,5,2,3,28.86,,
67357,MFC-1BD,1,1,0,9.99,,
67358,MFC-1BS,0,0,0,12.44,,
67359,MFC-1NS,2,2,0,12.44,,
67360,MFC-2BD,0,0,0,21.94,,
67361,MFC-2ND,0,0,0,21.94,,
67362,MFC-3BD,0,0,0,37.49,,
67364,MFC-3ND,0,0,0,37.49,,
67367,MFC-4BD,8,4,4,45.12,,
67368,MFC-4ND,9,6,3,45.12,,
67373,MFC-A2B,3,1,2,26.27,,
67377,MFC-A2N,1,1,0,23.49,,
67389,MFC-A3B,5,3,2,34.14,,
67390,MFC-A3N,0,0,0,34.14,,
67391,MFC-A4B,2,2,0,55.87,,
67392,MFC-A4N,0,0,0,55.87,,
67393,MFC-A5B,0,0,0,80.81,,
67394,MFC-A5N,0,0,0,80.81,,
67395,MFC-A6B,2,0,2,102.53,,
67396,MFC-A7N,0,0,0,136.04,,
67397,MFC-A7B,0,0,0,136.04,,
67398,MFC-F4N,4,4,0,37.99,,
67399,MFC-F4B,0,0,0,46.55,,
67400,MFC-F7N,1,0,1,49.21,,
67401,MFC-F7B,0,0,0,49.21,,
67402,MFC-F8N,0,0,0,71.60,,
67403,MFC-F8B,0,0,0,71.60,,
67404,MFC-F10B,0,0,0,76.86,,
67406,MFC-F10N,0,0,0,76.86,,
67407,MFC-F11B,0,0,0,95.29,,
67408,MFC-F11N,0,0,0,95.29,,
67409,MFC-13B,0,0,0,145.92,,
67410,MFC-F13N,0,0,0,145.92,,
67412,M5-60-205-8,0,0,0,70.58,,
67415,MC-04-123-10,0,0,0,179.00,,
67416,MF-01-110-60,28,4,24,75.22,,
67417,37-20-086-20,34,18,16,13.49,,
67420,93-10-201-50,0,0,0,32.04,,
67421,93-314,0,0,0,13.21,,
67422,C2-32-25,5,5,0,16.50,,
67423,C7-10-15,0,0,0,11.59,,
67424,F7-530,23,11,12,5.74,,
67426,1001401,26,20,6,3.87,,
67427,1001402,15,10,5,3.59,,
67428,1001503,9,4,5,9.88,,
67429,1001504,4,2,2,14.29,,
67430,1001505,6,3,3,10.38,,
67431,1001506,0,0,0,14.41,,
67432,1001507,6,6,0,11.00,,
67433,1001508,8,6,2,7.94,,
67435,A80526,0,0,0,59.65,,
67436,A80527,0,0,0,76.69,,
67437,A80528,0,0,0,76.69,,
67438,A80525,0,0,0,59.65,,
67439,A80529,1,0,1,76.69,,
67440,A80524,1,0,1,59.65,,
67441,A80530,1,1,0,68.17,,
67442,A80531,0,0,0,74.99,,
67443,A80533,0,0,0,91.66,,
67444,209-1277-00,6,4,2,110.54,,
67445,1001306,21,5,16,15.27,,
67446,1001302,8,6,2,9.31,,
67447,1001303,4,2,2,15.34,,
67448,1001307,6,6,0,8.74,,
67449,1001304,0,0,0,26.02,,
67450,1001301,0,0,0,11.45,,
67451,1001305,0,0,0,11.81,,
67452,1001605,2,1,1,26.12,,
67454,1001606,4,1,3,18.99,,
67455,1001610,6,3,3,11.81,,
67456,1001604,5,3,2,24.85,,
67457,1001603,2,0,2,34.79,,
67458,1001607,5,2,3,18.69,,
67459,1001609,6,2,4,18.84,,
67460,1002301,0,0,0,18.74,,
67461,1001001,1,1,0,28.95,,
67462,1002101,0,0,0,59.08,,
67463,1002102,10,5,5,42.55,,
67464,1001601,7,5,2,12.82,,
67465,1001602,4,0,4,7.01,,
67466,1001101,0,0,0,5.90,,
67467,1001102,6,2,4,3.94,,
67468,1001103,12,7,5,3.94,,
67469,1001104,18,12,6,3.94,,
67470,1002206,0,0,0,19.65,,
67471,1002201,0,0,0,44.52,,
67472,1002205,0,0,0,30.18,,
67473,1002203,0,0,0,25.74,,
67474,1002204,2,0,2,22.38,,
67480,560-1814-7,0,0,0,22.50,,
67482,512-9911-1,3,3,0,18.09,,
67491,7010,8,5,3,16.07,,
67494,1128,7,7,0,17.04,,
67495,INF622MLT,0,0,0,159.42,229.65,
67496,INF622MLW,1,1,0,149.99,229.95,
67497,INF822MLT,0,0,0,188.09,259.95,
67498,INF822MLW,0,0,0,188.09,259.95,
67499,INF1022MLT,0,0,0,180.64,229.95,
67500,INF1022MLW,2,0,2,159.99,229.95,
67507,T70327,11,6,5,285.32,,
67528,A526-31AAG-HE,21,19,2,147.26,,
67536,RF261,0,0,0,2.93,,
67538,RF263,0,0,0,2.93,,
67544,RF270,0,0,0,6.60,,
67547,RF273,1,0,1,6.60,,
67550,RF276,0,0,0,12.70,,
67578,32816,3,2,1,104.93,,
67603,1377615,1,1,0,580.24,,
67605,1377652,1,1,0,869.86,,
67611,412,2,2,0,11.27,,
67613,413,0,0,0,11.58,,
67616,010-01759-00,10,4,6,183.74,,
67618,591,0,0,0,13.21,,
67619,010-12506-00,15,3,12,74.99,,
67623,010-12523-00,1,0,1,44.99,,
67627,010-12523-03,3,0,3,59.99,,
67629,010-12506-02,9,3,6,59.99,,
67631,444,3,3,0,21.33,,
67632,442,0,0,0,22.99,,
67633,446,8,2,6,13.99,,
67634,010-12505-02,10,4,6,11.24,,
67635,300,9,4,5,11.90,,
67636,302,8,6,2,11.90,,
67637,301,4,4,0,11.90,,
67640,847Q,0,0,0,11.49,,
67666,DT1H,20,9,11,69.68,,
67671,1001801,13,6,7,8.86,,
67672,1001802,18,3,15,8.30,,
67673,1001803,6,5,1,8.86,,
67674,1001804,12,6,6,9.16,,
67675,1001805,6,5,1,9.31,,
67676,1001806,3,1,2,9.31,,
67677,1001807,0,0,0,11.73,,
67678,1001808,11,2,9,11.81,,
67679,1001809,11,4,7,11.60,,
67680,1001810,0,0,0,9.74,,
67681,1001811,5,0,5,10.01,,
67682,1001812,6,4,2,11.73,,
67683,1001703,8,5,3,3.23,,
67684,1001702,6,1,5,5.44,,
67685,1001701,9,3,6,8.30,,
67686,1001705,5,5,0,6.68,,
67687,1001707,8,3,5,3.93,,
67688,1001708,6,5,1,7.21,,
67689,1001714,0,0,0,6.93,,
67690,1001716,2,2,0,14.36,,
67691,1001704,12,2,10,11.84,,
67692,1001709,10,6,4,5.54,,
67693,1001706,10,5,5,4.29,,
67694,1001710,13,5,8,6.26,,
67695,1001715,10,7,3,8.38,,
67696,1001711,29,19,10,6.30,,
67697,1001712,0,0,0,6.96,,
67698,1001713,21,15,6,7.76,,
67699,1001901,11,6,5,6.88,,
67700,1001906,0,0,0,7.23,,
67701,1001902,0,0,0,4.66,,
67702,1001908,7,5,2,7.01,,
67707,MCK632WB.6,9,1,8,68.13,,
67708,MCK632WB.64,3,0,3,90.85,,
67751,MR508UABW,9,4,5,72.17,,
67752,MR632UAB,72,42,30,37.72,,
67753,MR692W,2,0,2,62.50,,
67754,MR62W,7,6,1,32.90,,
67755,MR52W,9,7,2,24.34,,
67757,MRGB65B,7,3,4,56.82,,
67761,MR62B,9,7,2,32.90,,
67764,MR52B,15,0,15,23.99,,
67776,100102-W,0,0,0,8.33,,
67779,S72-0486,1,1,0,729.99,,
67784,"ROGUE REACH DB",0,0,0,623.86,,
67785,"ROGUE PRO DB",0,0,0,587.50,,
67786,EC-ER-DB,1,0,1,999.99,,
67788,EC-HP-DB-AC,2,2,0,1699.99,,
67790,99081,0,0,0,522.38,,
67791,99080,0,0,0,451.95,,
67793,11700100,12,5,7,50.13,,
67794,11700500,7,2,5,54.18,,
67795,11700700,2,2,0,52.65,,
67796,11700800,2,2,0,50.13,,
67797,11701500,2,0,2,60.25,,
67798,31430930,2,1,1,301.23,,
67799,31432330,4,2,2,301.23,,
67800,31432340,0,0,0,301.23,,
67801,31511110,3,1,2,385.26,,
67802,31511120,0,0,0,385.26,,
67803,31511310,4,3,1,385.26,,
67804,31511320,4,2,2,385.26,,
67805,31511510,5,1,4,385.26,,
67806,31511520,2,0,2,385.26,,
67819,862113,2,0,2,243.75,389.99,
67820,862213,0,0,0,243.75,389.99,
67822,212213BLK,3,1,2,180.25,288.39,
67823,220003,0,0,0,307.62,492.19,
67824,150213BLK,0,0,0,1158.75,1853.99,
67826,883213BLK,0,0,0,1037.50,1659.99,
67832,872213,3,1,2,721.87,1154.99,
67833,873213,8,5,3,984.37,1574.99,
67834,874213,4,2,2,1246.87,1994.99,
67835,876213,0,0,0,1574.99,2519.99,
67836,322613,0,0,0,413.75,661.99,
67840,324313,8,8,0,285.88,,
67845,884213,4,2,2,1252.84,2099.99,
67846,2378000,0,0,0,9.64,,
67847,202113,5,4,1,148.06,236.89,
67848,202213,22,13,9,148.06,236.89,
67849,502313,2,0,2,263.93,422.29,
67850,502513,0,0,0,263.93,422.29,
67852,942213,0,0,0,98.43,157.49,
67865,945513,0,0,0,200.00,319.99,
67880,806113,0,0,0,206.24,329.99,
67881,806213,1,0,1,206.24,329.99,
67882,806313,0,0,0,218.87,350.19,
67883,806513,3,0,3,218.87,350.19,
67886,810313,4,0,4,283.25,453.19,
67887,820313,4,1,3,489.25,782.79,
67888,830313,3,0,3,708.12,1132.99,
67889,840313,12,0,12,749.94,,
67901,602113,6,2,4,148.06,236.89,
67902,602213,2,0,2,148.06,236.89,
67903,602513,3,1,2,148.06,236.89,
67915,MHU-TACT,0,0,0,237.95,,
67945,62-542-MARINE-BLK,0,0,0,49.94,,
67950,710269-1,2,0,2,166.67,,
67951,710270-1,0,0,0,159.09,,
67952,ZDIGN2KIT,12,6,6,89.96,,
67953,720101-1,0,0,0,33.33,,
67954,720102-1,7,1,6,33.33,,
67957,720073-6,0,0,0,35.06,,
67962,740174-1,4,1,3,41.66,,
67963,740175-1,0,0,0,60.60,,
67964,740176-1,1,1,0,53.02,,
67965,740177-1,0,0,0,60.60,,
67969,875213,1,0,1,1509.37,2414.99,
67973,PS20061050000,0,0,0,412.50,,
67974,PS20061054000,0,0,0,412.50,,
67975,PS20061058000,0,0,0,412.50,,
68004,MMC-0,0,0,0,95.00,,
68005,MMC-8G,5,1,4,95.00,,
68006,MMC-BL,0,0,0,95.00,,
68007,MMC-9N,5,2,3,95.00,,
68008,MMC-14HB,0,0,0,111.76,,
68009,MMC-HB,1,1,0,95.00,,
68016,B175C-20-H-MM,2,1,1,825.85,,
68017,B175C-20-HW-MM,2,1,1,1122.73,,
68018,B175C-20-M-MM,1,1,0,933.81,,
68019,B265C-LH-MM,2,0,2,1365.63,,
68020,B175C-0-H-MM,0,0,0,825.85,,
68021,B175C-12-H-MM,0,0,0,825.85,,
68031,B175C-0-HW-MM,0,0,0,1122.73,,
68032,B175C-12-HW-MM,0,0,0,1122.73,,
68033,B175C-0-M-MM,0,0,0,982.39,,
68034,B175C-12-M-MM,1,1,0,923.01,,
68036,B75C-0-H-MM,0,0,0,615.34,,
68037,B75C-12-H-MM,0,0,0,615.34,,
68038,B75C-20-H-MM,2,1,1,615.34,,
68039,B75C-0-M-MM,0,0,0,620.74,,
68040,B75C-12-M-MM,1,0,1,620.74,,
68041,B75C-20-M-MM,2,1,1,620.74,,
68046,7465,0,0,0,42.76,,
68054,TKA01AL,0,0,0,7.24,,
68055,TKA02AL,0,0,0,5.26,,
68057,100102-B,0,0,0,8.33,,
68073,M1708CASE,0,0,0,42.16,,
68074,M4232CASE,0,0,0,93.24,,
68075,M4516CASE,0,0,0,52.78,,
68076,M6316CASE,0,0,0,93.00,,
68078,M180132CASE,2,0,2,65.59,,
68079,M180332CASE,0,0,0,63.16,,
68080,M6385CASE,0,0,0,186.57,,
68081,010-12390-20,0,0,0,56.24,,
68086,DFW4X-6,0,0,0,77.14,,
68089,M77132CASE,0,0,0,101.77,,
68090,M6311CASE,0,0,0,105.95,,
68091,M5916CASE,2,0,2,42.89,,
68092,M5616CASE,1,1,0,63.41,,
68093,M5016CASE,0,0,0,67.78,,
68094,M4916CASE,0,0,0,56.43,,
68097,M9424CASE,1,0,1,54.89,,
68098,342KIT,0,0,0,82.03,,
68099,342KIT2,0,0,0,82.97,,
68100,342KIT3,1,0,1,82.03,,
68102,SCR-24-CC-BZ-10CASE,1,1,0,1749.95,,2540.00
68104,342KIT4,0,0,0,82.97,,
68105,342KIIT5,1,0,1,76.40,,
68106,342KIT6,1,0,1,76.40,,
68107,342KIT7,0,0,0,76.40,,
68110,042KIT,0,0,0,74.27,,
68113,042KIT2,0,0,0,75.21,,
68115,"TB 3001CASE",0,0,0,104.42,,
68120,"TC 2001CASE",0,0,0,78.31,,
68122,"TC 2000CASE",0,0,0,156.62,,
68124,"TS 1001CASE",1,1,0,148.36,,
68125,042KIT3,0,0,0,74.27,,
68126,805QCASE,0,0,0,95.38,,
68127,042KIT4,0,0,0,75.21,,
68128,810QCASE,0,0,0,100.21,,
68129,800QCASE,0,0,0,100.21,,
68130,042KIT5,0,0,0,68.64,,
68131,830CASE,0,0,0,64.49,,
68132,042KIT6,0,0,0,68.64,,
68133,042KIT7,0,0,0,68.64,,
68135,825QCASE,0,0,0,115.01,,
68136,862QCASE,0,0,0,95.53,,
68137,045KIT,0,0,0,74.27,,
68138,861QCASE,0,0,0,95.53,,
68140,815QCASE,0,0,0,131.69,,
68141,850QCASE,0,0,0,129.82,,
68143,412CASE,0,0,0,65.84,,
68144,SAD-1460,5,2,3,293.48,,
68145,045KIT2,0,0,0,75.21,,
68146,045KIT3,0,0,0,74.27,,
68147,045KIT4,0,0,0,75.21,,
68148,045KIT5,0,0,0,68.64,,
68149,045KIT6,0,0,0,68.64,,
68150,045KIT7,0,0,0,68.64,,
68152,340KIT,2,2,0,82.03,,
68156,340KIT2,0,0,0,82.97,,
68158,340KIT3,1,1,0,82.03,,
68160,340KIT4,0,0,0,82.97,,
68163,340KIT5,2,2,0,76.40,,
68165,340KIT6,1,1,0,76.40,,
68167,340KIT7,0,0,0,76.40,,
68169,040KIT,0,0,0,74.27,,
68170,040KIT2,0,0,0,75.21,,
68171,040KIT3,0,0,0,74.27,,
68172,040KIT4,0,0,0,75.21,,
68173,040KIT5,0,0,0,68.64,,
68174,040KIT6,0,0,0,68.64,,
68175,040KIT7,0,0,0,68.64,,
68206,010KIT2,0,0,0,106.48,,
68208,305KIT2,0,0,0,105.47,,
68210,001KIT2,0,0,0,97.47,,
68224,HX400ISCASE,11,2,9,5544.72,,
68244,M180232CASE,0,0,0,64.38,,
68245,M5032CASE,0,0,0,101.11,,
68247,DRS6ANXT,2,1,1,4288.95,,5295.00
68248,CM-CF-CFCASE,9,9,0,109.44,,
68249,270000,31,13,18,18.56,,
68250,270001,27,9,18,16.56,,
68251,270002,24,10,14,23.20,,
68252,270005,8,8,0,29.82,,
68253,270010,15,5,10,46.39,,
68254,270101,7,7,0,13.26,,
68255,270103,28,0,28,23.20,,
68256,270104,224,118,106,29.82,,
68257,270105,37,23,14,9.28,,
68258,270106,15,15,0,9.28,,
68259,270108,4,0,4,11.94,,
68260,270201,13,5,8,53.01,,
68261,270202,16,16,0,72.90,,
68262,270300,56,18,38,11.37,,
68263,270301,37,11,26,15.98,,
68264,270302,50,19,31,19.60,,
68265,270305,40,5,35,24.99,,
68266,300000,5,3,2,6.78,,
68267,101810,3,2,1,11.09,,
68268,101825,0,0,0,26.71,,
68269,101850,0,0,0,49.40,,
68270,103810,0,0,0,15.95,,
68271,103825,1,0,1,37.00,,
68272,103850,0,0,0,66.54,,
68273,105810,1,0,1,19.99,,
68274,105825,0,0,0,54.26,,
68275,105840,0,0,0,79.82,,
68276,703112,4,0,4,9.19,,
68277,2707A,22,12,10,89.68,,
68278,2708A,0,0,0,72.50,,
68279,2710A,4,3,1,106.00,,
68280,2711A,1,0,1,113.83,,
68281,2713A,11,3,8,138.61,,
68282,2720A,18,10,8,146.77,,
68283,2731A,10,4,6,267.73,,
68284,2740A,10,3,7,332.97,,
68285,76080,6,4,2,88.34,,
68286,76090,2,0,2,76.56,,
68287,151225,0,0,0,24.09,,
68288,151250,4,2,2,43.36,,
68289,22150A,0,0,0,531.73,,
68291,22350-R,0,0,0,47.60,,
68292,23050A,0,0,0,611.95,,
68293,23051A,0,0,0,571.16,,
68294,23250-HH,1,0,1,43.51,,
68295,23250-R,0,0,0,40.79,,
68296,23350-R,0,0,0,47.60,,
68298,CM-CG1-CF-00.5CASE,1,1,0,120.00,,
68306,83304002,5,2,3,202.00,,
68366,SS175C-20-HW-MM,0,0,0,1155.11,,
68373,104018,0,0,0,147.89,,
68375,102216,0,0,0,122.11,,
68376,102217,0,0,0,92.83,,
68377,100000,0,0,0,39.32,,
68378,205102,0,0,0,168.94,,
68380,131300,0,0,0,113.29,,
68381,132200,0,0,0,56.29,,
68383,132300,0,0,0,147.89,,
68384,100017,7,2,5,15.19,,
68385,210003,0,0,0,42.03,,
68386,010-11076-03CASE,1,1,0,174.90,,
68387,890017,0,0,0,11.18,,
68388,941014,0,0,0,6.41,,
68389,941015,3,0,3,9.46,,
68390,150110,7,0,7,19.69,,
68391,010-11076-04CASE,4,0,4,112.46,,
68392,156006,2,0,2,39.99,,
68393,156026,0,0,0,56.74,,
68394,941022,0,0,0,4.71,,
68395,151100,3,0,3,185.22,,
68396,010-11076-00CASE,13,2,11,224.93,,
68397,010-11076-01CASE,1,1,0,209.94,,
68398,010-11078-01CASE,12,6,6,206.21,,
68399,"LQ 04506CASE",0,0,0,112.76,167.95,
68400,PS1,1,1,0,211.10,,
68401,PS2,2,0,2,324.88,,
68402,PS3,2,1,1,470.49,,
68403,PS4,1,0,1,609.51,,
68404,SS1,1,1,0,176.22,,
68405,SS2,2,2,0,271.46,,
68406,SS3,1,0,1,397.20,,
68407,SS4,1,1,0,527.68,,
68408,BDCOAX,5,5,0,90.63,,
68409,C50254,0,0,0,532.86,743.75,
68410,RS1,2,2,0,116.10,,
68411,RS2,3,3,0,162.07,,
68412,RS3,2,2,0,220.00,,
68413,C50504,0,0,0,656.47,916.30,
68430,BFGWOV12V,0,0,0,63.29,,
68431,BFGWOV24V,0,0,0,63.29,,
68432,BFGWOV36V,0,0,0,63.29,,
68433,BFGWOV48V,0,0,0,63.29,,
68434,BFGWOV64V,0,0,0,63.29,,
68435,BFGWOV72V,0,0,0,63.29,,
68436,BFGWOVR12V,0,0,0,63.29,,
68437,BFGWOVR24V,0,0,0,63.29,,
68438,BFGWOVR36V,0,0,0,63.29,,
68439,BFGWOVR48V,0,0,0,63.29,,
68440,BFGWOVR64V,0,0,0,63.29,,
68441,BFGWOVR72V,0,0,0,63.29,,
68447,90526,0,0,0,93.39,,
68453,CA-0180,3,2,1,40.11,,
68455,CM-CG1-CF-01.0CASE,1,1,0,125.76,,
68456,210201,2,2,0,5.16,,
68457,210202,5,4,1,5.45,,
68458,220202,3,2,1,11.15,,
68459,210203,2,0,2,5.45,,
68460,220203,4,2,2,11.15,,
68462,210204,0,0,0,6.87,,
68464,210205,0,0,0,6.53,,
68466,210206,0,0,0,6.53,,
68468,210211,2,2,0,5.45,,
68469,210212,4,2,2,5.45,,
68470,220212,3,2,1,11.15,,
68471,210213,3,1,2,5.45,,
68472,220213,6,2,4,11.15,,
68473,222213,0,0,0,50.15,,
68474,210214,0,0,0,6.91,,
68475,220214,0,0,0,14.14,,
68476,210215,0,0,0,6.91,,
68477,220215,0,0,0,14.14,,
68478,210216,0,0,0,6.91,,
68479,220216,0,0,0,14.14,,
68480,"EFC-1 BLUE",1,0,1,21.99,,
68481,"EFC-2 BLUE",0,0,0,39.71,,
68482,"EFC-3 BLUE",9,4,5,31.00,,
68483,"EFC-4 BLUE",0,0,0,51.51,,
68484,M285C-HW-MM,0,0,0,766.48,,
68490,GP2050-08,0,0,0,327.26,,
68497,WS-C25,0,0,0,155.87,,
68498,WS-USB,0,0,0,188.19,,
68509,210221,4,0,4,7.10,,
68510,210222,1,0,1,7.51,,
68511,220222,2,0,2,15.38,,
68512,210223,1,0,1,7.51,,
68513,220223,6,3,3,15.38,,
68515,210224,3,1,2,8.71,,
68516,220224,1,1,0,17.81,,
68517,210225,3,1,2,8.71,,
68518,220225,2,0,2,17.81,,
68519,210226,4,2,2,8.71,,
68520,220226,1,1,0,17.81,,
68521,210227,7,3,4,12.65,,
68523,210233,5,2,3,13.40,,
68524,222233,0,0,0,27.41,,
68525,210234,0,0,0,13.47,,
68526,222234,2,2,0,27.55,,
68527,210235,4,2,2,17.09,,
68528,222235,5,3,2,34.99,,
68529,210236,6,2,4,17.09,,
68530,222236,2,1,1,34.99,,
68531,210237,1,1,0,18.70,,
68534,210244,2,2,0,18.36,,
68536,210245,3,1,2,18.36,,
68538,210246,0,0,0,18.36,,
68539,DRS4DL+,0,0,0,1534.95,,
68545,210247,1,1,0,15.99,,
68555,210257,0,0,0,18.36,,
68557,210301,0,0,0,5.16,,
68558,210302,0,0,0,5.45,,
68559,220302,4,3,1,11.15,,
68560,210303,0,0,0,5.45,,
68561,220303,0,0,0,11.15,,
68562,R111C-LH,0,0,0,2860.80,,
68563,210311,7,0,7,4.49,,
68564,210312,0,0,0,5.45,,
68565,SA-866,6,5,1,14.81,,
68566,220312,3,1,2,11.15,,
68567,210313,0,0,0,5.45,,
68568,220313,0,0,0,11.15,,
68569,210321,0,0,0,7.10,,
68570,210322,4,3,1,7.51,,
68573,220323,0,0,0,15.38,,
68574,210510,5,3,2,17.74,,
68575,210520,3,3,0,19.62,,
68576,210100,3,0,3,4.26,,
68577,220100,5,3,2,8.71,,
68578,222100,0,0,0,39.16,,
68579,210110,4,3,1,4.26,,
68580,220110,7,3,4,8.71,,
68581,222110,0,0,0,39.16,,
68582,210120,3,3,0,6.94,,
68583,220120,5,2,3,14.22,,
68584,222120,0,0,0,68.35,,
68585,CM-CG1-CF-03.0CASE,0,0,0,147.36,,
68587,210161,0,0,0,13.67,,
68589,210162,0,0,0,13.67,,
68590,210163,0,0,0,16.66,,
68591,222161,0,0,0,125.91,,
68592,222162,0,0,0,125.91,,
68593,222163,0,0,0,153.29,,
68594,210164,0,0,0,15.47,,
68595,220164,0,0,0,31.63,,
68597,210165,0,0,0,16.78,,
68598,210166,3,2,1,21.72,,
68614,GPS915,0,0,0,489.30,,
68616,23870-1200,4,2,2,257.41,,
68626,GSE-1939BSA20,3,0,3,224.50,,
68627,NMEA2K1,6,4,2,169.57,,
68636,122200-300-020-18,7,7,0,54.67,,
68637,122200-300-040-18,9,7,2,54.67,,
68638,122200-300-060-18,12,6,6,54.67,,
68639,122200-600-020-18,4,3,1,54.67,,
68640,122200-600-040-18,13,6,7,54.67,,
68641,122200-600-060-18,11,6,5,41.99,,
68649,"G-1-COBALT BLUE",10,0,10,8.99,,
68650,"G-2-COBALT BLUE",9,0,9,9.99,,
68651,"G-3-COBALT BLUE",2,2,0,13.99,,
68652,"G-4-COBALT BLUE",0,0,0,29.17,,
68653,"G-5-COBALT BLUE",5,5,0,40.31,,
68654,CW-376-5M,1,1,0,52.50,,
68655,"G-6-COBALT BLUE",1,1,0,73.59,,
68656,"G-3 COBALT BLUEWO",2,2,0,13.99,,
68657,"G-4-COBALT BLUEWO",0,0,0,28.71,,
68658,"G-5-COBALT BLUEWO",5,5,0,39.99,,
68659,1002013,6,6,0,6.23,,
68660,"G-6-COBALT BLUEWO",1,1,0,73.13,,
68661,1002021,11,6,5,6.49,,
68662,1002022,0,0,0,7.16,,
68663,1002002,6,5,1,5.97,,
68664,1002023,3,3,0,6.17,,
68665,1002010,29,11,18,9.06,,
68666,1002006,3,0,3,10.24,,
68667,1001907,15,5,10,7.30,,
68668,1001903,4,4,0,5.31,,
68669,1001904,10,8,2,5.40,,
68670,1002001,2,0,2,5.56,,
68671,1002015,7,2,5,5.64,,
68672,1002004,6,4,2,5.73,,
68673,1002008,6,0,6,13.15,,
68674,1002007,0,0,0,10.26,,
68675,1002009,10,5,5,10.16,,
68681,1002017,0,0,0,6.37,,
68682,1001905,7,4,3,7.03,,
68683,1002018,6,4,2,6.71,,
68684,1002014,0,0,0,6.71,,
68685,1002012,8,3,5,6.79,,
68686,1002016,45,25,20,10.74,,
68687,1002003,0,0,0,11.31,,
68688,1002011,6,4,2,12.96,,
68689,1002005,0,0,0,11.91,,
68692,M80ATP,1,1,0,897.72,,
68697,1014212,0,0,0,27.47,,
68702,SEC-1212,0,0,0,97.05,140.10,
68712,7608,2,0,2,293.39,,
68716,7151,7,4,3,6.53,,
68717,7152,8,4,4,6.53,,
68718,7153,10,4,6,6.53,,
68719,7154,6,4,2,6.53,,
68720,7155,4,2,2,6.53,,
68721,7156,15,5,10,6.53,,
68722,7157,0,0,0,6.53,,
68723,7160,5,0,5,1.26,,
68729,4180,29,5,24,47.44,,
68730,4181,10,10,0,47.44,,
68731,4230,0,0,0,10.51,,
68733,1842,0,0,0,252.67,,
68734,YBP-0111,4,4,0,29.99,,74.98
68735,242237,3,0,3,8.49,,
68736,012110C,4,3,1,502.17,,
68737,70195,0,0,0,17.64,,
68739,09-703P-1,0,0,0,17.28,,
68740,10-13399-05,0,0,0,123.46,,
68741,10-24188-4,0,0,0,423.25,,
68742,54264PK,0,0,0,6.30,,
68743,54274PK,0,0,0,7.43,,
68745,80-47625-01,0,0,0,137.04,,
68747,80-47626-01,0,0,0,256.79,,
68754,60-100-SV,2,0,2,561.78,688.00,
68758,621-100-SV,1,0,1,561.78,688.00,
68761,ARS-5-H,0,0,0,215.00,264.00,
68763,DDC-12/24,1,0,1,189.03,232.00,
68764,MC-TS-A,14,1,13,31.36,38.99,
68765,MC-TS-B,0,0,0,39.21,47.99,
68768,UBB,3,0,3,58.42,71.99,
68769,UAA,2,0,2,28.01,34.99,
68770,BBU,6,1,5,40.88,50.99,
68772,F16-0204-1,4,3,1,123.82,,
68773,F16-0220-1,1,0,1,72.50,,
68776,F31-3103BXZ-1,4,0,4,159.76,,
68777,F31-3104BXZ-1,0,0,0,213.87,,
68783,L10-1001-1,0,0,0,1650.92,,
68805,2307,30,26,4,19.72,,
68806,3180,14,2,12,20.63,,
68807,3182,0,0,0,13.75,,
68808,3184,0,0,0,40.63,,
68809,3186,0,0,0,40.63,,
68810,3188,4,2,2,40.63,,
68811,3125,4,2,2,7.71,,
68813,MSK-90,0,0,0,335.23,483.80,
68814,MSK-135,1,1,0,394.74,615.00,
68821,SCC-30AB,2,2,0,100.00,144.40,
68833,SCC-1208L,2,2,0,41.59,60.00,
68846,A80470,0,0,0,866.66,,
68852,320,4,0,4,7.07,,
68853,321,0,0,0,7.07,,
68854,322,4,4,0,7.07,,
68855,SRV-100-30A,0,0,0,359.09,518.20,
68856,SRV-150-30A,0,0,0,401.14,578.90,
68859,HC25H2,2,0,2,122.31,,
68882,010-12439-10,3,1,2,9.74,,
68883,010-12439-03,30,14,16,18.74,,
68884,010-12440-10,0,0,0,7.49,,
68885,010-12440-03,0,0,0,14.99,,
68908,010-12671-00,0,0,0,11.24,,
68911,010-12671-01,0,0,0,14.99,,
68912,010-12672-01,0,0,0,14.99,,
68913,010-12673-01,5,0,5,14.99,,
68914,010-12671-02,0,0,0,6.74,,
68915,010-12672-02,0,0,0,6.74,,
68916,010-12673-02,0,0,0,6.74,,
68917,010-12671-03,0,0,0,18.74,,
68918,010-12672-03,0,0,0,41.24,,
68919,010-12672-05,0,0,0,41.24,,
68920,010-12673-03,7,7,0,44.99,,
68924,PP4500-08,0,0,0,276.35,,
68925,200125,3,3,0,38.99,,
68926,200142,0,0,0,83.19,,
68928,2833,6,3,3,35.30,,
68929,30097-005,0,0,0,69.23,,
68930,S600EW,3,2,1,487.71,,
68931,S650E,0,0,0,453.34,,
68932,S700E,3,2,1,522.09,,
68933,S750E,0,0,0,536.49,,
68936,F650,1,0,1,466.33,,
68937,F650W,0,0,0,530.10,,
68938,200825,0,0,0,41.59,,
68939,F750,0,0,0,549.99,,
68940,S300EW,0,0,0,488.90,,
68941,200122,14,5,9,42.99,,
68942,S350EW,0,0,0,503.29,,
68943,S300W,4,2,2,500.13,,
68944,M120ATP,3,1,2,933.78,,
68945,904042ABYC,0,0,0,64.39,,
68946,S650,0,0,0,465.35,,
68947,904043ABYC,0,0,0,67.23,,
68948,S750,0,0,0,547.55,,
68949,904044ABYC,0,0,0,79.77,,
68950,S1200E,2,1,1,595.05,,
68951,904045ABYC,0,0,0,96.87,,
68952,904046ABYC,0,0,0,102.57,,
68953,904048ABYC,0,0,0,141.91,,
68954,F1150,3,1,2,522.59,,
68955,F1150W,0,0,0,564.23,,
68956,F1250,0,0,0,636.51,,
68962,S1150,0,0,0,515.09,,
68964,S1250,3,1,2,611.48,,
68979,74556,25,17,8,21.31,,
68991,CL68M,0,0,0,58.62,,
68992,CL68S,0,0,0,67.83,,
68999,ST16ATP,2,1,1,1224.61,,
69012,RF4880XXL,0,0,0,22.66,,
69037,CL24L,0,0,0,65.69,,
69041,CL24XS,0,0,0,65.69,,
69049,S1150EW-4500,0,0,0,576.60,,
69050,S650EW-3000,0,0,0,509.16,,
69051,WX1599B,8,5,3,137.33,,
69061,XV1-921-2,41,41,0,16.05,22.99,
69064,XV1-967-2,0,0,0,16.05,22.99,
69065,XV1-863-2,1,1,0,10.00,22.99,
69066,XV1-968-2,0,0,0,16.05,22.99,
69067,YBP-3153,23,14,9,8.63,,12.98
69068,PTS-0-5PSI-01,0,0,0,361.60,,
69087,1216DP0CHR,16,6,10,11.92,,
69096,90133,4,0,4,190.00,303.99,
69097,C30503BM30NT,0,0,0,388.53,542.30,
69103,PP5200-14,0,0,0,392.72,,
69107,CA-0127,0,0,0,152.47,,
69109,1710ST-13-75T,0,0,0,420.00,,
69115,33-969-01,0,0,0,306.38,,
69131,385320006,2,2,0,20.52,,
69132,010-12547-00,0,0,0,14.99,,
69133,010-12670-00,0,0,0,11.24,,
69155,A80043,0,0,0,1182.05,,
69160,GS-400,2,2,0,1927.50,,2649.99
69197,CA-0026-MO,0,0,0,212.65,,
69223,3106100,7,0,7,126.30,,
69227,444-442KIT,0,0,0,41.44,,
69228,140402,7,7,0,19.27,,
69229,2365002,0,0,0,5.14,,
69231,AS-LED-NY,7,4,3,30.13,41.99,
69232,AS-LED-RR,4,0,4,30.13,,
69233,AS-LED-BK,0,0,0,30.13,41.99,
69239,A90LBC-BK,4,2,2,15.06,20.99,
69240,A90LBC-NY,0,0,0,15.06,20.99,
69243,IMP-1-BK,1,0,1,8.49,,
69245,ST-NY,2,2,0,30.13,41.99,
69286,010-11053-02,0,0,0,472.49,,
69288,010-00705-64,2,1,1,869.99,,
69293,E70499,3,0,3,328.22,,
69298,A80532,0,0,0,603.25,,
69303,MT-03-10-5,8,0,8,19.99,,
69308,M1-64-8,9,9,0,39.99,,
69311,E70492,1,1,0,868.41,,
69312,M1-63-1,25,24,1,16.38,,
69314,E70493,2,2,0,947.36,,
69315,M1-63,24,19,5,16.38,,
69319,M1-62-8,0,0,0,57.32,,
69325,M1-61-8,0,0,0,55.13,,
69326,M1-61-1,48,25,23,14.94,,
69327,M1-61,0,0,0,14.94,,
69328,FASP3112A1ACA00,0,0,0,129.23,,
69329,FASP453201ACA00,0,0,0,212.72,,
69331,FASP3562X12CA00,0,0,0,564.31,,
69332,FASP1572X12CD00,0,0,0,653.40,,
69335,MHS335BT,332,30,302,124.99,,
69336,UM385,6,6,0,95.37,,
69337,UM385BK,33,18,15,95.37,,
69338,UM435,12,4,8,113.03,,
69339,UM435BK,11,5,6,113.03,,
69340,2401,0,0,0,8.63,,11.98
69344,JP-21405,0,0,0,20.75,,
69346,GP0819,3,3,0,307.06,,
69348,PP1812D,2,2,0,462.00,,539.95
69357,289,0,0,0,4.49,,5.98
69361,940700010,3,1,2,1195.39,,1389.99
69363,940700020,2,1,1,1203.99,,1399.99
69364,940700030,0,0,0,1341.59,,1559.99
69368,PEDRS4600-08-C,0,0,0,545.44,,
69382,940700060,0,0,0,852.26,,
69383,940700070,0,0,0,1066.39,,1239.99
69384,940700080,0,0,0,1074.99,,1249.99
69385,940700100,3,2,1,1289.99,,1499.99
69386,940700120,2,0,2,1410.39,,1639.99
69387,940700130,2,1,1,1418.99,,1649.99
69388,940700140,0,0,0,638.83,,
69389,940700160,0,0,0,749.99,,
69390,940700170,4,2,2,766.60,,
69391,940700180,2,1,1,784.08,,
69392,940700190,4,2,2,980.39,,1139.99
69393,940700200,1,0,1,988.99,,1149.99
69395,940700220,4,2,2,945.99,,1099.99
69396,940800350,0,0,0,1934.99,,2249.99
69397,940800360,2,1,1,2063.99,,2399.99
69399,941600020,3,1,2,1046.50,,
69401,941600040,2,1,1,1135.19,,1319.99
69403,941600060,1,1,0,1461.99,,1699.99
69404,941600070,1,0,1,1539.39,,1789.99
69405,941600080,3,1,2,1547.99,,1799.99
69406,JP-64535,0,0,0,191.36,,
69407,JP-61121,1,0,1,86.42,,
69408,54304PK,0,0,0,9.88,,
69409,54270PK,0,0,0,2.99,,
69411,90281PK,0,0,0,31.19,,
69412,90291PK,0,0,0,11.25,,
69452,M-284-BP,0,0,0,42.02,,
69453,M-284-01-BP,1,0,1,49.52,,
69454,24059-BP,1,0,1,26.12,,
69455,24117-01-BP,2,2,0,35.21,,
69456,M-750-BP,0,0,0,55.51,,
69457,95060-50-BP,0,0,0,33.71,,
69458,9579-BP,10,5,5,18.55,,
69459,M-712-BP,5,2,3,30.37,,
69460,M-850-BP,6,0,6,25.54,,
69461,58328-101-BP,9,3,6,14.91,,
69462,58328-100-BP,6,6,0,11.93,,
69463,58328-103-BP,1,1,0,17.35,,
69464,M-58031-01-BP,11,5,6,13.54,,
69465,M-58031-02-BP,10,5,5,13.49,,
69466,M-58031-04-BP,5,0,5,14.81,,
69467,M-58031-07-BP,4,4,0,13.24,,
69471,82159-02-BP,3,3,0,9.12,,
69472,87167-01-BP,0,0,0,14.47,,
69473,54100-BP,5,5,0,6.76,,
69474,54103-BP,2,0,2,8.36,,
69475,54104-BP,6,0,6,7.99,,
69476,54109-BP,1,1,0,13.62,,
69477,5582-BP,0,0,0,5.63,,
69478,55014-BP,0,0,0,5.64,,
69479,5586-BP,3,0,3,7.17,,
69480,55021-BP,1,1,0,9.31,,
69481,55021-07-BP,4,4,0,14.81,,
69482,5592-BP,17,10,7,10.65,,
69483,55054-BP,8,7,1,15.38,,
69484,M-54111-01-BP,9,5,4,14.88,,
69485,M-54111-02-BP,13,5,8,15.47,,
69486,81255-BP,0,0,0,6.09,,
69487,81264-01-BP,6,3,3,6.19,,
69489,90030-BP,0,0,0,8.57,,
69490,M-608-BP,0,0,0,17.87,,
69491,SP5104,1,1,0,128.09,,
69492,M-606-BP,4,0,4,17.15,,
69493,SP5105,1,0,1,120.71,,
69494,M-628-BP,0,0,0,15.64,,
69495,SP5102,4,1,3,128.09,,
69496,M-527-BP,0,0,0,16.17,,
69497,M-531-BP,5,5,0,27.92,,
69498,M-532-BP,7,1,6,29.83,,
69500,11172-BP,4,1,3,4.99,,
69501,11173-BP,0,0,0,9.88,,
69503,INFBC4,3,3,0,68.69,99.95,
69521,LLB-53BK-01-00,2,2,0,184.39,,
69525,910R2PB-7,5,5,0,11.29,,
69526,910R2PSB-7,9,7,2,15.80,,
69528,910R3PSB-7,5,0,5,16.04,,
69529,910T2PB-7,8,4,4,12.97,,
69533,910V2PB-7,0,0,0,14.29,,
69544,1212ATP,4,2,2,868.51,,
69545,S2-0820,1,0,1,168.33,,
69546,129ATP,3,1,2,858.72,,
69551,PED4600-08-C,0,0,0,305.44,,
69552,GP1200-13,0,0,0,363.62,,
69555,817-3000,11,8,3,874.81,,
69562,3031-P,0,0,0,17.64,,
69564,92861,9,6,3,80.34,,
69565,92828,10,0,10,98.91,,
69566,92814,3,0,3,107.25,143.58,
69567,92820,6,3,3,125.59,168.13,
69568,GP1040-05,0,0,0,334.53,,
69573,7463,0,0,0,42.76,,
69576,SK11,0,0,0,145.44,,
69578,M1-519-4,45,25,20,1.68,,
69579,M1-62-1,0,0,0,22.54,,
69580,M1-63-8,1,1,0,48.56,,
69586,M5-10-271-8,32,22,10,21.47,,
69588,37-20-101-20,26,6,20,19.74,,
69589,F7-730,0,0,0,8.74,,
69605,90845,2,2,0,15.99,,
69606,7461,0,0,0,42.76,,
69607,7464,0,0,0,42.76,,
69608,7466,0,0,0,48.16,,
69609,7467,0,0,0,48.16,,
69611,9380,0,0,0,43.23,,
69630,A80492,0,0,0,98.00,,
69634,HE-FMTL1,12,9,3,25.85,,
69655,010-11156-01,0,0,0,34.99,,
69657,010-11351-30,0,0,0,33.74,,
69658,010-11053-01,0,0,0,599.99,,
69662,PP5200-02,0,0,0,392.72,,
69663,PP5200-02-C,0,0,0,392.72,,
69664,PP5200-13,0,0,0,392.72,,
69665,PP5200-14-C,0,0,0,392.72,,
69666,PP4500-09,0,0,0,276.35,,
69667,PP4600-06,0,0,0,305.44,,
69668,PP4400-09,0,0,0,269.08,,
69694,C7-10-17,0,0,0,4.68,,
69696,210023,0,0,0,240.74,385.19,
69698,910213,0,0,0,212.43,339.89,
69699,FLB31503S120A00,0,0,0,1063.59,,
69700,FLB32003S120A00,0,0,0,1118.04,,
69701,HE-H11LED,6,4,2,62.04,,
69702,HE-TL1,0,0,0,27.15,,
69703,A80496,1,1,0,55.39,,
69705,EZ36-W,0,0,0,19.18,,
69706,EZ48-W,2,0,2,21.93,,
69707,EZ22-W,0,0,0,21.93,,
69709,010-12165-00,0,0,0,14.99,,
69710,BOLT612ED,3,2,1,404.55,,
69711,HE-DR8,0,0,0,82.09,,
69714,HE-DR14,0,0,0,131.85,,
69715,HE-TR10,0,0,0,124.55,,
69716,HE-TR20,0,0,0,210.17,,
69720,HE-TR50,1,0,1,467.05,,
69721,HE-DR22,0,0,0,168.05,,
69722,HE-DR30,0,0,0,253.37,,
69723,HE-DR42,0,0,0,294.73,,
69725,HE-DR50,0,0,0,338.68,,
69727,HE-DRC42,0,0,0,374.88,,
69730,HE-BDR8,0,0,0,84.67,,
69732,HE-BDR22,0,0,0,191.32,,
69733,HE-BDR30,0,0,0,275.34,,
69734,HE-BDR42,0,0,0,315.41,,
69735,HE-BDR50,1,0,1,354.82,759.00,
69741,HE-SL550,1,0,1,65.79,,
69742,HE-SL914,0,0,0,82.09,,
69743,HE-SL2014,6,2,4,119.26,,
69744,HE-SL32,0,0,0,180.98,,
69745,HE-SL3912,0,0,0,213.94,,
69746,PH1800-GFP,3,2,1,795.38,,
69747,HE-SL5034,0,0,0,267.59,,
69748,HE-HCL22PK,0,0,0,140.90,,
69749,HE-HCL2,0,0,0,56.88,,
69750,20036,8,3,5,15.05,,
69759,HE-HCL2S2PK,1,1,0,144.43,,
69760,HE-CL3,2,2,0,53.00,,
69761,HE-CL32PK,0,0,0,148.66,,
69762,2373101,9,4,5,9.64,,
69765,HE-DL1,3,1,2,49.30,,
69766,HE-FMDL1,3,3,0,44.76,,
69767,HE-DL2,0,0,0,53.51,,
69768,HE-WL1,2,2,0,40.22,,
69770,HE-MDR8,4,2,2,76.91,,
69771,HE-MDR14,2,0,2,133.09,,
69772,HE-MDRC30,4,4,0,273.84,,
69773,HE-MDRC42,5,2,3,343.32,,
69779,HE-MCL2,0,0,0,58.28,,
69783,HE-MFMCL2,1,1,0,53.80,118.00,
69784,HE-MFMCL3,0,0,0,66.99,,
69785,HE-4MLRGBK,2,2,0,136.38,,
69786,HE-8MLRGBK,0,0,0,244.96,,
69787,HE-ML1,0,0,0,27.79,,
69788,HE-ML1RGB,10,6,4,24.56,,
69789,HE-ML1DIV,13,3,10,3.43,,
69790,HE-ML1B,0,0,0,36.20,,
69791,HE-ML1G,0,0,0,36.20,,
69793,HE-TL1B,0,0,0,36.20,,
69794,HE-TL1G,0,0,0,32.32,,
69795,HE-TL1R,0,0,0,36.20,,
69796,HE-TL1DIV,0,0,0,3.70,,
69797,HE-4TLRGBK,0,0,0,136.38,,
69798,HE-8TLRGBK,5,2,3,244.96,,
69799,HE-PTRGB,10,3,7,3.43,,
69807,010-12677-00,0,0,0,127.50,,
69808,010-12676-00,0,0,0,299.99,,
69809,010-12676-10,0,0,0,97.49,,
69810,A2K-SBN-1,0,0,0,64.27,,
69823,DE96255F,12,0,12,19.67,,
69826,NV2002PB-7,0,0,0,29.96,,
69827,NV2002SS-7,8,2,6,36.43,,
69828,NV2012PBR-7,10,5,5,24.13,,
69829,NV2012PBG-7,2,0,2,24.13,,
69830,NV2012SSR-7,12,2,10,32.49,,
69831,NV2012SSG-7,18,7,11,32.49,,
69832,NV3012SSR-7,14,6,8,31.55,,
69833,NV3012SSG-7,10,5,5,31.55,,
69834,NV4012SSR-7,8,1,7,32.17,,
69835,NV4012SSG-7,1,1,0,32.17,,
69838,NV6LC1-14A7,11,8,3,33.21,,
69839,NV6LC2-10-7,9,6,3,39.37,,
69847,010-12100-00,0,0,0,23.99,,
69850,010-10646-02,0,0,0,6.39,,
69852,2445-7,6,6,0,6.21,,
69853,2449-7,6,2,4,6.21,,
69859,6244-6,10,8,2,11.12,,
69869,7571L7,15,1,14,4.99,,
69870,ZDIGDTV200,3,2,1,232.46,,
69871,HE-9006LED,3,1,2,60.52,,
69872,HE-BFMCL2,0,0,0,65.28,,
69873,11478-7,4,2,2,26.39,,
69876,2027-7,27,16,11,3.69,,
69878,1364A3,21,15,6,18.74,,
69879,14348-6,16,5,11,6.49,,
69880,6522SS7,2,1,1,112.26,,
69882,HX40,258,132,126,89.99,,
69908,EXPLORERNAVPROWIFI,3,3,0,629.30,,
69909,EXPLORERNAVPROWIFIW,1,0,1,811.30,,
69915,ACC-FF-1543,0,0,0,11.88,,
69920,101413,0,0,0,794.70,,
69921,101414,0,0,0,821.68,,
69922,101415,0,0,0,794.70,,
69923,101416,0,0,0,813.69,,
69924,101515,35,18,17,418.80,,
69925,101511,56,42,14,199.52,,
69926,101510,43,29,14,244.90,,
69929,165T-TM54,0,0,0,1688.89,,
69939,601513,0,0,0,81.25,129.99,
69940,122400,5,5,0,5.77,,
69941,122850,7,1,6,4.94,,
69943,460000,2,2,0,9.64,,
69944,17-1502-23,0,0,0,72.22,,
69945,C12,4,2,2,82.82,,
69946,C35,6,5,1,88.08,,
69947,C40,5,2,3,124.89,,
69948,C60,33,18,15,135.76,,
69949,CM/R-50,6,3,3,72.31,,
69950,941700170,3,1,2,2192.99,,2549.99
69952,AIR-331-029-02,0,0,0,72.73,,
69954,F11-0177S-1,0,0,0,20.31,,
69955,F11-0180S-1,2,0,2,21.28,,
69956,33749,2,0,2,105.65,,
69957,33839,7,5,2,108.79,,
69960,F11-1001AS-1,0,0,0,25.78,,
69961,F12-0181S-1,8,2,6,19.18,,
69963,F13-0241/244BN-1,7,3,4,25.73,,
69964,F13-0242/244BN-1,6,2,4,26.51,,
69965,F13-0301/244BN-1,6,3,3,28.35,,
69966,F13-0244BN-1,18,6,12,10.60,,
69967,PP4102,0,0,0,239.99,,
69968,0795DP0BLK,9,7,2,23.03,,
69969,0795DP0WHT,1,0,1,23.03,,
69970,8521DPC,8,3,5,52.67,,
69971,8521DP0KEY,2,2,0,3.96,,
69972,8521DP,2,2,0,34.99,,
69974,9621DPC,5,5,0,42.64,,
69975,9621DP,0,0,0,38.03,,
69976,0541DPGCHR,1,1,0,42.67,,
69977,0542DPGBLK,10,4,6,27.80,,
69978,0543DPGBLK,7,3,4,27.80,,
69979,0590DPGCHR,10,5,5,66.35,,
69980,0591DPGCHR,6,0,6,66.35,,
69982,SD0047,28,28,0,33.96,,
69987,14601,0,0,0,26.04,,
69994,81300100,0,0,0,369.34,,
69995,45513000,5,2,3,288.81,,
69996,131906000,5,2,3,545.48,,
69998,LLB-51M1-81-00,0,0,0,93.90,,
69999,LLB-61WO-81-00,0,0,0,93.90,,
70001,F7-51,0,0,0,12.06,,
70003,M1-2A-13-1,34,11,23,17.13,,
70004,M1-63-7,0,0,0,28.50,,
70005,M1-64,0,0,0,20.38,,
70013,20080011,0,0,0,490.00,,
70023,119902,0,0,0,169.72,,
70024,119502,8,3,5,169.72,,
70049,SF200G,4,0,4,350.00,474.95,
70052,BFGWOM1512V/12V,0,0,0,98.29,,
70053,BFGWOM1524V/12V,2,2,0,98.29,,
70054,BFGWOM1536V/12V,1,1,0,98.29,,
70055,2000030727,11,6,5,67.65,,
70056,PLAB88140,0,0,0,46.19,,
70057,PLAM80700,0,0,0,112.19,,
70078,432-0012-08-00,0,0,0,60479.84,,
70079,432-0012-04-00,0,0,0,72576.61,,
70095,101516,33,27,6,275.93,,
70097,33851,6,4,2,94.74,,
70098,101459,7,4,3,201.88,,
70099,101460,12,1,11,250.10,,
70100,101456,8,2,6,107.67,,
70101,101457,6,3,3,107.67,,
70103,101525,7,2,5,1095.70,,
70104,101526,9,6,3,299.23,,
70105,101520,0,0,0,106.18,,
70106,101521,2,0,2,130.88,,
70107,101522,0,0,0,130.88,,
70108,101532,5,2,3,107.91,,
70113,SCR-16-BW-BZ-10,2,0,2,286.52,,449.00
70114,SCR-16-UB-BZ-10,0,0,0,318.99,,449.00
70115,SCR-16-GW-BZ-10,1,0,1,286.52,,449.00
70116,SCR-16-BB-BZ-10,1,1,0,318.99,,449.00
70117,SCR-16-AG-BZ-10,0,0,0,318.99,,449.00
70118,SCR-16-CR-BZ-10,0,0,0,318.99,,449.00
70119,SCM-DL-CC,2,2,0,83.26,,116.00
70122,SCM-DL-GW,2,2,0,62.92,,98.00
70123,4160,103,0,103,17.24,,
70124,4161,3,0,3,17.24,,
70125,4162,4,4,0,17.24,,
70126,4163,9,4,5,17.24,,
70131,980960011,0,0,0,63.29,,
70132,010-C1157-00,0,0,0,262.49,,
70133,980960001,0,0,0,63.29,,
70139,010-12110-04,15,0,15,8.00,,
70141,010-11932-01,0,0,0,7.69,,
70142,TD9122,0,0,0,74.87,,
70144,CLIP-TWNDRP,0,0,0,116.42,,
70145,CA76313,0,0,0,14.58,,
70146,CA76312,48,33,15,10.00,,
70147,CA76311,0,0,0,14.58,,
70148,CA76310,0,0,0,10.00,,
70149,TR7,9,5,4,737.64,,
70150,"TR7 SSP",5,5,0,50.80,,
70151,TR5,4,4,0,509.55,,
70152,"TR5 SSP",2,1,1,51.72,,
70154,1030,18,8,10,11.39,,
70155,1031,14,14,0,10.99,,
70156,1032,8,4,4,11.39,,
70157,1033,0,0,0,21.66,,
70158,1034,7,7,0,21.66,,
70159,1035,4,4,0,21.66,,
70160,1036,10,10,0,21.66,,
70161,1052,13,1,12,9.39,,
70162,1055,10,2,8,9.39,,
70163,1169,5,1,4,18.49,,
70164,1170,0,0,0,18.49,,
70165,1171,3,3,0,18.49,,
70166,1172,5,5,0,15.97,,
70167,1173,2,0,2,15.97,,
70168,1150,2,0,2,12.99,,
70169,2310,0,0,0,15.92,,
70170,2311,1,1,0,7.62,,
70171,1151,16,12,4,15.33,,
70172,3150,0,0,0,22.50,,
70173,3174,0,0,0,8.86,,
70174,1152,0,0,0,15.33,,
70175,3207,1,0,1,21.86,,
70176,3462,1,1,0,6.23,,
70177,1160,1,0,1,9.92,,
70178,3856,2,0,2,24.43,,
70180,4220,0,0,0,5.54,,
70181,4376,0,0,0,102.21,,
70182,1161,0,0,0,9.92,,
70183,4547,0,0,0,3.75,,
70184,1162,8,0,8,8.57,,
70185,1140,0,0,0,7.71,,
70186,4611,0,0,0,19.93,,
70187,1141,17,17,0,7.71,,
70188,1142,27,2,25,7.71,,
70189,2185,9,0,9,5.21,,
70190,1063,2,0,2,17.41,,
70191,1064,20,7,13,39.78,,
70192,1065,0,0,0,67.11,,
70194,5347,0,0,0,22.85,,
70195,5953,0,0,0,39.86,,
70196,6915,1,0,1,28.29,,
70197,6980,0,0,0,52.23,,
70198,7037,0,0,0,15.23,,
70199,7068,0,0,0,23.70,,
70200,7278,0,0,0,20.57,,
70201,BP1020,0,0,0,3.93,,
70202,BP1055,0,0,0,4.97,,
70203,BP1129,0,0,0,40.50,,
70204,BP1130,0,0,0,24.43,,
70205,BP1346,0,0,0,4.45,,
70206,BP170,0,0,0,4.03,,
70208,BP228S,0,0,0,21.00,,
70209,BP255,1,0,1,7.86,,
70210,BP275S,0,0,0,39.21,,
70212,DRAIN,0,0,0,3.49,,
70213,FTR13201,0,0,0,51.33,,
70214,FTR13202,0,0,0,18.00,,
70215,FTR3301,2,2,0,26.36,,
70216,FTR3302,0,0,0,20.08,,
70217,FTR41,3,1,2,7.62,,
70218,SPR-8-AM,0,0,0,331.31,,
70222,V9124,5,3,2,21.99,,
70228,P90006,0,0,0,24.43,,
70229,P90007,0,0,0,24.43,,
70230,RC01C,0,0,0,11.18,,
70232,SET0003,0,0,0,30.86,,
70234,SET0187,1,0,1,16.86,,
70235,SP0037,0,0,0,3.60,,
70238,HS37N,0,0,0,21.29,,
70239,SP0262,0,0,0,2.14,,
70242,P100083,0,0,0,23.79,,
70243,P100087,2,0,2,24.00,,
70245,SP0288,0,0,0,2.36,,
70251,SP0428,0,0,0,2.66,,
70254,SP0468,0,0,0,8.31,,
70255,SP0474,0,0,0,2.16,,
70256,RS100,4,2,2,44.99,,
70257,SP0484,0,0,0,4.85,,
70258,SP0622,7,7,0,3.09,,
70259,P100807,0,0,0,84.21,,
70261,SP0708,0,0,0,4.85,,
70262,SP0717,0,0,0,6.92,,
70263,P101526,0,0,0,40.50,,
70264,SP0721,0,0,0,4.85,,
70265,P101543,0,0,0,20.77,,
70266,SP0722,0,0,0,6.23,,
70267,SP0740,0,0,0,4.85,,
70268,SP0846,0,0,0,7.62,,
70269,SP0871,0,0,0,5.54,,
70270,SP0878,1,0,1,7.62,,
70275,SP4155,0,0,0,40.50,,
70276,US001,0,0,0,12.46,,
70277,US002,0,0,0,12.46,,
70279,US003,0,0,0,12.46,,
70280,US004,0,0,0,4.85,,
70282,ZE050,0,0,0,17.31,,
70283,ZE125,0,0,0,17.31,,
70284,ZE160,0,0,0,17.31,,
70285,ZE200,0,0,0,17.31,,
70286,P101550,2,0,2,42.43,,
70287,P102837,0,0,0,21.86,,
70288,ZE300,0,0,0,18.00,,
70289,ZE500,0,0,0,17.31,,
70290,P104704,2,0,2,18.00,,
70291,P104750,0,0,0,39.75,,
70292,P104897,2,0,2,36.00,,
70293,P90003,0,0,0,31.50,,
70294,P90004,0,0,0,31.50,,
70295,P90005,0,0,0,32.14,,
70298,SPR-8-RM,1,0,1,314.44,,
70299,1061,0,0,0,164.62,,
70300,500620,0,0,0,409.85,,
70301,500621,14,0,14,444.76,,
70340,55106100,0,0,0,547.41,,
70352,570-002,0,0,0,106.83,,
70363,ZDIGSTN,3,2,1,157.46,,
70373,MVP-J-G-XL,0,0,0,175.50,,
70376,RC8812VEDC,0,0,0,1417.76,2009.00,
70377,FBNRP0140FR0A00,0,0,0,171.57,,
70378,FBNRP0250FR0A00,0,0,0,215.67,,
70379,FBNRP0300FR0A00,0,0,0,278.88,,
70380,FBNRP0500FR0A00,0,0,0,412.65,,
70381,FBNRP0700FR0A00,0,0,0,957.60,,
70383,FBNRP1100FR0A00,0,0,0,1265.25,,
70384,FBNRP1200FR0A00,0,0,0,1526.41,,
70403,TW5M14500JV,4,4,0,35.48,,
70411,41011,0,0,0,24.86,,
70417,28522000,0,0,0,655.40,,
70418,70405080,0,0,0,42.55,,
70419,540-0000-7,2,0,2,21.65,,
70420,540-0100-7,8,0,8,21.65,,
70422,540-0101-7,0,0,0,21.65,,
70432,2362001,0,0,0,6.00,,
70435,119510,0,0,0,621.13,,
70436,119910,0,0,0,621.13,,
70439,010-12770-00,8,0,8,22.49,,
70440,SHC-29,29,19,10,10.40,,
70441,165T-50/200-SS260,2,1,1,2666.67,,
70442,165T-50/200-TM260,1,1,0,2044.44,,
70443,165T/265LH-PM488,0,0,0,3111.11,,
70450,322313,2,2,0,345.00,551.99,
70457,LTB1,7,3,4,283.25,,
70463,120313,4,1,3,489.25,782.79,
70468,980503221,2,2,0,25.32,,
70472,TW5M09500JV,0,0,0,32.25,,
70478,OCTOIL1USQ,17,11,6,13.93,,
70495,GK1512,0,0,0,395.35,,
70499,T42571JV,99,99,0,26.88,,
70507,T71912XY,0,0,0,14.51,,
70513,BBTG0920001,1,1,0,30.00,,
70514,010-12719-00,7,3,4,18.74,,
70521,"GB44 0101",5,2,3,122.37,,
70522,"GB150 0100",5,5,0,126.32,,
70523,"BGR20 0101",0,0,0,131.59,,
70525,STC1000301,3,2,1,41.67,,
70529,92306,100,18,82,148.36,196.76,
70543,RC8824V,0,0,0,1334.09,1823.00,
70550,010-12381-00,12,0,12,17.04,,
70551,43001,0,0,0,96.41,,
70552,IRID-BM-9575PD,0,0,0,815.22,,
70569,SC113,0,0,0,255.38,,
70573,90122,7,4,3,190.00,303.99,
70574,90144,0,0,0,190.00,303.99,
70584,2060366,4,4,0,73.69,,
70591,1196,14,14,0,29.99,,
70592,1137,1,1,0,12.99,,
70593,1190,10,3,7,14.43,,
70594,1102,10,10,0,9.06,,
70600,RF41300,2,2,0,49.95,76.42,
70601,RF41310,0,0,0,54.95,84.07,
70602,RF41171,0,0,0,29.44,45.05,
70603,RF41500,0,0,0,31.40,48.03,
70604,RF41510,0,0,0,33.53,51.31,
70605,RF41520,0,0,0,66.37,101.55,
70606,RF41530,0,0,0,68.51,104.82,
70607,RF41811,0,0,0,52.81,80.80,
70608,RF41821,0,0,0,46.67,71.40,
70609,RF41831,0,0,0,55.65,85.16,
70611,RF40101,0,0,0,16.05,24.56,
70612,RF40100HL,0,0,0,33.72,51.58,
70613,RF40110,0,0,0,26.04,39.84,
70614,RF40111,0,0,0,22.48,34.39,
70615,RF40171,3,1,2,33.72,51.58,
70616,RF40200,0,0,0,44.25,67.69,
70617,RF40210,0,0,0,47.81,73.15,
70618,RF40300,0,0,0,54.23,82.98,
70619,RF40310,0,0,0,59.95,91.72,
70620,RF40500,0,0,0,35.68,54.59,
70621,RF40510,0,0,0,38.53,58.95,
70622,RF40520,0,0,0,58.52,89.53,
70623,RF40530,0,0,0,60.65,92.80,
70624,RF45130,1,1,0,59.95,91.72,
70625,RF45140,1,0,1,26.39,45.85,
70626,RF45151,0,0,0,19.98,30.56,
70629,545613,0,0,0,450.00,719.99,
70630,545513,2,0,2,450.00,719.99,
70635,245513,1,1,0,317.76,574.99,
70636,245213,0,0,0,359.37,574.99,
70660,R70561,1,1,0,42.60,,
70661,LLB-26KC-21-00,2,2,0,6.99,,
70662,LLB-26KW-21-00,0,0,0,11.08,,
70670,90519,12,0,12,33.44,,
70671,91109,9,2,7,10.13,,
70672,13002,5,0,5,19.99,,
70674,544613,0,0,0,450.00,719.99,
70679,RF51111,0,0,0,30.20,46.76,
70680,RF51140,1,1,0,30.68,46.94,
70681,RF51151,0,0,0,33.31,50.96,
70682,RF51171,0,0,0,32.02,48.99,
70683,RF51200,7,6,1,46.58,71.27,
70684,RF51210,0,0,0,57.78,88.40,
70685,RF51300,2,0,2,66.11,101.15,
70686,RF51500,0,0,0,40.68,62.23,
70687,RF51510,0,0,0,44.96,68.78,
70688,RF51530,0,0,0,80.80,123.63,
70689,RSB0071-057A,0,0,0,1577.78,,
70690,209-1268-00,0,0,0,60.19,,
70691,118510,0,0,0,544.44,,
70692,DT820PV-235-N2,1,0,1,284.90,,
70701,RF56110,0,0,0,54.23,82.98,
70702,RF56120,0,0,0,99.73,152.58,
70703,EC-HP-DB-3G/4G,1,1,0,2119.00,,
70704,RF56130,0,0,0,105.00,160.65,
70705,RF56151,0,0,0,50.95,77.95,
70706,RF56151A,0,0,0,50.95,77.95,
70708,RF56510,4,4,0,59.20,90.57,
70715,000-0124-64,0,0,0,25.79,,
70729,199114,0,0,0,41.15,,
70730,303SSEL-BXPK,0,0,0,62.30,,
70733,000-154-025,0,0,0,181.82,,
70738,S-0601,0,0,0,241.95,,
70739,S-0600,0,0,0,178.66,,
70740,60756,0,0,0,43.43,,
70741,60748,0,0,0,15.26,,
70742,60750,0,0,0,18.04,,
70743,60752,0,0,0,23.43,,
70744,60754,0,0,0,32.73,,
70745,6147,0,0,0,28.00,,
70746,6169,0,0,0,26.09,,
70747,S-5001,0,0,0,8.59,,
70748,S-5001B,0,0,0,10.25,,
70749,S-5002,0,0,0,12.29,,
70750,S-5002B,4,1,3,15.51,,
70751,"CS 02902",33,31,2,3.26,5.95,
70752,S-5003,0,0,0,14.32,,
70753,S-5003B,2,2,0,18.11,,
70754,"CS 02908",8,3,5,14.79,20.95,
70755,6170,4,2,2,27.65,,
70756,S-5010,3,3,0,20.95,,
70757,S-5011,5,3,2,33.18,,
70766,990-35,0,0,0,126.75,,
70767,992-35,1,1,0,113.05,,
70769,119010,0,0,0,621.13,,
70770,F16-0039,22,4,18,27.53,,
70772,16023,6,6,0,28.38,,
70777,49012,9,3,6,21.25,33.99,
70778,261113,0,0,0,135.62,216.99,
70781,32834,3,2,1,113.29,,
70783,RF20141,0,0,0,13.56,20.73,
70784,A80309,3,1,2,55.39,,
70785,A80369,0,0,0,79.16,,
70786,RF20281,0,0,0,23.54,36.02,
70787,RF20284,0,0,0,17.12,26.19,
70789,RF20184,0,0,0,12.48,,
70790,RF20174,0,0,0,24.26,37.11,
70791,RF20175,0,0,0,45.12,69.04,
70792,RF613S,0,0,0,4.78,,
70794,010-12776-00,0,0,0,198.74,,
70795,010-12776-10,0,0,0,629.98,,
70796,010-12776-11,0,0,0,974.99,,
70801,010-02055-00,0,0,0,472.49,,
70803,112000,0,0,0,28.27,,
70804,H2183-10,0,0,0,574.86,,
70806,010-12721-00,0,0,0,18.74,,
70808,115503,0,0,0,31.81,,
70809,WS-C10,0,0,0,103.69,,
70810,WS2-C06,1,0,1,73.07,,
70816,TPA3012,2,0,2,141.78,,
70832,134900,0,0,0,31.81,,
70833,135010,0,0,0,38.89,,
70835,RF572,2,2,0,9.99,19.09,
70837,RF2332,0,0,0,16.90,25.86,
70839,395010,16,11,5,20.62,,
70841,395210,8,8,0,35.34,,
70842,791502,0,0,0,80.43,,
70843,723300,0,0,0,55.68,,
70844,723700,1,1,0,61.86,,
70846,135402,0,0,0,28.27,,
70847,737002,0,0,0,61.86,,
70848,758005,0,0,0,63.63,,
70852,B765C-LH-MM,0,0,0,874.43,,
70853,147000,13,4,9,38.89,,
70854,144402,1,0,1,42.41,,
70855,613403,6,6,0,38.06,,
70856,759201,4,1,3,80.43,,
70857,797010,0,0,0,93.16,,
70870,104100,0,0,0,6.92,,
70871,105000,23,4,19,5.92,,
70872,106100,2,0,2,9.88,,
70873,107000,0,0,0,9.88,,
70874,171301,0,0,0,7.20,,
70875,171502,0,0,0,9.64,,
70876,321309,4,4,0,8.10,,
70877,321508,2,2,0,16.07,,
70878,321407,0,0,0,7.20,,
70879,341406,11,6,5,7.20,,
70880,350304,0,0,0,9.00,,
70881,350500,0,0,0,9.64,,
70882,350400,0,0,0,9.00,,
70883,344922,10,7,3,7.20,,
70884,345023,0,0,0,9.00,,
70885,350022,0,0,0,7.50,,
70886,351001,2,2,0,6.92,,
70888,358200,6,6,0,12.00,,
70889,358300,3,3,0,15.00,,
70890,358400,0,0,0,21.00,,
70891,2373121,40,40,0,12.86,,
70892,2373130,13,13,0,12.86,,
70893,2361000,6,0,6,7.20,,
70894,708020,6,6,0,28.93,,
70896,370800,0,0,0,9.64,,
70897,361610,0,0,0,7.07,,
70898,371610,4,4,0,9.64,,
70899,344840,0,0,0,3.75,,
70900,344860,6,0,6,4.50,,
70901,344985,3,3,0,4.50,,
70902,345046,0,0,0,5.25,,
70904,345028,0,0,0,6.30,,
70905,2360600,2,2,0,5.54,,
70907,2361301,0,0,0,5.54,,
70909,367000,0,0,0,9.64,,
70910,377000,0,0,0,11.57,,
70911,377100,0,0,0,11.57,,
70912,2371304,0,0,0,7.71,,
70913,2360100,112,53,59,5.14,,
70914,2363001,0,0,0,6.43,,
70916,2370100,3,2,1,8.36,,
70917,2370500,0,0,0,5.14,,
70918,2371500,4,0,4,5.14,,
70920,436200,0,0,0,8.36,,
70921,437000,0,0,0,9.64,,
70922,437300,0,0,0,11.57,,
70931,360704,0,0,0,12.46,,
70932,360706,0,0,0,12.46,,
70933,360707,1,1,0,13.85,,
70934,370704,0,0,0,12.86,,
70935,370705,3,3,0,12.86,,
70936,370707,4,0,4,12.86,,
70938,370708,0,0,0,12.86,,
70941,010-12753-00,1,0,1,19.56,,
70947,2361200,0,0,0,5.54,,
70967,011204WW,0,0,0,279.53,,
70968,011203W,0,0,0,279.53,,
70980,619,5,0,5,27.99,,
70981,916,0,0,0,10.53,,
70983,984,35,15,20,19.08,,
70989,927,0,0,0,17.11,,
70991,963,1,1,0,15.99,,
70992,964,2,0,2,37.11,,
70993,965,5,0,5,39.99,,
70994,844,0,0,0,65.13,,
70995,942,0,0,0,12.63,,
70997,840,0,0,0,25.99,,
70998,841,3,1,2,63.68,,
71010,B285C-HW-MM,0,0,0,1149.72,,
71019,RF15100,0,0,0,13.72,20.98,
71020,RF15101,5,0,5,7.83,,
71021,RF15111,0,0,0,9.27,,
71022,RF15141,0,0,0,12.12,,
71023,RF15151,0,0,0,9.99,,
71024,RF15171,0,0,0,13.56,20.73,
71025,RF15174,0,0,0,23.90,36.57,
71026,RF15180,0,0,0,16.05,24.56,
71027,RF15202,0,0,0,15.56,23.80,
71028,RF15212,0,0,0,17.22,26.35,
71029,RF15302,0,0,0,21.77,33.29,
71030,RF15312,0,0,0,23.90,36.57,
71031,RF15711,0,0,0,20.33,31.11,
71032,63407,0,0,0,35.70,,
71033,63410,0,0,0,73.36,,
71034,60175,0,0,0,14.66,,
71035,60176,0,0,0,13.74,,
71037,60177,0,0,0,14.66,,
71038,60178,0,0,0,13.74,,
71039,60179,0,0,0,14.64,,
71044,68900,0,0,0,190.49,,
71045,68902,0,0,0,197.41,,
71046,68904,0,0,0,224.49,,
71047,68906,0,0,0,244.41,,
71053,S-1850,1,1,0,72.95,,
71054,S-1852,2,2,0,92.01,,
71055,S-1854,3,2,1,125.86,,
71056,62-541-MARINE-BL,0,0,0,49.94,,
71057,62-541-R-MARINE-BL,0,0,0,52.44,,
71058,62-542-R-MARINE-BL,0,0,0,52.44,,
71060,RF4055,38,27,11,55.53,84.96,
71061,RF4055A,86,67,19,55.53,84.96,
71062,RF4055B,58,40,18,55.53,84.96,
71063,547,0,0,0,85.00,,
71066,SH-0126-200,0,0,0,14.79,,
71069,CA-0147,5,3,2,12.07,,
71071,S-0232C,0,0,0,14.39,,
71072,P-2400,0,0,0,5.57,,
71073,P-2401,2,0,2,6.46,,
71074,P-2402,1,1,0,16.76,,
71075,P-0440B,9,1,8,20.78,,
71076,P-0441B,6,4,2,24.00,,
71077,P-0442B,7,5,2,31.14,,
71078,P-0440,44,15,29,20.78,,
71079,P-0441,21,0,21,24.00,,
71080,P-0442,2,2,0,31.14,,
71081,P-0443,7,2,5,73.03,,
71082,63448,2,2,0,25.28,,
71083,63449,0,0,0,39.63,,
71084,63450,0,0,0,52.04,,
71085,SH-0126-390,0,0,0,18.49,,
71086,SH-0126-820,0,0,0,14.79,,
71087,000-157-939-10,0,0,0,86.36,,
71091,W700-800-WHITE,0,0,0,279.92,,
71110,"GL 04510",0,0,0,74.99,,
71127,W705-WHITE,0,0,0,230.97,,
71145,010-12225-00,0,0,0,41.24,,
71165,W709-SUPA,1979,1000,979,89.99,,
71166,W730,3,1,2,19.68,,
71167,W731,2,2,0,6.42,,
71168,W749,1,1,0,4.99,,
71169,W734,0,0,0,10.85,,
71170,W738,0,0,0,10.85,,
71174,CVC627MT,0,0,0,118.75,,
71185,GP1871F,4,0,4,724.95,,
71187,GP1971F,0,0,0,1048.95,,
71189,CM599C-LHW,0,0,0,3535.51,,
71192,6135C,0,0,0,30.44,,
71193,6136C,0,0,0,34.95,,
71194,6137C,0,0,0,24.70,,
71195,6138C,0,0,0,29.76,,
71196,S-0250C,0,0,0,72.43,,
71197,S-0251C,0,0,0,76.06,,
71199,6095KEY,0,0,0,5.74,,
71200,3360BC,0,0,0,3.75,,
71201,3360WC,0,0,0,3.75,,
71202,3364BC,0,0,0,4.97,,
71203,3364WC,0,0,0,4.97,,
71204,010-12718-00,24,19,5,18.74,,
71205,3227BC,0,0,0,14.93,,
71206,3227WC,0,0,0,14.93,,
71207,3228BC,0,0,0,15.93,,
71208,3228WC,0,0,0,15.93,,
71209,S-1415BC,4,4,0,33.70,,
71210,S-1417BC,0,0,0,24.24,,
71211,S-1415WC,0,0,0,29.49,,
71212,S-1417WC,0,0,0,24.24,,
71213,6228KEY,7,5,2,3.28,,
71214,6075C,0,0,0,14.41,,
71225,40020506,6,2,4,1393.21,,
71226,011810,0,0,0,830.98,,
71228,011811,0,0,0,833.70,,
71230,20641,4,1,3,106.99,171.19,
71231,09-1088-23,6,3,3,27.28,,
71235,950520,0,0,0,21.94,,
71236,951520,11,4,7,21.94,,
71237,950622,13,9,4,37.04,,
71238,1005,0,0,0,13.47,,
71239,951622,7,1,6,37.04,,
71240,950824,37,20,17,63.66,,
71241,951824,25,12,13,63.66,,
71242,252000,0,0,0,17.36,,
71243,252004,2,0,2,17.36,,
71244,262300,23,10,13,26.91,,
71246,282600,13,7,6,52.16,,
71247,282604,2,2,0,52.16,,
71248,31010,5,1,4,5.53,,
71253,2412ATP,0,0,0,938.11,,
71254,010-12504-02,3,0,3,11.24,,
71255,010-12545-00,0,0,0,22.49,,
71257,GP1170-17,0,0,0,385.44,,
71269,OC14SUK26,0,0,0,48.91,,
71283,PP5920-01,0,0,0,414.53,,
71284,A2K-GCM-0.25M,2,0,2,32.73,,
71286,HE-CBRGB,0,0,0,45.37,,
71291,6031,4,2,2,58.66,,
71292,6034,0,0,0,58.66,,
71293,GP2402,0,0,0,312.72,,
71294,CA200B-8B,0,0,0,386.67,,
71296,GP1040-42,0,0,0,334.53,,
71306,374,20,0,20,15.97,,
71333,230AHF012,0,0,0,963.41,,
71341,AV-800-BK-S/M,0,0,0,75.94,,
71342,AV-800-BK-L/XL,0,0,0,75.94,,
71343,AV-800-BK-2XL/3XL,0,0,0,75.94,,
71344,AV-800-HV-S/M,0,0,0,75.94,,
71345,AV-800-HV-L/XL,1,1,0,75.94,,
71346,AV-800-HV-2XL-3XL,0,0,0,75.94,,
71347,AV-800-GN-S/M,0,0,0,75.94,,
71348,AV-800-GN-L/XL,0,0,0,75.94,,
71349,AV-800-GN-2XL/3XL,0,0,0,75.94,,
71352,921314,0,0,0,495.68,793.09,
71353,920314,0,0,0,386.25,617.99,
71356,320314,12,0,12,312.44,,
71415,300-037,0,0,0,1256.36,,1601.85
71428,482073,0,0,0,112.50,179.99,
71430,482083,0,0,0,112.50,179.99,
71432,482103,2,2,0,118.12,188.99,
71433,482113,6,6,0,104.44,188.99,
71436,86620,1,0,1,69.07,124.99,
71437,86610,0,0,0,78.12,124.99,
71438,681513,7,7,0,173.81,278.09,
71439,262213,4,0,4,243.75,389.99,
71440,262313,7,0,7,350.00,559.99,
71443,14212,1,1,0,57.10,,
71458,0780,23,15,8,3.80,,
71462,4825,3,3,0,24.10,,
71465,0838,4,4,0,59.01,,
71466,14341,2,2,0,23.44,,
71467,14371,3,3,0,47.59,,
71469,14042,1,1,0,47.59,,
71472,14071,2,0,2,57.10,,
71474,14261,2,0,2,57.10,,
71476,99091,5,5,0,22.21,,
71479,14691,0,0,0,82.49,,
71480,14221,3,3,0,20.94,,
71481,14351,5,5,0,22.00,,
71482,980023,0,0,0,275.00,439.99,
71484,980033,0,0,0,275.00,439.99,
71485,14281,15,12,3,7.42,,
71486,14291,6,0,6,7.06,,
71487,1430,29,26,3,13.43,,
71491,A80489,4,4,0,55.39,,
71492,A80494,0,0,0,98.00,,
71493,A80491,0,0,0,98.00,,
71498,4501,15,15,0,7.60,,
71499,451200,4,4,0,19.78,,
71500,451205,0,0,0,15.22,,
71503,4744,3,3,0,9.19,,
71504,4745,0,0,0,10.78,,
71506,4650,5,5,0,7.77,,
71507,4651,4,4,0,12.01,,
71509,1062,0,0,0,19.03,,
71510,1266,3,0,3,27.28,,
71511,1280,0,0,0,8.47,,
71513,1285,0,0,0,7.18,,
71527,210413,0,0,0,721.87,1154.99,
71528,28-501,1,0,1,11.84,,
71529,27-404,2,0,2,32.28,,
71530,42-110,0,0,0,37.16,,
71534,45-100,0,0,0,140.63,,
71536,04-100,0,0,0,33.89,,
71537,04-110,4,0,4,25.01,,
71538,04-110S,3,0,3,22.21,,
71539,05-110,0,0,0,33.75,,
71540,06-110,1,0,1,58.92,,
71541,QR-3-20,0,0,0,7.55,,
71542,QR-4-32,0,0,0,7.25,,
71544,QR-6-26,2,0,2,14.95,,
71546,50-115,0,0,0,14.07,,
71547,50-115B,0,0,0,14.07,,
71552,2150,0,0,0,10.14,,
71554,2152,1,1,0,13.95,,
71555,2154,5,5,0,15.22,,
71556,90-500,0,0,0,141.96,,
71558,2156,3,3,0,27.28,,
71559,2157,0,0,0,30.45,,
71560,48-580,2,0,2,25.91,,
71561,1264,0,0,0,42.41,,
71563,48-585,0,0,0,39.99,,
71565,48-590,1,0,1,41.26,,
71566,1271,4,4,0,14.11,,
71569,1279,0,0,0,17.08,,
71572,1290,2,2,0,38.06,,
71573,1291,0,0,0,57.11,,
71574,37-510,0,0,0,42.34,,
71575,37-504,0,0,0,34.05,,
71576,37-505,1,0,1,52.12,,
71577,37-503,0,0,0,313.96,,
71578,53-215,0,0,0,250.53,,
71580,53-220,0,0,0,275.39,,
71581,53-222,0,0,0,469.74,,
71582,220413,2,0,2,1172.50,1875.99,
71583,230413,0,0,0,1585.00,2535.99,
71584,240413,0,0,0,1860.62,2976.99,
71585,250413,0,0,0,2274.37,3638.99,
71586,550103,0,0,0,90.00,143.99,
71587,106613,0,0,0,456.25,729.99,
71588,920413,0,0,0,450.62,720.99,
71590,1300,4,4,0,15.86,,
71600,14211,0,0,0,28.55,,
71601,14213,1,1,0,50.76,,
71609,4820,1,1,0,10.78,,
71610,A80508,0,0,0,1149.70,,
71614,TM185C-HW-14HB,0,0,0,1084.94,,
71617,BS11050,0,0,0,72.43,,
71618,BS11250,0,0,0,80.95,,
71661,142625,3,2,1,79.99,,
71696,PP4500-08-C,0,0,0,276.35,,
71697,B4-209SS,3,0,3,1956.73,2396.00,
71698,B4-309SS,2,0,2,2544.73,3116.00,
71700,50900-1100,3,1,2,292.06,,
71701,2106B,0,0,0,708.92,,
71704,464,8,0,8,2.88,,
71707,744,7,0,7,6.58,,
71716,6032,2,0,2,58.66,,
71718,340314,0,0,0,727.43,1163.89,
71722,27640,5,1,4,92.80,174.99,
71724,29320,31,20,11,44.44,,
71729,MM3-VNA-021,0,0,0,227.27,,
71731,16867A,35,11,24,3.02,,
71733,29540,0,0,0,4.67,,
71734,29541,12,0,12,6.10,,
71742,18A,8,5,3,235.56,,
71779,41611,2,2,0,105.00,199.99,
71791,23-001-001A,0,0,0,525.42,639.00,
71792,23-001-501A,0,0,0,610.54,739.00,
71803,75212-04-BX,0,0,0,13.85,,
71806,TPA309,0,0,0,116.78,,
71812,ZDIG4GC-US,2,1,1,449.96,,
71813,ZDIG4GCPRO-US,2,1,1,704.96,,
71825,B785C-M-MM,0,0,0,755.68,,
71828,S72-0631-05,0,0,0,1137.60,,
71832,DMF6,9,3,6,25.68,,
71839,A1624,0,0,0,6.97,,
71840,A2216,0,0,0,8.11,,
71841,A1214,9,3,6,11.96,,
71844,G17748,4,0,4,11.50,,
71849,G10900,9,1,8,6.60,,
71850,DMX5,0,0,0,24.17,,
71852,PP4800-07,0,0,0,356.35,,
71853,D15501,1,0,1,22.65,,
71854,D18001,5,0,5,27.99,,
71856,D30116,0,0,0,9.65,,
71857,12845,0,0,0,21.78,,
71864,2000033189,1,0,1,148.53,,
71865,2000033190,4,3,1,205.28,,
71867,010-12525-00,0,0,0,29.98,,
71868,2000032674,4,4,0,30.88,,
71874,F38-6602-1,26,9,17,133.65,,
71875,PP5920-05,0,0,0,414.53,,
71883,TM150M,2,1,1,311.11,,
71884,40215,0,0,0,254.76,,349.00
71886,010-12561-02,0,0,0,31.99,,
71904,90406,8,2,6,14.99,,
71918,A102148,0,0,0,51.13,,
71919,330314,4,1,3,579.37,926.99,
71926,HL-1,5,4,1,10.55,,
71927,HEL-KIT,3,1,2,14.89,,
71928,HL-103,3,2,1,3.93,,
71933,EVO-1212F,1,1,0,696.25,1004.80,
71938,0253W00DP1,2,2,0,51.45,,
71946,199232,16,9,7,8.28,,
71947,B765C-LM-MM,0,0,0,1041.76,,
71948,010-12527-00,17,4,13,74.99,,
71954,119251,0,0,0,188.49,,
71955,118151,0,0,0,16.22,,
71964,GP1800-08,0,0,0,312.72,,
71966,A80515,0,0,0,80.95,,
71973,32851,1,1,0,85.93,,
71974,RMX4800-07,0,0,0,436.35,,
72002,350314,0,0,0,869.06,1390.49,
72007,010-02087-00,14,11,3,749.99,,
72008,010-12824-01,0,0,0,22.49,,
72009,010-02047-00,9,5,4,599.99,,
72010,010-12769-00,2,1,1,97.49,,
72018,37202-2024,4,2,2,273.12,,
72045,D30116CASE,0,0,0,56.35,,
72049,A1624CASE,0,0,0,39.58,,
72050,A2216CASE,0,0,0,46.05,,
72051,A1214CASE,1,0,1,67.86,,
72054,G17748CASE,0,0,0,61.54,,
72057,G18016CASE,0,0,0,35.27,,
72059,D18001CASE,1,0,1,133.08,,
72060,D15501CASE,0,0,0,80.81,,
72061,G10900CASE,1,0,1,34.78,,
72062,"CS 02908CASE",0,0,0,88.76,125.70,
72076,09-60616,2,0,2,24.69,,
72077,10615-00,0,0,0,26.54,,
72078,61155,0,0,0,14.81,,
72084,110-11700,0,0,0,65.95,,
72085,110-15800,1,0,1,65.95,,
72087,20104,13,5,8,77.97,,
72088,20105,11,11,0,83.55,,
72089,20106,7,7,0,94.69,,
72090,20107,33,22,11,105.83,,
72091,20108,9,9,0,125.97,,
72092,20109,9,5,4,137.97,,
72093,20110,8,2,6,139.26,,
72094,20111,0,0,0,161.97,,
72095,20112,8,2,6,161.55,,
72096,20204,12,6,6,77.97,,
72097,20205,2,1,1,89.97,,
72098,20206,22,20,2,101.97,,
72099,20207,16,10,6,113.97,,
72100,20208,15,12,3,125.97,,
72101,20209,2,2,0,137.97,,
72102,20210,11,7,4,139.26,,
72103,20211,0,0,0,161.97,,
72104,20212,7,4,3,161.55,,
72108,20304,2,2,0,77.97,,
72109,20305,0,0,0,89.97,,
72110,20306,0,0,0,101.97,,
72111,20307,0,0,0,113.97,,
72112,20308,0,0,0,125.97,,
72113,20309,0,0,0,137.97,,
72114,20310,0,0,0,149.97,,
72115,20311,2,2,0,161.97,,
72116,20312,1,1,0,173.97,,
72118,20404,0,0,0,77.97,,
72119,20405,0,0,0,89.97,,
72120,20406,2,0,2,101.97,,
72121,20407,1,0,1,113.97,,
72122,20408,2,2,0,125.97,,
72123,20409,0,0,0,137.97,,
72124,20410,0,0,0,149.97,,
72125,20411,0,0,0,161.97,,
72126,20412,0,0,0,173.97,,
72128,20504,0,0,0,77.97,,
72129,20505,5,3,2,89.97,,
72130,20506,11,6,5,101.97,,
72131,20507,12,6,6,113.97,,
72132,20508,4,4,0,125.97,,
72133,20509,0,0,0,137.97,,
72134,20510,0,0,0,149.97,,
72135,20511,6,3,3,161.97,,
72136,20512,0,0,0,173.97,,
72137,20604,0,0,0,77.97,,
72138,20605,0,0,0,89.97,,
72139,20606,0,0,0,101.97,,
72140,20607,14,7,7,113.97,,
72141,20608,12,6,6,125.97,,
72142,20609,0,0,0,137.97,,
72143,20610,0,0,0,149.97,,
72144,20611,3,0,3,161.97,,
72145,20612,0,0,0,173.97,,
72146,20704,0,0,0,77.97,,
72147,20705,5,5,0,89.97,,
72148,20706,0,0,0,101.97,,
72149,20707,5,5,0,105.83,,
72150,20708,0,0,0,125.97,,
72151,20709,0,0,0,137.97,,
72152,20710,0,0,0,149.97,,
72153,20711,13,5,8,150.40,,
72154,20712,0,0,0,173.97,,
72155,20804,0,0,0,74.97,,
72156,20805,0,0,0,86.51,,
72157,20806,6,6,0,101.97,,
72158,20807,0,0,0,113.97,,
72159,20808,15,6,9,116.98,,
72160,20809,0,0,0,137.97,,
72161,20810,0,0,0,149.97,,
72162,20811,3,3,0,161.97,,
72163,20812,0,0,0,167.28,,
72164,20904,0,0,0,77.97,,
72165,20905,0,0,0,89.97,,
72166,20906,0,0,0,101.97,,
72167,20907,12,6,6,113.97,,
72168,20908,0,0,0,121.13,,
72169,20909,0,0,0,137.97,,
72170,20910,0,0,0,149.97,,
72171,20911,0,0,0,161.97,,
72172,20912,0,0,0,173.97,,
72173,21104,0,0,0,77.97,,
72174,21105,0,0,0,86.51,,
72175,21106,0,0,0,98.05,,
72176,21107,0,0,0,109.59,,
72177,21108,12,0,12,116.98,,
72178,21109,5,5,0,137.97,,
72179,21110,5,5,0,149.97,,
72180,21111,0,0,0,155.74,,
72181,21112,1,1,0,173.97,,
72182,21404,0,0,0,74.97,,
72183,21405,0,0,0,86.51,,
72184,21406,0,0,0,101.97,,
72185,21407,3,1,2,113.97,,
72186,21408,6,6,0,125.97,,
72187,21409,0,0,0,137.97,,
72188,21410,0,0,0,149.97,,
72189,21411,0,0,0,155.74,,
72190,21412,0,0,0,167.28,,
72191,30232,0,0,0,251.38,,
72192,30240,0,0,0,298.95,,
72193,30532,0,0,0,251.38,,
72194,30540,0,0,0,298.95,,
72195,31532,0,0,0,251.38,,
72197,31632,0,0,0,251.38,,
72198,31640,0,0,0,298.95,,
72201,27011,0,0,0,66.32,,
72202,02637,43,11,32,11.76,,
72203,02638,8,3,5,12.67,,
72204,80637,34,14,20,22.48,,
72205,80638,31,9,22,24.21,,
72206,80011,18,6,12,102.54,,
72210,LLB-45AR-08-02,0,0,0,15.79,,
72237,27021,8,4,4,66.32,,
72238,27031,6,5,1,61.58,,
72239,27041,5,1,4,66.32,,
72240,27051,7,1,6,66.32,,
72241,27061,0,0,0,66.32,,
72242,27071,4,4,0,66.32,,
72243,27081,7,1,6,66.32,,
72244,27091,5,5,0,66.32,,
72245,27101,0,0,0,66.32,,
72246,27121,0,0,0,66.32,,
72247,27131,0,0,0,66.32,,
72248,27141,5,1,4,66.32,,
72249,27151,8,2,6,66.32,,
72250,27171,10,4,6,66.32,,
72251,27181,2,1,1,61.58,,
72252,27191,0,0,0,66.32,,
72253,27211,0,0,0,66.32,,
72254,27221,0,0,0,66.32,,
72255,27261,0,0,0,66.32,,
72256,27271,0,0,0,66.32,,
72257,27291,0,0,0,66.32,,
72258,27301,9,3,6,66.32,,
72259,27311,3,0,3,66.32,,
72260,27321,0,0,0,66.32,,
72261,27331,6,2,4,66.32,,
72262,27341,0,0,0,66.32,,
72263,MBR550,1,1,0,969.99,,
72267,02655,9,3,6,40.36,,
72268,02656,2,0,2,34.98,,
72269,02657,0,0,0,40.36,,
72270,02658,0,0,0,40.36,,
72271,02660,0,0,0,40.36,,
72273,02662,0,0,0,40.36,,
72274,02663,0,0,0,40.36,,
72275,02664,0,0,0,40.36,,
72276,02665,0,0,0,40.36,,
72277,02667,0,0,0,40.36,,
72278,02668,0,0,0,40.36,,
72280,02673,0,0,0,40.36,,
72281,02674,0,0,0,40.36,,
72293,RF681,0,0,0,11.54,,
72294,RF470,0,0,0,17.68,26.38,
72295,40281,2,1,1,22.50,35.99,
72297,RF467,0,0,0,18.07,27.65,
72298,RF567,0,0,0,22.05,33.73,
72299,RF417,0,0,0,14.17,21.69,
72300,RF285,4,1,3,16.38,25.07,
72301,RF188,0,0,0,13.64,,
72302,RF81,0,0,0,19.28,29.51,
72303,RF82,0,0,0,25.56,39.10,
72304,RF83,0,0,0,22.05,33.73,
72305,64011,0,0,0,456.25,729.99,
72306,41646,0,0,0,175.00,279.99,
72310,RA300,1,0,1,39.99,,
72311,165T-SS54,0,0,0,1688.89,,
72316,RA357,1,1,0,4.99,,
72321,31-6262-00,7,4,3,17.75,,
72333,529-VW-S,81,38,43,289.53,,
72334,897-CW-S,0,0,0,309.74,,
72335,1197-CW-S,0,0,0,356.20,,
72337,529-VB-S,10,3,7,313.11,,
72339,829-VW-S,10,8,2,311.08,,
72340,1129-VW-S,0,0,0,329.94,,
72341,532-VW-S,6,0,6,868.67,,
72342,532-VW-RS,5,5,0,915.13,,
72343,549-EW-S,0,0,0,365.62,,
72344,598-SW-S,0,0,0,301.66,,
72345,538-AW-S,3,1,2,265.29,,
72346,538-AB-S,3,2,1,286.84,,
72348,249ATP,1,1,0,870.26,,
72352,11001,4,2,2,11.67,24.99,
72354,11003,4,2,2,14.00,24.99,
72357,1140,18,17,1,28.42,,
72358,1143,21,10,11,34.11,,
72359,385310681,0,0,0,57.76,,
72360,1146,35,25,10,49.69,,
72361,1149,29,20,9,65.94,,
72362,1152,11,5,6,101.40,,
72363,61140,24,21,3,28.42,,
72364,61143,28,14,14,34.11,,
72366,61146,19,6,13,49.69,,
72367,61149,16,3,13,65.94,,
72368,61152,15,12,3,101.40,,
72370,1515-FT,199,199,0,0.69,,
72375,201913,37,0,37,5.83,13.99,
72376,201923,36,31,5,8.73,13.99,
72377,201933,46,25,21,5.83,13.99,
72386,104933,0,0,0,8.12,16.99,
72392,106913,2,2,0,7.58,18.99,
72393,106923,0,0,0,11.08,18.99,
72394,106933,2,2,0,7.58,18.99,
72397,RF30100,3,3,0,19.26,29.46,
72402,RF30110,0,0,0,30.68,46.94,
72403,RF30141,0,0,0,17.12,26.19,
72404,110913,2,1,1,7.58,20.99,
72406,110933,11,4,7,7.58,20.99,
72414,301913,0,0,0,5.83,15.99,
72422,311913,2,2,0,9.35,15.99,
72425,311933,3,0,3,5.83,15.99,
72426,R50304,3,3,0,373.91,521.90,
72435,103933,7,3,4,9.33,24.99,
72443,R69015,32,2,30,26.46,,
72451,105843,0,0,0,8.12,18.99,
72453,105863,0,0,0,8.12,18.99,
72455,105883,0,0,0,11.87,18.99,
72458,105913,0,0,0,11.87,,
72460,40187,0,0,0,84.37,134.99,
72462,MBR500,1,0,1,599.99,,
72463,20611,0,0,0,50.00,79.99,
72464,163032,5,4,1,31.40,45.97,
72465,163001,0,0,0,87.62,140.97,
72466,163532,12,7,5,36.12,52.97,
72467,163501,1,1,0,100.78,145.97,
72472,131932,27,16,11,24.40,41.97,
72473,131901,10,6,4,61.22,108.97,
72474,133532,6,6,0,30.22,52.97,
72475,133501,10,6,4,75.49,136.97,
72476,133132,10,6,4,33.36,56.97,
72477,133332,8,3,5,28.55,49.97,
72478,800136CS,7,2,5,7.69,13.97,
72479,890146,23,6,17,14.12,24.97,
72480,810176,14,4,10,10.27,16.97,
72481,890171,12,0,12,15.83,28.97,
72482,890142,1,0,1,10.08,21.97,
72483,890143,16,6,10,14.38,25.97,
72485,890172,12,7,5,15.10,26.97,
72486,890144,27,23,4,16.04,23.97,
72487,166232,1,1,0,9.62,14.97,
72488,166022,0,0,0,5.86,19.97,
72489,166622,0,0,0,5.69,9.97,
72496,166322,2,2,0,6.35,10.97,
72501,C1030D,0,0,0,84.38,109.95,
72502,C1015D,11,2,9,84.38,109.95,
72503,C1000D,8,4,4,84.38,109.95,
72504,C1030ND,13,8,5,84.38,109.95,
72505,C1015ND,0,0,0,84.38,109.95,
72506,C1000ND,20,2,18,84.38,109.95,
72507,C1030DS,11,11,0,92.47,132.00,
72508,C1015DS,12,2,10,92.47,132.00,
72509,C1000DS,16,8,8,92.47,132.00,
72510,C2030D,9,3,6,84.38,109.95,
72511,C2015D,0,0,0,84.38,109.95,
72512,C2000D,2,0,2,84.38,109.95,
72513,C2030ND,19,9,10,84.38,109.95,
72514,C2015ND,22,0,22,84.38,109.95,
72515,C2000ND,18,12,6,84.38,109.95,
72516,C2030DS,7,7,0,92.47,132.00,
72518,C2015DS,2,0,2,92.47,132.00,
72519,C2000DS,6,0,6,92.47,132.00,
72520,P1000DB,7,7,0,9.59,,
72521,P1000DW,18,13,5,9.59,,
72522,20621,0,0,0,60.18,96.29,
72523,P1015DB,0,0,0,9.59,,
72524,P1015DW,39,12,27,9.59,,
72525,20631,0,0,0,60.18,96.29,
72526,P2030B,11,0,11,9.59,,
72527,P2030W,5,5,0,9.59,,
72528,2000CS,0,0,0,6.16,,
72529,20731,0,0,0,168.75,269.99,
72530,1000CS,11,0,11,6.16,,
72533,CBP,0,0,0,13.70,,
72534,RHS,0,0,0,41.10,44.95,
72535,A3812,0,0,0,0.41,,
72536,EL3812,2,1,1,0.55,,
72537,T12,1,0,1,0.68,,
72538,20511,3,0,3,60.18,96.29,
72539,20521,0,0,0,60.18,96.29,
72540,20531,1,1,0,53.21,96.29,
72542,40282,6,3,3,31.87,50.99,
72551,40284,0,0,0,28.12,44.99,
72552,40286,0,0,0,26.24,,
72555,40289,8,6,2,9.70,,
72556,40290,0,0,0,34.37,54.99,
72557,20541,4,2,2,106.99,171.19,
72558,40312,0,0,0,50.27,89.99,
72566,42010,0,0,0,43.75,69.99,
72567,41010,0,0,0,20.00,31.99,
72571,740173-1,2,2,0,53.02,,
72572,010-12809-20,0,0,0,2984.99,,
72577,010-12667-02,0,0,0,29.98,,
72578,010-12765-00,0,0,0,37.49,,
72580,010-12784-01,10,4,6,22.49,,
72581,010-12784-00,0,0,0,22.49,,
72582,010-12784-02,0,0,0,26.24,,
72583,SET0225,0,0,0,99.64,,
72585,010-12531-01,6,6,0,18.74,,
72587,TZ-121,0,0,0,823.53,,850.00
72589,1377612,1,1,0,556.88,,
72591,001-341-680-00,1,1,0,336.36,,
72593,40610,0,0,0,20.00,31.99,
72594,40690,0,0,0,20.00,31.99,
72597,42090,0,0,0,33.12,52.99,
72602,20002,151,0,151,5.34,,
72603,20004,11,0,11,73.33,,
72605,20032,0,0,0,25.71,,
72607,20012,54,0,54,12.42,,
72610,25002,223,0,223,4.25,,
72612,25003,25,0,25,11.45,,
72613,25014,39,0,39,12.62,,
72614,25016,10,0,10,15.11,,
72616,MI-0012-STD,3,1,2,84.26,,
72618,RA0978600,14,11,3,0.86,,
72627,R70389,0,0,0,136.35,,
72633,T70216,1,0,1,1144.73,,
72634,QUAD-TAC-BK,15,4,11,30.39,44.99,
72636,QUAD-TAC-OD,5,3,2,32.61,44.99,
72651,RA2028000000,0,0,0,837.56,926.10,
72652,RA2034000000,0,0,0,931.16,1029.60,
72653,RA2040000000,1,0,1,936.81,1132.20,
72654,RA2046000000,0,0,0,1301.51,1439.10,
72659,PP4400-09-C,0,0,0,269.08,,
72662,480153,2,0,2,60.18,96.29,
72664,RA5205BK,0,0,0,96.15,,
72666,RH5329H,6,2,4,83.13,,
72685,40-518,24,1,23,18.21,,
72718,010-11967-00,0,0,0,20.99,,
72721,FX-4,0,0,0,37.44,,
72723,A80311,0,0,0,262.49,,
72767,ARG-500-P,2,1,1,161.67,,
72768,ARG-500-S,1,1,0,164.44,,
72769,ARG-500,0,0,0,194.44,,
72770,ARG-755-P,5,2,3,161.67,,
72771,ARG-755,3,1,2,194.44,,
72772,T70432,0,0,0,434.20,,
72773,T70433,0,0,0,631.57,,
72774,T70434,0,0,0,434.20,,
72775,E70399,0,0,0,4399.99,,
72776,INFPRV315.2,1,0,1,251.25,349.95,
72780,INFPRV90,0,0,0,120.10,159.95,
72782,ARG-750-P,1,1,0,163.89,,
72783,ARG-750-S,1,0,1,166.11,,
72784,ARG-750,2,0,2,208.89,,
72786,ARG-1000-P,5,1,4,228.89,,
72787,ARG-1000-S,3,0,3,230.00,,
72789,ARG-1000,1,1,0,288.33,,
72791,ARG-1250-P,2,2,0,250.00,,
72792,REFPRV415,1,1,0,269.99,429.95,
72793,ARG-1250-S,0,0,0,250.00,,
72794,ARG-1250,5,2,3,323.33,,
72795,ARG-1500-P,2,0,2,378.33,,
72796,ARG-1500-S,0,0,0,381.67,,
72797,ARG-1500,0,0,0,471.67,,
72798,ARG-2000-P,1,0,1,402.78,,
72799,ARG-2000-S,2,2,0,404.44,,
72800,ARG-2000,0,0,0,512.78,,
72813,JBLMA4505,1,1,0,339.99,499.95,
72817,JBLPRV275,1,0,1,244.63,319.95,
72819,RK2201BK,0,0,0,10.00,,
72820,RK2202BK,4,3,1,18.85,,
72821,TM-10-101-24,0,0,0,154.22,,
72823,46-250-1,0,0,0,87.78,,
72824,46-250-2,0,0,0,81.71,,
72825,ASC-1250,2,0,2,102.78,,
72827,ASC-2000,0,0,0,141.11,,
72829,ASC-3000,2,2,0,254.44,,
72839,544-SSW-RS,0,0,0,915.13,,
72841,BV-750,4,2,2,181.67,,
72842,BV-1000,0,0,0,221.67,,
72843,BV-1250,1,1,0,282.78,,
72844,BV-1500,3,1,2,318.89,,
72845,BV-2000,0,0,0,446.11,,
72846,199325,1,0,1,3.28,,
72847,BB-1,5,4,1,36.11,,
72848,BB-2,3,3,0,45.00,,
72853,FF-500,14,11,3,6.11,,
72855,FF-750,16,2,14,7.78,,
72857,FF-1000,11,1,10,9.44,,
72859,FF-1125,9,2,7,10.00,,
72861,FF-1250,13,4,9,15.56,,
72863,FF-1500,13,7,6,19.44,,
72865,FF-2000,7,0,7,44.44,,
72869,MM3-VNA-023,0,0,0,227.27,,
72883,PP4503,0,0,0,276.35,,
72885,PP4600-06-C,0,0,0,305.44,,
72886,601114,10,5,5,3.21,,
72887,700103,0,0,0,4.34,,
72888,522122,0,0,0,2.08,,
72891,FM4800,0,0,0,565.16,,695.00
72895,EIC102,2,0,2,127.44,,
72901,NAVPRO900,1,0,1,769.30,,
72902,NAVPRO900F,1,0,1,909.30,,
72903,NAVPRO1200,1,1,0,1489.99,,
72904,NAVPRO1200F,0,0,0,1749.30,,
72905,10-13406-104,1,0,1,165.00,,
72907,980013,0,0,0,225.00,359.99,
72908,PRO505XL,36,13,23,40.75,,
72911,A80565,4,3,1,76.69,,
72912,10140006,0,0,0,3728.00,,
72913,10140007,0,0,0,3567.31,,
72914,10140006Y,0,0,0,3728.00,,
72915,10140007Y,0,0,0,3567.31,,
72916,30140001,0,0,0,1468.24,,
72917,20140002,0,0,0,1556.39,,
72926,20140001,0,0,0,1651.89,,
72927,20310033,1,1,0,1005.45,,
72928,20310034,0,0,0,1005.45,,
72938,012105W,0,0,0,436.75,,
72939,012104B,0,0,0,436.75,,
72940,012106BW,0,0,0,448.36,,
72941,012107C,0,0,0,640.58,,
72942,012108,0,0,0,143.48,,
72952,RBA-100,2,2,0,29.99,,
72953,RA5000SL,2,0,2,101.92,,
72959,1104,0,0,0,135.33,,
72969,1428G00WHT,14,14,0,37.97,,
72994,010-12390-44,4,1,3,59.99,,
72996,GP2040-17,0,0,0,334.53,,
73005,163032CASE,0,0,0,376.77,551.64,
73006,163532CASE,0,0,0,433.38,635.64,
73009,131932CASE,1,1,0,292.77,503.64,
73010,133532CASE,0,0,0,362.62,611.64,
73011,133132CASE,1,1,0,200.15,341.82,
73012,133332CASE,0,0,0,171.31,299.82,
73014,166322CASE,0,0,0,76.17,131.64,
73018,P12072,3,0,3,405.00,,
73020,W739,0,0,0,10.85,,
73021,W732,6,6,0,4.99,,
73025,W737,0,0,0,6.85,,
73026,W740,0,0,0,4.28,,
73027,W741,0,0,0,4.57,,
73028,W742,1,0,1,4.42,,
73029,W746,2,2,0,8.12,,
73031,W743-DOUBLE,0,0,0,13.98,,
73032,W743-SS,0,0,0,16.12,,
73033,W748,0,0,0,8.12,,
73035,W755,3,2,1,52.99,,
73044,890146CASE,1,0,1,169.38,299.64,
73045,810176CASE,0,0,0,108.46,203.64,
73046,890171CASE,1,0,1,190.00,347.64,
73047,890142CASE,0,0,0,120.92,263.64,
73048,890143CASE,0,0,0,172.62,311.64,
73049,890172CASE,0,0,0,181.23,323.64,
73050,890144CASE,1,1,0,192.46,287.64,
73052,M81136,0,0,0,1891.66,,
73054,JB-100716B,0,0,0,9.06,,
73061,480143,0,0,0,60.18,96.29,
73069,480343,0,0,0,60.18,96.29,
73072,480053,0,0,0,60.18,96.29,
73073,480043,0,0,0,60.18,96.29,
73074,480033,0,0,0,60.18,96.29,
73077,FTT641512000B00,3,0,3,130.68,,
73081,F7-537,35,16,19,1.61,,
73082,B45-DT-HB,0,0,0,280.68,,
73084,104099,0,0,0,129.37,,
73096,731S-01422,0,0,0,14.21,,
73100,MCKGB450W.6,12,6,6,141.99,,
73101,MCKGB450B.6,0,0,0,139.20,,
73102,BM40AMPBT,5,1,4,170.44,,
73103,TUBE,9,8,1,39.77,,
73106,R109LH,0,0,0,3022.22,,
73107,R70521,2,1,1,55.39,,
73108,010-12507-02,8,6,2,7.49,,
73109,GP1812,0,0,0,409.00,,
73110,GPX1212,1,1,0,323.00,,
73111,GPX2012,13,13,0,484.00,,
73112,IPX1212,0,0,0,350.00,,409.95
73113,PPX2012D,2,2,0,506.00,,589.95
73116,FM0800,0,0,0,213.55,,
73117,FMX1200,0,0,0,310.00,,339.95
73118,FM1800,0,0,0,410.00,,469.95
73119,FMX2000,0,0,0,430.00,,539.95
73120,FM2800,0,0,0,460.00,,550.95
73122,DVR100,7,7,0,28.24,,
73123,104,0,0,0,7.04,,
73124,TB0050,0,0,0,80.63,,
73125,TB0080,6,6,0,80.63,,
73126,TB0051,2,2,0,91.88,,
73127,TK-100,0,0,0,59.06,,
73128,TK-123,0,0,0,86.25,,
73129,TK-144,0,0,0,86.25,,
73130,TK-187,0,0,0,86.25,,
73131,TK-184,0,0,0,86.25,,
73132,TK-127,0,0,0,110.63,,
73133,TK-130,0,0,0,110.63,,
73134,TK-223,0,0,0,86.25,,
73135,TK-244,0,0,0,86.25,,
73136,TK-284,0,0,0,83.44,,
73137,TK-287,0,0,0,86.25,,
73138,TK-227,0,0,0,110.63,,
73139,TK-230,0,0,0,107.81,,
73140,BK0023,0,0,0,9.38,,
73141,BK0027,0,0,0,9.38,,
73142,BK0044,0,0,0,13.13,,
73143,P1030DB,0,0,0,9.59,,
73144,VGR001,11,11,0,28.13,,
73145,CB0001,2,2,0,19.69,,
73146,GB0001,0,0,0,9.85,,
73147,COV001,0,0,0,7.98,,
73148,L-202,3,2,1,15.94,,
73149,MS0001,0,0,0,13.00,,
73150,BC-100,5,5,0,27.19,,
73152,PC-100,16,16,0,26.25,,
73153,FSSK01,0,0,0,103.13,,
73154,TSA001,5,5,0,7.50,,
73156,PC0001,5,5,0,11.25,,
73157,PC0004,0,0,0,11.25,,
73158,PCDCA1,0,0,0,24.38,,
73159,PCDCA4,0,0,0,24.38,,
73160,S-140,9,9,0,14.06,,
73162,SP0007,0,0,0,27.19,,
73164,SP0005,0,0,0,29.00,,
73168,RH-100,0,0,0,4.69,,
73171,FT-100,7,7,0,4.69,,
73172,GBK001,0,0,0,3.75,,
73173,RB-100,0,0,0,0.94,,
73174,ST-100,11,11,0,1.41,,
73177,TKB100,2,2,0,4.23,,
73178,SMC001,0,0,0,10.31,,
73179,SMB001,3,3,0,7.98,,
73180,ACE001,0,0,0,5.16,,
73181,V-120,10,10,0,48.75,,
73183,DD-100,0,0,0,53.44,,
73184,V-410,21,21,0,24.38,,
73196,13815,0,0,0,47.00,,
73199,010-02096-00,13,8,5,299.99,,
73200,010-02097-00,5,1,4,374.99,,
73201,010-02098-00,17,9,8,524.99,,
73206,010-12462-10,0,0,0,149.99,,
73207,010-12676-30,0,0,0,56.24,,
73208,010-12676-35,1,1,0,29.98,,
73209,88653,0,0,0,498.71,1000.00,
73216,770050,10,0,10,11.37,,
73217,770055,0,0,0,15.36,,
73218,770067,8,0,8,24.48,,
73220,GK-414,0,0,0,9.30,,
73222,770001,0,0,0,9.67,,
73223,770002,10,0,10,14.23,,
73224,770003,0,0,0,21.07,,
73225,770007,0,0,0,11.95,,
73226,770035,0,0,0,29.04,,
73227,770295,0,0,0,112.83,,
73229,770297-1,0,0,0,20.49,,
73230,770297-2,0,0,0,33.03,,
73231,770298-1,0,0,0,25.63,,
73233,770298-2,1,0,1,41.59,,
73237,BP282,2,2,0,38.48,,
73242,770201,9,0,9,12.51,,
73243,770202,11,0,11,19.92,,
73244,770203,11,0,11,31.32,,
73245,770204,0,0,0,49.56,,
73246,770207,8,0,8,13.08,,
73250,0927DP0CHR,17,4,13,107.18,,
73251,0960DP0CHR,3,3,0,69.99,,
73252,8502DP,4,4,0,61.28,,
73253,0254B00DP1,2,1,1,51.97,,
73254,1181DP0CHR,0,0,0,50.75,,
73255,0947DP3CHR,3,0,3,43.57,,
73256,0947DP2CHR,18,10,8,37.73,,
73257,0931DP1BLK,10,5,5,37.04,,
73258,903000,1,1,0,21.63,,
73259,903001,2,0,2,19.35,,
73260,903002,0,0,0,7.97,,
73261,903003,1,0,1,24.55,,
73262,710215-1,28,28,0,68.18,,
73263,903007,0,0,0,27.91,,
73264,770030-1,8,8,0,48.69,,
73265,903008,1,0,1,23.91,,
73267,903011,0,0,0,27.91,,
73268,903018,0,0,0,31.89,,
73270,1421DP2CHR,4,4,0,35.83,,
73271,740158-1NB,146,146,0,162.41,,
73272,1092DP1BLK,1,1,0,36.94,,
73273,1134DP0CHR,1,1,0,31.68,,
73274,1137DP0CHR,4,4,0,31.68,,
73275,1634DP0CHR,5,0,5,31.00,,
73276,1637DP0CHR,8,3,5,31.00,,
73277,0323DP,0,0,0,30.32,,
73279,HX890BK,122,93,29,200.27,,
73280,HX890NB,59,33,26,200.27,,
73281,F16-0091,4,2,2,56.90,,
73282,010-10553-00,4,0,4,20.30,,
73283,MVP-J-G-XXL,0,0,0,175.50,,
73284,MVP-J-G-L,0,0,0,175.50,,
73285,MVP-J-G-M,0,0,0,175.50,,
73290,480213,0,0,0,66.87,106.99,
73291,0932DP1BLK,0,0,0,30.11,,
73292,0932DP2BLK,5,5,0,30.11,,
73296,1440DP2CHR,16,10,6,29.43,,
73297,0956DP4CHR,2,2,0,22.32,,
73298,1318DPGBLK,24,10,14,21.28,,
73299,1319DPGBLK,0,0,0,21.28,,
73300,1101DP0CHR,1,1,0,19.92,,
73301,1198DP2CHR,11,10,1,15.92,,
73302,0481DP0BLK,10,0,10,11.64,,
73303,1125DP499A,3,3,0,80.23,,
73304,1125DP4CHR,5,4,1,101.25,,
73305,0052DP,11,1,10,11.55,,
73306,1269DP099A,7,6,1,10.44,,
73307,1223DP0CHR,0,0,0,9.93,,
73308,1199DP3CHR,20,0,20,9.92,,
73309,1199DP2CHR,11,11,0,9.65,,
73310,1199DP1CHR,20,0,20,8.89,,
73311,1287DP1CHR,20,0,20,8.89,,
73312,0492DP0STS,16,10,6,8.79,,
73313,0502DP2STS,0,0,0,9.41,,
73314,1242DP0CHR,8,4,4,5.99,,
73315,0330DP2CHR,8,0,8,4.99,,
73316,0502DP1STS,11,11,0,7.57,,
73317,0024DP1,0,0,0,6.22,,
73319,0477DP0BLK,0,0,0,6.23,,
73321,0610DP0CHR,0,0,0,4.88,,
73325,W736-SS,0,0,0,10.26,,
73331,RA2012010000,2,0,2,484.30,535.50,
73332,RA2018010000,3,0,3,634.07,701.10,
73333,RA2050010000,3,2,1,1563.09,1889.10,
73338,VP1135R24V,8,4,4,41.11,,
73339,VP1135G24V,6,3,3,41.11,,
73374,MM3-VNA-033,0,0,0,454.55,,
73378,205113,0,0,0,33.31,,
73382,130900-701-004-19,14,8,6,67.11,,
73383,121900-505-004-19,17,11,6,37.14,,
73391,103000-500-000-12,0,0,0,19.62,,
73392,103000-500-001-12,0,0,0,19.62,,
73393,103000-500-002-12,7,7,0,19.62,,
73394,103000-500-004-12,6,6,0,19.62,,
73395,103000-500-005-12,4,2,2,19.62,,
73402,103000-100-000-12,2,1,1,19.62,,
73403,103000-100-001-12,3,0,3,19.62,,
73404,103000-100-002-12,1,0,1,19.62,,
73405,103000-100-004-12,11,5,6,19.62,,
73406,103000-100-005-12,5,0,5,19.62,,
73408,152200-200-024-13,8,2,6,92.86,,
73422,"SILVERSTEER 1TB",0,0,0,1391.83,,
73425,"SILVERSTEER 2TB",4,3,1,1391.83,,
73426,SILVERSTEER1.0B,3,1,2,1154.30,,
73455,01-03-011,3,2,1,59.65,,
73456,01-03-012,2,2,0,60.96,,
73457,01-03-013,1,0,1,77.72,,
73458,01-03-014,2,2,0,79.77,,
73459,01-04-015,4,2,2,30.47,,
73460,01-04-016,4,2,2,33.54,,
73461,01-04-017,3,1,2,35.73,,
73462,01-04-018,0,0,0,37.92,,
73463,01-04-019,5,3,2,39.95,,
73464,01-66-025,2,1,1,13.81,,
73465,01-66-037,1,0,1,37.35,,
73466,01-69-041,2,2,0,97.82,,
73482,03-01-001,3,2,1,110.30,,
73483,03-01-002,0,0,0,111.35,,
73484,03-01-003,0,0,0,125.32,,
73488,03-01-004,0,0,0,127.39,,
73490,03-01-005,1,1,0,90.98,,
73492,03-01-006,0,0,0,93.21,,
73495,03-01-015,0,0,0,110.30,,
73497,03-01-016,1,0,1,111.35,,
73505,104300-100-001-19,5,5,0,17.99,,
73506,03-02-007,0,0,0,491.90,,
73507,03-02-008,0,0,0,517.77,,
73508,03-02-009,0,0,0,443.15,,
73509,03-02-010,0,0,0,466.63,,
73510,03-66-011,0,0,0,26.17,,
73511,03-66-012,1,1,0,53.52,,
73512,04-01-001,1,1,0,74.92,,
73513,04-01-002,0,0,0,77.01,,
73514,04-01-003,0,0,0,89.94,,
73515,04-01-004,1,1,0,80.65,,
73520,04-01-005,0,0,0,119.96,,
73521,04-01-006,0,0,0,122.05,,
73525,04-03-009,0,0,0,104.96,,
73526,04-03-010,0,0,0,107.33,,
73527,04-66-015,0,0,0,25.45,,
73529,07-01-001,2,1,1,178.01,,
73531,07-01-002,0,0,0,192.74,,
73532,07-01-003,1,0,1,178.01,,
73534,07-02-004,2,1,1,292.44,,
73536,07-02-005,0,0,0,298.06,,
73539,07-02-006,1,1,0,311.10,,
73540,07-02-007,0,0,0,316.58,,
73541,07-02-008,1,1,0,292.44,,
73542,07-02-009,0,0,0,298.06,,
73545,07-03-010,2,1,1,275.70,,
73547,07-03-011,0,0,0,316.58,,
73548,07-03-012,0,0,0,278.57,,
73549,07-03-013,0,0,0,315.99,,
73550,07-02-043,1,0,1,324.58,,
73551,07-02-044,0,0,0,333.32,,
73552,07-03-045,0,0,0,341.92,,
73553,07-03-046,0,0,0,305.19,,
73554,07-04-014,0,0,0,541.08,,
73555,07-04-015,0,0,0,541.08,,
73556,07-04-016,1,0,1,485.21,,
73557,07-04-017,1,0,1,479.99,,
73558,07-66-018,0,0,0,68.53,,
73559,07-66-019,2,2,0,169.18,,
73560,07-66-020,0,0,0,169.18,,
73561,07-66-021,0,0,0,184.63,,
73562,07-66-022,0,0,0,184.63,,
73563,07-66-023,0,0,0,16.35,,
73567,07-66-024,0,0,0,89.94,,
73568,07-66-025,0,0,0,58.87,,
73569,07-66-027,0,0,0,16.06,,
73570,07-66-028,0,0,0,17.25,,
73595,07-66-029,0,0,0,20.36,,
73597,07-66-031,0,0,0,47.16,,
73598,07-66-032,2,2,0,79.24,,
73599,07-66-033,0,0,0,83.55,,
73606,07-66-034,0,0,0,55.60,,
73607,07-99-035,1,0,1,29.73,,
73608,07-99-036,0,0,0,35.67,,
73609,07-99-037,0,0,0,84.74,,
73611,07-99-042,0,0,0,130.19,,
73622,08-01-024,0,0,0,401.53,,
73623,08-01-025,0,0,0,446.27,,
73624,08-01-026,0,0,0,491.16,,
73625,08-01-027,0,0,0,531.60,,
73626,08-01-028,2,1,1,444.19,,
73632,710274-1,8,4,4,71.42,,
73633,710295-1,0,0,0,166.67,,
73634,710280-1,3,0,3,204.55,,
73635,710297-1,4,4,0,166.67,,
73636,710282-1,0,0,0,325.78,,
73637,710285-1,0,0,0,83.33,,
73638,710290-1,3,0,3,204.55,,
73639,710276-1,0,0,0,84.41,,
73640,710275-1,7,3,4,71.42,,
73641,710287-1,0,0,0,106.06,,
73642,710286-1,0,0,0,90.91,,
73643,710277-1,5,0,5,71.42,,
73646,710296-1,0,0,0,159.09,,
73647,710281-1,0,0,0,204.55,,
73648,710298-1,0,0,0,159.09,,
73649,710283-1,0,0,0,325.78,,
73650,09-02-005,0,0,0,404.74,,
73652,09-02-006,0,0,0,404.74,,
73653,09-02-007,0,0,0,421.83,,
73655,09-02-008,0,0,0,421.83,,
73656,710291-1,0,0,0,204.55,,
73659,09-02-011,0,0,0,327.75,,
73660,09-02-012,0,0,0,327.75,,
73661,09-02-013,0,0,0,342.15,,
73662,09-02-014,0,0,0,342.15,,
73663,09-66-015,0,0,0,42.22,,
73664,09-66-016,0,0,0,42.22,,
73665,09-66-017,0,0,0,49.21,,
73666,10-02-001,0,0,0,53.33,,
73667,10-02-002,0,0,0,57.64,,
73669,10-02-003,0,0,0,131.01,,
73670,710278-1,3,2,1,71.42,,
73671,10-02-004,0,0,0,132.39,,
73672,710279-1,0,0,0,103.89,,
73673,10-02-005,0,0,0,166.72,,
73674,710284-1,3,3,0,363.66,,
73675,10-02-006,0,0,0,170.85,,
73677,10-03-007,0,0,0,137.02,,
73678,10-03-008,0,0,0,140.15,,
73679,10-03-009,0,0,0,178.08,,
73680,10-03-010,0,0,0,180.16,,
73681,10-01-011,0,0,0,164.30,,
73682,10-01-012,0,0,0,167.24,,
73683,10-01-013,0,0,0,164.30,,
73684,10-01-014,0,0,0,167.24,,
73685,740181-1,6,0,6,34.08,,
73686,740182-1,0,0,0,34.08,,
73687,740183-1,11,0,11,34.08,,
73688,740179-1,0,0,0,53.02,,
73689,780038-1,0,0,0,33.33,,
73690,740184-1,3,3,0,20.76,,
73700,DPT-R,1,0,1,414.20,,
73701,DPT-S-PLATE-02,0,0,0,145.69,,
73702,DPT-R-PLATE-01,4,2,2,78.19,,
73703,DPT-LB-01,2,1,1,168.19,,
73728,0162,2,2,0,30.15,,
73729,0163,0,0,0,30.15,,
73730,0375,13,13,0,10.98,,
73731,0376,8,8,0,11.10,,
73732,0377,2,2,0,15.20,,
73733,0378,3,3,0,15.53,,
73738,1355935,3,0,3,297.37,,
73739,1355963,1,0,1,486.61,,
73764,1358994,0,0,0,2625.00,,
73770,1355964,0,0,0,516.60,,
73771,1355979,0,0,0,607.23,,
73776,MILREM80,0,0,0,80.87,124.95,
73777,MILLEDPWR,2,1,1,69.99,,
73799,A06072,0,0,0,68.17,,
73801,A06077,5,2,3,25.56,,
73806,7315,0,0,0,59.30,,
73809,BPJDE2,0,0,0,463.20,579.00,
73812,SA-339-WHT,7,3,4,43.69,,
73814,360-004,18,6,12,35.35,,
73816,010-12117-06,0,0,0,14.99,,
73817,93070,8,5,3,19.37,,
73818,5624,0,0,0,12.69,,
73819,38023500,0,0,0,3426.90,,
73821,25-742-BL,0,0,0,59.53,,
73822,25-742-WHT,0,0,0,62.44,,
73823,35-741-BL,0,0,0,66.60,,
73824,35-741-WHT,0,0,0,66.60,,
73825,35-742-BL,2,2,0,62.44,,
73826,35-742-WHT,0,0,0,66.60,,
73828,45-741-BL,0,0,0,66.60,,
73830,7310,0,0,0,59.30,,
73844,TR3,5,1,4,390.20,,
73845,TR8,0,0,0,1293.87,,
73847,"TR3 SSP",4,2,2,48.28,,
73848,"TR8 SSP",0,0,0,59.77,,
73850,118158,1,0,1,27.78,,
73852,119177,0,0,0,61.46,,
73856,118821,0,0,0,73.40,,
73869,68200,0,0,0,187.24,299.59,
73870,68201,0,0,0,187.24,299.59,
73871,68202,0,0,0,187.24,299.59,
73873,68204,0,0,0,187.24,299.59,
73874,68210,0,0,0,213.99,342.39,
73875,68211,0,0,0,213.99,342.39,
73891,23003,0,0,0,20.88,,
73892,10052-32GA,35,35,0,14.03,,
73893,10190G40,13,8,5,11.10,,
73896,ML-005NWW,0,0,0,29.48,,
73897,S00-00522-08,1,0,1,12.69,,
73898,GP2080-17,0,0,0,385.44,,
73901,DPT-OA,2,1,1,493.47,,
73902,DPT-OA-PLATE-01,2,2,0,111.94,,
73905,DPT-R-PLATE-02,0,0,0,78.19,,
73908,DPT-C-PLATE-01,4,2,2,127.13,,
73909,DPT-C-PLATE-02,1,0,1,127.13,,
73912,DPT-S-PLATE-01,0,0,0,100.69,,
73913,DPT-S-PLATE-03,0,0,0,213.19,,
73952,F16-2500,5,3,2,39.40,,
73958,F16-3000,8,2,6,54.08,,
73964,17201203,0,0,0,1411.59,,
73966,HCE50K,36,33,3,27.51,,
73967,HCE75K,11,9,2,33.63,,
73972,G190200,2,0,2,18.56,,
73976,G191419,24,0,24,5.81,,
73980,G190315,0,0,0,9.43,,
73982,G190526,10,3,7,16.01,,
73984,010-12743-00,4,3,1,14.60,,
73985,010-12745-00,8,4,4,14.60,,
73986,010-12817-00,3,2,1,11.68,,
73987,010-12830-00,1,0,1,11.68,,
74003,SP-67739-T,2,2,0,34.23,,
74006,DBP6,0,0,0,22.79,,
74010,P100790,0,0,0,99.35,,
74014,36032,3,1,2,123.19,,
74015,5022,0,0,0,1.65,,
74016,E-4209-16,0,0,0,97.50,,
74017,010-12183-20,2,2,0,1912.49,,
74019,133316,0,0,0,17.38,26.97,
74020,133216,5,5,0,17.97,32.97,
74021,133116,6,0,6,19.82,34.97,
74022,133632,20,20,0,30.21,52.97,
74063,010-01876-00,0,0,0,174.99,,
74067,010-12548-03,0,0,0,18.74,,
74071,53800,11,5,6,98.20,184.99,
74076,MDA-5,4,2,2,909.30,,
74079,27637,0,0,0,192.07,319.99,
74080,27638,0,0,0,192.07,319.99,
74081,27580,18,9,9,170.16,314.99,
74082,10161A40,12,4,8,11.40,,
74083,10162A40,8,3,5,13.06,,
74084,10160A40,14,3,11,10.34,,
74085,010-12530-03,0,0,0,27.99,,
74087,010-12530-00,225,43,182,8.00,,
74089,10003GA,9,5,4,11.00,,
74091,81205200,1,1,0,499.99,,
74093,16720A,1,0,1,9.76,,
74095,29542,4,4,0,4.55,,
74096,29543,13,11,2,5.15,,
74097,29554,14,5,9,4.65,,
74098,29791,34,4,30,18.38,,
74099,10800A,13,0,13,5.28,,
74100,10801A,15,14,1,5.38,,
74101,010-12771-01,0,0,0,67.99,,
74102,010-12771-00,4,3,1,39.99,,
74112,9030,0,0,0,102.44,,
74114,ME-01-210-60,21,3,18,115.85,,
74115,MF-02-310-24,3,3,0,103.47,,
74116,MF-05-550-24,0,0,0,203.95,,
74117,MG-01-110-70,8,0,8,36.90,,
74118,93-402,11,11,0,15.99,,
74119,97-50-310-12,0,0,0,21.94,,
74129,S72-0636-01,1,0,1,284.47,,
74141,GP1080-23,0,0,0,385.44,,
74142,RMX300-BK,2,2,0,26.11,,
74150,68711,0,0,0,118.50,,
74166,GP1352,45,38,7,29.62,,
74167,GP1002,20,0,20,22.99,,
74168,GP1652,57,50,7,28.22,,
74170,010-12519-60,1,0,1,13.61,,
74172,010-11029-19,0,0,0,19.99,,
74173,BB-3,1,0,1,52.78,,
74174,12835,5,0,5,41.66,,
74179,FFC-500,19,12,7,9.44,,
74180,FFC-750,7,6,1,13.89,,
74181,FFC-1000,5,2,3,19.44,,
74182,FFC-1125,4,0,4,18.33,,
74183,FFC-1250,6,4,2,31.67,,
74184,FFC-1500,5,5,0,40.56,,
74185,FFC-2000,2,0,2,102.78,,
74186,IBV-250,3,3,0,13.33,,
74187,IBV-375,18,2,16,13.33,,
74188,IBV-500,24,14,10,18.33,,
74189,IBV-750,0,0,0,21.67,,
74190,IBV-1000,12,4,8,40.00,,
74191,IBV-1250,17,9,8,53.89,,
74192,IBV-1500,13,7,6,76.11,,
74193,010-12166-02,0,0,0,14.99,,
74194,IBV-2000,3,3,0,128.89,,
74195,IBV-250-S,0,0,0,31.11,,
74196,IBV-375-S,2,0,2,24.99,,
74197,IBV-500-S,4,2,2,41.67,,
74198,IBV-750-S,3,1,2,43.89,,
74199,IBV-1000-S,6,1,5,46.67,,
74200,IBV-1250-S,1,1,0,72.78,,
74201,IBV-1500-S,1,0,1,95.00,,
74202,IBV-2000-S,4,0,4,121.67,,
74203,FFL12W,0,0,0,27.50,28.45,
74204,FFL12G,0,0,0,27.50,33.20,
74207,29712,0,0,0,7.55,,
74208,10700A,33,0,33,3.98,,
74209,10701A,60,48,12,4.09,,
74210,10705A,34,18,16,5.76,,
74222,11052A,0,0,0,3.10,,
74230,IBVF-750,4,1,3,32.22,,
74231,IBVF-1000,1,0,1,35.00,,
74232,IBVF-1250,2,2,0,39.44,,
74233,IBVF-1500,5,2,3,51.11,,
74234,IBVF-2000,0,0,0,62.22,,
74235,IBVF-750-S,0,0,0,43.89,,
74236,IBVF-1000-S,0,0,0,47.78,,
74238,IBVF-1250-S,0,0,0,51.11,,
74239,IBVF-1500-S,0,0,0,57.78,,
74241,IBVF-2000-S,2,1,1,65.56,,
74247,PNC-500,8,8,0,14.44,,
74248,PNC-750,8,6,2,16.11,,
74249,PNC-1000,11,1,10,20.56,,
74250,PNC-1250,0,0,0,28.89,,
74251,PNC-1500,12,8,4,22.99,,
74252,PNC-2000,0,0,0,40.56,,
74253,PTH-500,0,0,0,4.44,,
74254,PTH-5062,7,1,6,4.44,,
74255,PTH-750,24,24,0,5.00,,
74256,PTH-1000,13,10,3,7.22,,
74257,PTH-1125,9,6,3,11.67,,
74258,PTH-1250,12,6,6,12.78,,
74259,PTH-1500,8,1,7,16.11,,
74260,PTH-2000,3,2,1,21.67,,
74265,PTH-750-S,3,2,1,8.89,,
74266,PTH-1000-S,0,0,0,12.22,,
74267,PTH-1250-S,4,2,2,16.67,,
74268,PTH-1500-S,7,4,3,20.56,,
74269,PTH-2000-S,0,0,0,34.44,,
74274,PTHC-750,0,0,0,8.33,,
74275,PTHC-1000,18,4,14,12.78,,
74276,PTHC-1125,3,0,3,17.22,,
74277,PTHC-1250,0,0,0,18.89,,
74278,PTHC-1500,3,0,3,26.11,,
74279,PTHC-2000,0,0,0,37.78,,
74289,TH-500-W,22,10,12,11.67,,
74290,TH-750-W,9,0,9,12.78,,
74291,TH-1000-W,13,4,9,18.33,,
74292,TH-1250-W,11,4,7,30.56,,
74293,TH-1500-W,28,11,17,39.44,,
74298,TH-2000-W,2,1,1,58.89,,
74299,TH-500-WS,10,6,4,12.22,,
74300,TH-750-WS,7,2,5,11.67,,
74301,TH-1000-WS,2,0,2,33.33,,
74302,TH-1250-WS,2,2,0,37.22,,
74303,TH-1500-WS,2,2,0,38.33,,
74304,TH-2000-WS,7,3,4,52.22,,
74318,LLB-32KW-01-00,1,1,0,35.12,,
74320,LLB-32LW-01-00,0,0,0,40.61,,
74334,97001,0,0,0,18.57,,
74335,97002,7,3,4,22.86,,
74370,"FBVE-750 12V",0,0,0,1402.78,,
74371,"FBVE-750 24V",0,0,0,1408.33,,
74372,"FBVE-1000 12V",0,0,0,1419.44,,
74373,"FBVE-1000 24V",0,0,0,1425.00,,
74374,"FBVE-1250 12V",2,0,2,1439.44,,
74375,"FBVE-1250 24V",0,0,0,1445.00,,
74376,"FBVE-1500 12V",2,0,2,1523.89,,
74377,"FBVE-1500 24V",2,1,1,1529.44,,
74378,"FBVE-2000 12V",0,0,0,1605.56,,
74379,"FBVE-2000 24V",0,0,0,1611.11,,
74380,"FBVE-2500 12V",0,0,0,2001.67,,
74381,"FBVE-2500 24V",0,0,0,2007.22,,
74382,"FBVE-3000 12V",0,0,0,2153.89,,
74383,"FBVE-3000 24V",0,0,0,2159.44,,
74384,LCD-5,0,0,0,1478.33,,
74385,FBV-750,8,0,8,44.44,,
74386,FBV-1000,4,4,0,61.11,,
74387,FBV-1250,3,2,1,75.00,,
74388,FBV-1500,5,3,2,101.11,,
74389,FBV-2000,4,4,0,163.89,,
74390,HF-B,3,1,2,494.44,,
74391,K-H,1,0,1,1411.11,,
74392,"K-H 12V",0,0,0,2280.56,,
74393,"K-H 24V",0,0,0,2291.67,,
74394,970-1500-12,4,0,4,2234.44,,
74395,APHS-1250-1,2,1,1,114.44,,
74396,APHS-2000-1,0,0,0,161.67,,
74397,APHS-3000-1,1,1,0,281.67,,
74398,BVS-750,6,3,3,502.22,,
74399,BVS-1000,5,5,0,615.00,,
74400,BVS-1250,4,0,4,817.22,,
74401,BVS-1500,1,0,1,699.99,,
74402,"CP-20 12V",0,0,0,230.56,,
74403,CV-50,4,2,2,16.67,,
74404,CV-75,0,0,0,19.44,,
74405,CV-100,4,2,2,26.11,,
74406,CV-125,0,0,0,48.33,,
74407,CV-150,0,0,0,73.89,,
74408,CV-200,0,0,0,110.56,,
74409,FV-250,14,1,13,13.89,,
74410,FV-375,5,5,0,13.89,,
74411,FV-500,8,0,8,21.67,,
74412,FV-750,7,4,3,26.67,,
74413,FV-590,2,2,0,16.11,,
74414,FV-590-S,10,9,1,26.67,,
74415,FV-450-X,4,2,2,75.56,,
74416,FV-550-L,6,2,4,95.00,,
74417,FV-65038,5,4,1,138.89,,
74431,12VBRS2,0,0,0,16.50,,
74437,P100791,0,0,0,108.70,,
74441,BHW4050,0,0,0,77.94,,
74442,41656,1,0,1,193.42,349.99,
74443,41657,2,0,2,49.74,89.99,
74444,41658,4,4,0,57.07,99.99,
74445,41659,0,0,0,93.75,149.99,
74446,41660,2,1,1,136.49,,
74450,41665,0,0,0,134.37,214.99,
74463,133632CASE,1,1,0,362.46,635.64,
74464,133116CASE,1,0,1,118.92,209.82,
74465,133216CASE,0,0,0,107.85,197.83,
74466,133316CASE,0,0,0,104.31,161.82,
74470,"A-2 WHITE",16,10,6,53.07,,
74471,"A-3 WHITE",15,5,10,71.04,,
74474,"A-1 WHITE",0,0,0,38.34,,
74479,10980,43,15,28,6.07,,
74483,29532,6,0,6,19.05,,
74488,10211G,21,0,21,4.94,,
74499,TM185HW,1,1,0,1066.67,,
74500,MMC-10F-HM,3,1,2,95.00,,
74501,MMC-10F-L,0,0,0,95.00,,
74502,TM185C-HW-MM,0,0,0,1020.17,,
74516,RA1225HP,5,0,5,89.99,,
74517,RA1206CR,2,1,1,59.99,,
74521,RA1206NY,2,2,0,44.99,,
74522,RA115,1,1,0,13.99,,
74523,CBL-LU-2000,0,0,0,17.38,,
74525,CBL-MU-2000,1,1,0,17.38,,
74529,1908016,0,0,0,79.06,,
74536,GP1040-16,0,0,0,334.53,,
74541,13851,2,2,0,173.41,,
74542,13751,1,1,0,175.05,,
74544,HE-RGBSAC-1,5,1,4,35.01,,
74548,10070014,1,0,1,342.84,,
74569,S-8235C,1,1,0,49.99,,
74571,010-12855-00,2,0,2,63.74,,
74573,905513BLK,4,2,2,218.75,349.99,
74574,110213BLK,0,0,0,289.68,463.49,
74575,202513BLK,0,0,0,148.06,236.89,
74578,13004,0,0,0,23.53,,
74579,91003,0,0,0,49.19,,
74580,EVO-1212F-HW,0,0,0,696.25,1004.80,
74581,EVO-1224F,0,0,0,696.25,1004.80,
74582,EVO-1224F-HW,0,0,0,696.25,1004.80,
74583,EVO-RC-PLUS,2,2,0,111.93,161.50,
74585,482033,0,0,0,100.00,159.99,
74589,23006,2,0,2,20.03,,
74591,90513,0,0,0,43.03,,
74602,UMS108WR,1,1,0,149.95,269.99,
74604,UMS108SR,1,1,0,149.95,269.99,
74611,UMS77BR,6,4,2,209.95,359.99,
74612,UMS77SR,2,2,0,150.99,429.99,
74614,UMS88BR,2,2,0,309.09,409.99,
74634,SP201RG,8,4,4,105.82,,
74635,MA7020G,18,11,7,95.24,,
74636,SB44G2,29,14,15,19.40,,
74637,SB44G1,18,18,0,19.40,,
74639,MA4052LG1,15,7,8,32.88,,
74640,CVC620WPT,0,0,0,147.50,,
74662,13752,3,3,0,207.76,,
74664,13852,0,0,0,220.31,,
74665,1038,10,5,5,41.11,,
74666,KTF0184,2,1,1,222.20,,
74667,1046,11,8,3,41.11,,
74668,12851,0,0,0,192.00,,
74669,KTF0182,2,1,1,176.25,,
74670,33005,8,4,4,64.34,,
74671,91106,0,0,0,22.93,,
74672,13795,0,0,0,153.10,,
74673,KTF063,2,2,0,300.49,,
74682,RA38M,0,0,0,18.56,,
74691,55010,3,3,0,6.74,,
74692,AH-100,3,0,3,72.03,,
74694,HH,4,0,4,15.68,,
74698,H002F00,0,0,0,64.46,,
74699,H003F00,2,0,2,19.62,,
74703,TDH-900,0,0,0,320.04,,
74704,17-59,2,0,2,94.21,,
74705,300-34,4,0,4,52.24,,
74706,300-35,1,0,1,104.97,,
74707,303-09,3,0,3,51.47,,
74708,32-97,3,0,3,295.49,,
74709,34-46,2,0,2,22.67,,
74710,34-48,2,0,2,46.51,,
74711,36-01,0,0,0,130.19,,
74714,45-06,0,0,0,74.46,,
74715,504-05,0,0,0,53.12,,
74716,504-11,1,0,1,63.40,,
74717,504-62,1,1,0,132.50,,
74718,504-82,2,0,2,153.56,,
74721,GP0629B,0,0,0,576.62,,
74724,505-05,0,0,0,61.73,,
74727,505-11,1,0,1,71.60,,
74731,506-05,1,0,1,73.88,,
74732,506-44,0,0,0,59.33,,
74734,70-74,2,0,2,131.15,,
74735,70-75,1,0,1,139.59,,
74737,704-05,0,0,0,80.51,,
74738,704-11,1,0,1,91.19,,
74739,704-62,0,0,0,159.46,,
74740,704-92,0,0,0,205.06,,
74741,705-05,0,0,0,104.97,,
74742,705-92,0,0,0,223.44,,
74744,72-49,2,0,2,109.23,,
74746,74-35,4,0,4,6.06,,
74748,74-35-G,3,0,3,6.06,,
74749,74-36,6,0,6,6.06,,
74751,74-36-G,2,0,2,6.06,,
74753,77-18,2,0,2,7.99,,
74754,010-12833-10,8,3,5,202.49,,
74756,78-01,0,0,0,31.71,,
74757,010-02011-00,2,1,1,215.99,,
74758,78-02,0,0,0,40.38,,
74759,010-02011-01,0,0,0,215.99,,
74761,78-03,0,0,0,22.79,,
74762,78-05,0,0,0,28.76,,
74763,78-07,0,0,0,57.03,,
74764,78-17,2,0,2,75.87,,
74765,78-83,2,2,0,181.19,,
74769,63259,0,0,0,22.04,,
74770,63223,3,1,2,14.15,,
74773,63300,0,0,0,34.81,,
74774,R599C-LM,0,0,0,4422.78,,
74775,13130,2,1,1,41.66,,
74778,RAM33,0,0,0,17.01,,
74779,RAA33,0,0,0,26.44,,
74780,RA24M,0,0,0,18.70,,
74781,RA24A,0,0,0,24.61,,
74782,SWV-100-RD-U,0,0,0,194.06,,
74783,SWV-100-HV-U,0,0,0,194.06,,
74789,80307,0,0,0,52.41,,
74790,AB-1100-PRO-BK-S,0,0,0,239.06,,
74791,AB-1100-PRO-BK-M,0,0,0,239.06,,
74792,AB-1100-PRO-BK-L,0,0,0,239.06,,
74793,AB-1100-PRO-BK-XL,0,0,0,239.06,,
74794,AB-1100-PRO-BK-2XL,0,0,0,239.06,,
74795,AB-1100-PRO-NV-S,0,0,0,239.06,,
74796,AB-1100-PRO-NV-M,0,0,0,239.06,,
74797,AB-1100-PRO-NV-L,0,0,0,239.06,,
74798,AB-1100-PRO-NV-XL,0,0,0,239.06,,
74799,AB-1100-PRO-NV-2XL,0,0,0,239.06,,
74801,AB-1100-PRO-GN-S,0,0,0,239.06,,
74802,AB-1100-PRO-GN-M,0,0,0,239.06,,
74803,AB-1100-PRO-GN-L,0,0,0,239.06,,
74804,AB-1100-PRO-GN-XL,0,0,0,239.06,,
74805,AB-1100-PRO-GN-2XL,0,0,0,239.06,,
74806,FWBH-RD-S/M,0,0,0,55.13,,
74807,FWBH-HV-S/M,4,4,0,55.13,,
74808,FWBH-GN-S/M,0,0,0,55.13,,
74809,FWBH-BK-S/M,0,0,0,55.13,,
74810,FWBH-RD-L/XL,4,4,0,55.13,,
74811,FWBH-HV-L/XL,11,11,0,55.13,,
74812,FWBH-GN-L/XL,0,0,0,55.13,,
74813,FWBH-BK-L/XL,5,5,0,55.13,,
74814,MVP-J-G-S,0,0,0,175.50,,
74815,MVP-J-G-XXXL,0,0,0,175.50,,
74816,MVP-J-BK-S,0,0,0,175.50,,
74817,MVP-J-BK-M,0,0,0,175.50,,
74818,MVP-J-BK-L,0,0,0,175.50,,
74819,MVP-J-BK-XL,0,0,0,175.50,,
74820,MVP-J-BK-2XL,0,0,0,175.50,,
74821,BHW4035,0,0,0,56.28,,
74822,MVP-J-BK-3XL,0,0,0,175.50,,
74823,MVP-J-HV-S,0,0,0,175.50,,
74824,MVP-J-HV-M,0,0,0,175.50,,
74825,MVP-J-HV-L,0,0,0,175.50,,
74826,MVP-J-HV-XL,0,0,0,175.50,,
74827,MVP-J-HV-2XL,0,0,0,175.50,,
74828,MVP-J-HV-3XL,0,0,0,175.50,,
74831,34001,0,0,0,802.49,1283.99,
74836,MVP-BP-BK-S,0,0,0,157.50,,
74838,MVP-BP-BK-M,0,0,0,157.50,,
74839,MVP-BP-BK-L,0,0,0,157.50,,
74840,MVP-BP-BK-XL,0,0,0,157.50,,
74841,MVP-BP-BK-2XL,0,0,0,157.50,,
74842,MVP-BP-BK-3XL,0,0,0,157.50,,
74844,LLB-51WO-91-10,5,3,2,127.06,,
74845,HBV-100-BK-M-XL,0,0,0,235.13,,
74846,HBV-100-BK-XL-3XL,0,0,0,248.63,,
74847,HBV-100-RD-M-XL,0,0,0,235.13,,
74848,HBV-100-RD-XL-3XL,0,0,0,248.63,,
74849,HBV-100-HV-M-XL,2,2,0,189.99,,
74850,HBV-100-HV-XL-3XL,0,0,0,248.63,,
74851,1850,5,2,3,283.52,,
74853,010-12167-00,0,0,0,3.75,,
74854,701S-00618,0,0,0,180.75,,
74860,SN0015,0,0,0,120.53,,
74864,9160,2,2,0,12.01,,
74865,S-0226SO,0,0,0,4.08,,
74866,S-0226SL,21,12,9,4.08,,
74867,S-0226A,4,4,0,4.16,,
74868,S-0226LO,8,6,2,4.68,,
74881,SSM-76H,9,4,5,43.06,,
74898,FASP4881TVCFA00,0,0,0,350.47,,
74903,MFR-7,2,2,0,1599.99,,
74904,MFR-3,2,2,0,899.99,,
74907,13715,1,0,1,46.95,,
74909,40020156,2,0,2,923.77,,
74919,KTF064,0,0,0,300.49,,
74921,5257-S,11,2,9,59.64,,
74922,PL-259-ER,20,9,11,9.04,,
74923,4078-20-ER,6,6,0,47.49,,
74931,RL-521,0,0,0,10.55,,
74932,RLS-407,0,0,0,19.69,,
74933,RLS-521-401,0,0,0,40.50,,
74934,RLS-521-402,0,0,0,50.63,,
74937,RLS-521-407,1,0,1,51.75,,
74943,XT-DF-170-DV,0,0,0,803.57,984.00,
74945,XT-DF-170-DV-KIT,2,0,2,997.10,1220.00,
74946,XT-DF-170-J10,1,0,1,803.57,984.00,
74947,XT-DF-170-J10-KIT,0,0,0,997.10,1220.00,
74948,XT-DF-170-K6,3,0,3,803.57,984.00,
74949,XT-DF-170-K6-KIT,3,0,3,997.10,1220.00,
74950,XT-SF-170-DV,0,0,0,803.57,984.00,
74951,XT-SF-170-DV-KIT,1,0,1,997.10,1220.00,
74952,XT-SF-170-J10,2,0,2,803.57,984.00,
74953,XT-SF-170-J10-KIT,0,0,0,997.10,1220.00,
74954,XT-SF-170-K6,2,0,2,803.57,984.00,
74955,XT-SF-170-K6-KIT,2,0,2,997.10,1220.00,
74956,XT-VT-170-IR,0,0,0,477.25,539.00,
74957,XT-VT-170-K6,0,0,0,803.57,984.00,
74958,XT-VT-170-K6-KIT,2,0,2,997.10,1220.00,
74959,SG200,2,0,2,194.54,229.00,
74960,SG2-0100,2,0,2,112.83,128.00,
74961,SG2-0200,2,0,2,112.83,128.00,
74962,SG2-0300,3,0,3,48.65,54.99,
74963,SG2-0400,1,0,1,53.52,60.99,
74966,E70532-00-NAG,0,0,0,599.99,,
74970,E70532-05-NAG,0,0,0,679.99,,
74974,E70534-00-NAG,2,1,1,759.99,,
74976,E70534-05,4,2,2,679.99,,
74977,75155,0,0,0,8.96,,
74979,E70534-05-NAG,2,0,2,839.99,,
74983,E70536-00-NAG,0,0,0,1159.99,,
74987,64544,0,0,0,160.00,,
74989,E70536-05-NAG,0,0,0,1239.99,,
74991,10615-01,0,0,0,37.04,,
74993,80-47232-03,0,0,0,345.68,,
74995,A80557,0,0,0,46.86,,
75000,R70651,3,1,2,38.34,,
75002,A80604,0,0,0,354.61,,
75003,T70448,0,0,0,619.55,,
75004,A80562,1,1,0,70.82,,
75005,A80558,0,0,0,76.69,,
75006,A80559,0,0,0,85.22,,
75007,E70524,0,0,0,473.67,,
75008,E70516,0,0,0,552.62,,
75009,E70517,1,0,1,789.46,,
75010,A80615,0,0,0,1329.16,,
75011,T70450,0,0,0,1966.66,,
75012,T70451,1,1,0,1966.66,,
75013,A80560,0,0,0,46.86,,
75014,A80606,0,0,0,51.13,,
75029,42523-24V,0,0,0,29.86,,
75033,54061-24,16,4,12,2.69,,
75038,03-1033-4PK,7,6,1,26.00,,
75050,RMX4400-11,0,0,0,392.72,,
75056,STADIUMMW6520AM,1,1,0,219.99,349.95,
75061,STADIUMMW8030AM,0,0,0,320.68,449.95,
75063,STADIUMMW1000AM,2,2,0,264.99,399.95,
75064,KAPPA6120M,1,0,1,209.99,349.95,
75065,KAPPA6125M,0,0,0,240.53,349.95,
75066,KAPPA8130M,0,0,0,309.36,449.95,
75067,KAPPA8135M,2,0,2,247.99,449.95,
75068,KAPPA1010M,4,2,2,269.99,399.95,
75069,KAPPA1050M,4,2,2,179.99,399.95,
75084,01-0418-11,1,0,1,6799.99,,
75085,101584,6,2,4,82.67,,
75086,101585,5,1,4,76.13,,
75087,101586,10,5,5,479.14,,
75088,101587,4,0,4,479.14,,
75089,101554,0,0,0,48.74,,
75090,101555,0,0,0,48.74,,
75091,101556,0,0,0,48.74,,
75092,101574,4,2,2,48.74,,
75093,101575,5,3,2,48.74,,
75094,101576,2,2,0,48.74,,
75095,101577,5,3,2,145.92,,
75096,101578,2,2,0,145.92,,
75100,101596,2,0,2,56.08,,
75101,101597,6,2,4,56.08,,
75103,101448,8,5,3,948.61,,
75104,101449,4,2,2,1144.31,,
75105,OT-0318HD-VEL,3,2,1,1124.91,,
75106,OT-0318HD-BKA,4,2,2,1124.91,,
75108,4320,5,3,2,29.39,,
75109,4321,18,18,0,50.37,,
75110,4322,1,0,1,37.80,,
75111,4323,4,4,0,33.59,,
75112,4324,1,0,1,54.59,,
75113,4325,6,6,0,41.99,,
75114,4368,6,2,4,93.47,,
75115,4369,4,2,2,30.25,,
75116,6008,15,12,3,36.56,,
75117,6008200,8,5,3,36.56,,
75118,7440,15,10,5,24.27,,
75119,7441,0,0,0,24.27,,
75120,7442,5,1,4,24.27,,
75121,7443,7,2,5,24.27,,
75122,7444,1,0,1,24.27,,
75123,7445,11,5,6,24.27,,
75124,7446,13,7,6,24.27,,
75125,7454,6,6,0,24.27,,
75126,7455,0,0,0,24.27,,
75127,7456,12,7,5,24.27,,
75128,7457,11,6,5,24.27,,
75129,7458,9,6,3,24.27,,
75130,7459,11,9,2,24.27,,
75131,7870,2,2,0,29.06,,
75132,8300,0,0,0,13.59,,
75133,4363,8,5,3,37.62,,
75134,4364,5,5,0,17.68,,
75135,4365,10,6,4,50.92,,
75136,4366,1,1,0,75.85,,
75137,4367,4,4,0,20.54,,
75138,166100,0,0,0,278.85,,
75148,010-12799-12,10,0,10,82.49,,
75149,010-12799-02,8,0,8,22.49,,
75150,010-12798-02,10,10,0,41.24,,
75151,010-12799-11,6,4,2,63.74,,
75152,010-12799-01,3,0,3,18.74,,
75153,010-12798-01,0,0,0,29.98,,
75154,010-12799-10,0,0,0,56.24,,
75155,010-12799-00,12,6,6,14.99,,
75156,010-12798-00,0,0,0,29.98,,
75162,F38-6800D,15,5,10,140.78,,
75163,RM500B,7,7,0,59.10,,
75164,RM800B,11,4,7,81.17,,
75165,RM1100B,20,6,14,104.09,,
75166,RM500B-24,6,0,6,59.93,,
75168,RM800B-24,4,0,4,83.42,,
75169,RM1100B-24,2,0,2,107.90,,
75170,98B,7,5,2,127.14,,
75171,99B,9,6,3,130.05,,
75172,98B-24,7,4,3,130.05,,
75173,99B-24,12,4,8,133.14,,
75178,980503241,2,0,2,22.78,,
75179,980508241,4,2,2,17.09,,
75181,24DA-35A,9,3,6,44.67,,
75182,25DA-35A,21,12,9,59.69,,
75183,66A,23,10,13,16.22,,
75184,45DR,15,10,5,29.21,,
75185,GX1400B,87,0,87,136.18,,
75186,GX1400W,57,0,57,136.18,,
75187,GX1400GB,107,69,38,176.24,,
75188,GX1400GW,274,130,144,154.99,,
75191,GX1800GB,170,44,126,179.99,,
75192,GX1800GW,102,51,51,184.99,,
75193,GX1850B,135,57,78,216.30,,
75194,GX1850W,107,35,72,184.99,,
75195,A80513,15,15,0,17.03,,
75196,ARM102,0,0,0,98.01,,
75198,710292-1,6,2,4,325.78,,
75199,064-5140-7,0,0,0,23.29,,
75206,S2-6322,0,0,0,119.91,,
75207,S2-0329,0,0,0,119.91,,
75208,MGD-1XL,0,0,0,61.19,,
75209,A80580,0,0,0,174.99,,
75214,HTH-500,4,0,4,11.11,,
75215,HTH-625,9,9,0,14.44,,
75216,HTH-750,12,4,8,16.67,,
75217,HTH-1000,3,0,3,23.33,,
75218,HTH-1125,7,1,6,26.11,,
75219,HTH-1250,14,11,3,31.11,,
75220,HTH-1500,4,4,0,38.89,,
75221,HTH-2000,4,0,4,50.56,,
75222,HTH-500-S,18,9,9,21.67,,
75223,HTH-625-S,0,0,0,18.89,,
75224,HTH-750-S,11,2,9,18.89,,
75225,HTH-1000-S,18,5,13,22.78,,
75226,HTH-1125-S,18,4,14,23.33,,
75227,HTH-1250-S,21,12,9,38.33,,
75228,HTH-1500-S,15,6,9,46.67,,
75229,HTH-2000-S,7,3,4,57.78,,
75230,HVL-500,2,0,2,99.99,,
75231,HVL-750,1,0,1,146.11,,
75232,HVL-1000,4,2,2,146.11,,
75233,HVL-1500,3,2,1,163.33,,
75234,HVL-2000,6,2,4,177.78,,
75235,PN-500,9,5,4,5.00,,
75236,PN-750,0,0,0,6.11,,
75237,PN-1000,10,4,6,10.00,,
75238,PN-1250,20,10,10,17.78,,
75239,PN-1500,17,5,12,18.89,,
75240,PN-2000,9,5,4,26.67,,
75241,PN-2500,3,1,2,35.00,,
75242,PN-3000,1,1,0,65.00,,
75243,PN-4000,0,0,0,97.22,,
75244,PGN-50,29,6,23,15.00,,
75245,"PJR-A 12V",4,0,4,1938.33,,
75246,"PJR-A 24V",0,0,0,1949.44,,
75247,"PJR-B 12V",0,0,0,2262.78,,
75248,"PJR-B 24V",0,0,0,2273.89,,
75251,"PSR 115VAC",0,0,0,2476.11,,
75252,"PSR 230VAC",0,0,0,2466.11,,
75253,PST-1,3,1,2,180.00,,
75254,PST-2,2,2,0,255.00,,
75255,PST-3A,2,2,0,618.50,,
75256,PST-4,0,0,0,863.33,,
75257,PST-5,0,0,0,1020.56,,
75258,PST-6,0,0,0,488.89,,
75259,PTHC-5062,11,6,5,6.67,,
75261,PTHD-750,8,8,0,8.89,,
75262,PTHD-1000,20,9,11,11.67,,
75263,PTHD-1250,18,9,9,17.22,,
75264,PTHD-1500,9,4,5,25.56,,
75265,PTHD-2000,4,0,4,33.33,,
75266,PTHD-2500,2,2,0,61.67,,
75267,PTHD-3000,0,0,0,80.56,,
75268,RSC-1000,3,0,3,43.89,,
75269,RSC-2000,6,1,5,67.22,,
75272,RSC-4000,1,1,0,288.33,,
75275,010-02167-00,25,14,11,42.75,,
75276,010-02167-01,3,3,0,42.75,,
75277,010-12613-00,7,1,6,18.26,,
75278,010-12614-00,0,0,0,21.91,,
75279,010-12615-00,1,0,1,32.87,,
75280,010-12616-00,1,0,1,36.52,,
75281,010-12618-00,2,0,2,47.48,,
75282,010-12619-00,3,2,1,51.15,,
75283,010-12620-00,0,0,0,62.11,,
75284,010-12621-00,14,8,6,13.14,,
75285,010-12622-00,3,0,3,13.14,,
75287,010-12850-00,3,0,3,33.00,,
75295,010-12831-00,1,0,1,97.81,,
75296,010-12831-10,2,2,0,130.41,,
75297,010-12831-90,1,1,0,97.81,,
75300,010-12744-00,0,0,0,29.22,,
75301,010-12744-01,0,0,0,43.83,,
75302,010-12744-02,0,0,0,58.45,,
75305,SC-1000-L,6,3,3,20.56,,
75306,SC-1500-L,2,0,2,34.44,,
75307,SC-2500-L,5,3,2,61.67,,
75308,SC-1000,4,0,4,33.33,,
75309,SC-1500,4,2,2,68.33,,
75310,SC-2500,2,2,0,90.56,,
75311,12825,1,1,0,87.61,,
75313,"SPO-60-N 12V",3,2,1,340.56,,
75314,"SPO-60-N 24V",2,2,0,346.11,,
75315,"SPO-60-R 12V",0,0,0,503.33,,
75316,"SPO-60-R 24V",0,0,0,508.89,,
75321,"SPO-80-N 12V",0,0,0,737.78,,
75322,"SPO-80-N 24V",0,0,0,743.33,,
75323,"SPO-80-R 12V",0,0,0,950.00,,
75324,"SPO-80-R 24V",0,0,0,955.56,,
75329,STH-500-W,7,3,4,19.44,,
75330,STH-750-W,22,6,16,24.44,,
75331,STH-1000-W,23,17,6,33.33,,
75332,STH-1250-W,3,3,0,47.78,,
75333,STH-1500-W,10,3,7,53.33,,
75334,STH-2000-W,0,0,0,90.00,,
75335,STH-2500-W,4,2,2,131.11,,
75336,"STK-18 12V",2,2,0,274.15,,
75337,"STK-18 24V",2,1,1,279.02,,
75338,"STK-18 115VAC",5,2,3,275.61,,
75339,SW-2531,36,17,19,16.67,,
75340,TD-500,11,7,4,6.11,,
75341,TD-750,4,2,2,53.89,,
75342,THT-530,0,0,0,118.33,,
75343,THXL-750-W,14,13,1,21.67,,
75344,THXL-1000-W,5,4,1,27.78,,
75345,THXL-1250-W,1,0,1,44.44,,
75346,THXL-1500-W,3,3,0,47.78,,
75347,THXL-2000-W,5,3,2,66.11,,
75348,THXL-750-WS,8,4,4,31.67,,
75349,THXL-1000-WS,3,3,0,35.00,,
75350,THXL-1250-WS,1,0,1,42.22,,
75351,THXL-1500-WS,5,4,1,43.33,,
75352,THXL-2000-WS,6,3,3,46.67,,
75353,TS-350-T,3,0,3,148.33,,
75354,TWV-500,3,3,0,27.78,,
75355,TWV-750,6,4,2,34.44,,
75356,TWV-1500,5,2,3,146.11,,
75357,ULUBE-3,17,4,13,17.22,,
75358,WSB-500,0,0,0,31.11,,
75359,WSB-750,4,1,3,32.78,,
75360,WSB-1000,7,4,3,50.56,,
75361,WSB-1250,2,2,0,52.78,,
75362,WSB-500-P,3,1,2,33.89,,
75363,WSB-750-P,0,0,0,35.00,,
75364,WSB-1000-P,6,3,3,53.33,,
75365,WSB-1250-P,0,0,0,54.44,,
75371,SBV-1250-P,2,0,2,443.89,,
75372,SBV-1500-P,3,0,3,503.33,,
75373,SBV-2000-P,1,0,1,550.56,,
75374,SBV-2500-P,2,2,0,867.22,,
75375,SBV-3000-P,0,0,0,1395.00,,
75376,HSTH-750-W,15,8,7,12.22,,
75377,HSTH-1000-W,14,11,3,18.33,,
75378,HSTH-1250-W,14,9,5,33.33,,
75379,HSTH-1500-W,17,7,10,46.11,,
75380,HSTH-2000-W,4,2,2,53.89,,
75381,HSTH-2500-W,0,0,0,115.56,,
75382,HSTH-3000-W,0,0,0,157.78,,
75383,HSTH-4000-W,0,0,0,667.78,,
75384,HSTHXL-750-W,3,2,1,21.11,,
75385,HSTHXL-1000-W,1,1,0,31.11,,
75386,HSTHXL-1250-W,0,0,0,47.78,,
75387,HSTHXL-1500-W,0,0,0,51.11,,
75388,HSTHXL-2000-W,0,0,0,69.44,,
75389,HTHC-750-S,4,0,4,30.00,,
75390,HTHC-1000-S,9,4,5,37.22,,
75391,HTHC-1250-S,2,0,2,56.67,,
75392,HTHC-1500-S,3,2,1,103.33,,
75393,HTHC-2000-S,0,0,0,94.44,,
75394,SCUS-1245,0,0,0,83.33,,
75395,SCUS-1250,4,2,2,81.11,,
75396,SCUS-1290,4,2,2,87.78,,
75397,SCUS-1500,0,0,0,81.67,,
75398,SCUS-1590,2,0,2,98.89,,
75400,48-510,2,0,2,78.89,,
75403,40-506,5,0,5,25.32,,
75405,46-450,0,0,0,113.24,,
75406,WRAPC2-P,5,0,5,11.55,,
75407,WRAPC3-P,0,0,0,11.25,,
75408,WRAPC4-P,0,0,0,13.47,,
75410,48-701,0,0,0,13.62,,
75412,22610-9007,3,1,2,290.60,,
75413,22610-9507,4,2,2,323.63,,
75415,23095-0007-P,12,7,5,37.54,,
75424,24059-08-BP,1,0,1,30.23,,
75429,M-284-09-BP,5,5,0,45.16,,
75430,95060-60-BP,0,0,0,33.71,,
75432,M-550-BP,0,0,0,29.35,,
75433,M-550-14-BP,5,0,5,33.34,,
75434,M-489-BP,0,0,0,29.18,,
75438,56327-01-BP,12,6,6,10.97,,
75441,58327-01-BP,0,0,0,12.73,,
75442,58327-06-BP,8,2,6,16.65,,
75443,56027-01-BP,12,4,8,9.74,,
75444,58027-02-BP,0,0,0,9.40,,
75445,58027-03-BP,5,4,1,9.69,,
75446,58027-04-BP,0,0,0,9.89,,
75447,58027-07-BP,4,3,1,12.97,,
75448,2102,0,0,0,42.43,,
75449,58027-11-BP,0,0,0,11.64,,
75451,2112A,5,2,3,28.52,,
75452,54007-BP,7,1,6,4.44,,
75455,55025-BP,0,0,0,14.18,,
75456,55025-01-BP,7,4,3,15.65,,
75457,55025-02-BP,1,1,0,15.22,,
75458,55025-03-BP,8,7,1,15.65,,
75459,55025-04-BP,7,1,6,15.22,,
75460,55055-BP,7,0,7,8.37,,
75461,55020-BP,8,6,2,8.04,,
75462,55020-04-BP,8,8,0,14.88,,
75463,55088-BP,0,0,0,8.61,,
75464,5558-BP,0,0,0,6.90,,
75465,M-484-BP,0,0,0,8.42,,
75466,M-493-BP,0,0,0,9.53,,
75467,M-584-BP,0,0,0,8.91,,
75468,81264-BP,0,0,0,6.06,,
75469,33762,1,1,0,175.73,,
75470,33761,1,0,1,235.74,,
75471,M-490-BP,0,0,0,15.41,,
75472,33763,0,0,0,174.94,,
75473,M-626-BP,9,3,6,16.17,,
75474,33864,5,3,2,175.73,,
75475,33861,2,1,1,199.99,,
75476,33863,4,2,2,174.94,,
75477,M-485-BP,6,6,0,14.41,,
75478,M-492-BP,0,0,0,17.06,,
75479,770205,3,0,3,61.53,,
75480,770206,0,0,0,102.00,,
75481,M81135,0,0,0,1666.66,,
75482,0124000PLB,9,4,5,85.58,,
75483,012400099B,5,4,1,38.65,,
75488,010-12769-01,0,0,0,33.74,,
75489,G190200CASE,0,0,0,72.22,,
75491,G191419CASE,4,0,4,33.86,,
75493,G190315CASE,0,0,0,55.00,,
75494,G190526CASE,1,0,1,93.49,,
75496,CS75IT5,0,0,0,3292.41,,
75498,CS100IT5,0,0,0,3494.30,,
75499,CW125IT5,0,0,0,2884.19,,
75502,CW100IT4,0,0,0,2218.60,,
75503,CW125IT4,0,0,0,2645.69,,
75505,CS754,0,0,0,3233.62,,
75507,CW754,0,0,0,2351.72,,
75508,CW1004,0,0,0,3586.37,,
75509,M4100B12R,0,0,0,538.37,,
75510,M4100C12,0,0,0,528.67,,
75512,M4100P12,2,0,2,535.41,,
75513,M4100R12,0,0,0,556.71,,
75514,M5100B9R,0,0,0,617.87,,
75515,M5100C9,0,0,0,642.98,,
75516,M5100C9R,0,0,0,642.98,,
75517,M5100P9,0,0,0,584.73,,
75518,M5100R9,0,0,0,611.60,,
75519,"A-6 WHITE",0,0,0,379.40,,
75520,K00-00118-00,3,1,2,7.62,,
75521,B175C-20-L-MM,0,0,0,1176.70,,
75522,270113,3,3,0,13.26,,
75523,320101,8,5,3,60.24,,
75524,250101,2,2,0,61.01,,
75525,255101,8,5,3,61.38,,
75526,330101,4,2,2,56.30,,
75528,PP5200-16,0,0,0,392.72,,
75529,320000,8,4,4,29.80,,
75530,302603,4,2,2,1.72,,
75531,302606,0,0,0,9.52,,
75532,302624,0,0,0,16.74,,
75533,302648,0,0,0,5.78,,
75534,303602,3,0,3,1.77,,
75535,305606,4,2,2,7.78,,
75536,08099080-BP,0,0,0,15.97,,
75537,306903,0,0,0,3.85,,
75538,306906,3,1,2,9.33,,
75539,306948,20,20,0,15.02,,
75540,307602,1,0,1,3.42,,
75541,307603,1,1,0,5.20,,
75542,307606,0,0,0,8.74,,
75543,307903,0,0,0,5.20,,
75544,307924,2,2,0,15.86,,
75545,307948,3,3,0,18.06,,
75546,AIR-052-531,0,0,0,42.73,,
75547,326903,0,0,0,4.34,,
75548,326906,0,0,0,7.47,,
75549,AIR-335-661,0,0,0,81.82,,
75550,326924,0,0,0,14.29,,
75551,AIR-335-791,0,0,0,20.00,,
75552,327103,0,0,0,4.94,,
75553,AIR-335-792,0,0,0,20.00,,
75554,327106,0,0,0,6.42,,
75555,327603,0,0,0,4.94,,
75556,327903,0,0,0,4.94,,
75557,327906,0,0,0,6.42,,
75558,327924,1,0,1,11.64,,
75559,309302,0,0,0,479.76,,
75560,UP28R,3,3,0,593.97,,
75562,1852086,5,2,3,25.41,,
75563,MC70WH,0,0,0,20.36,,
75579,CS504-50W,0,0,0,699.01,,
75583,DE73104F,14,6,8,15.32,,
75584,DE73107F,13,10,3,14.24,,
75586,RF4054,10,7,3,47.20,72.21,
75587,RF4054A,44,20,24,47.20,72.21,
75588,RF4054B,40,20,20,47.20,72.21,
75589,GP1080-24,0,0,0,385.44,,
75590,BP-1,4,4,0,33.33,,
75591,BP-2,11,7,4,35.00,,
75592,BP-3,0,0,0,41.11,,
75593,BP-4,6,2,4,40.56,,
75594,BP-5,8,2,6,45.56,,
75595,BP-6,5,0,5,46.67,,
75596,BP-7,0,0,0,46.67,,
75597,BP-8,6,2,4,53.33,,
75598,BP-9,0,0,0,46.67,,
75599,BP-10,0,0,0,53.33,,
75600,BP-11,4,3,1,54.44,,
75601,BP-12,2,0,2,47.22,,
75602,BP-13,2,0,2,53.89,,
75603,BP-14,0,0,0,61.67,,
75604,BP-15,0,0,0,60.56,,
75606,BS-1,6,3,3,38.33,,
75607,BS-2,7,6,1,40.56,,
75608,BS-3,5,0,5,43.89,,
75609,BS-4,9,1,8,42.78,,
75610,BS-5,3,0,3,46.11,,
75611,BS-6,3,3,0,52.78,,
75612,BS-7,0,0,0,52.78,,
75613,BS-8,8,4,4,57.22,,
75614,BS-9,0,0,0,52.78,,
75615,BS-10,0,0,0,56.67,,
75616,BS-11,1,0,1,61.11,,
75617,BS-12,0,0,0,53.33,,
75618,BS-13,0,0,0,57.22,,
75619,BS-14,0,0,0,61.67,,
75620,BS-15,7,4,3,65.56,,
75621,BM-1,0,0,0,70.00,,
75622,BM-2,0,0,0,90.56,,
75623,BM-3,0,0,0,108.89,,
75624,BM-4,1,1,0,107.78,,
75625,BM-5,0,0,0,132.22,,
75626,BM-6,1,1,0,150.00,,
75627,BM-7,0,0,0,150.56,,
75628,BM-8,0,0,0,180.00,,
75629,BM-9,0,0,0,150.00,,
75630,BM-10,0,0,0,180.00,,
75631,BM-11,0,0,0,213.89,,
75632,BM-12,10,4,6,109.99,,
75633,BM-13,0,0,0,180.56,,
75634,BM-14,0,0,0,213.89,,
75635,BM-15,0,0,0,245.56,,
75636,19-1040,0,0,0,48.01,,
75637,010-12165-04,0,0,0,14.99,,
75643,010-12550-00,8,8,0,18.74,,
75647,A80564,0,0,0,59.65,,
75648,A80290,0,0,0,74.99,,
75649,A06078,0,0,0,29.82,,
75651,T70293,1,0,1,362.76,,
75652,A80049,0,0,0,1182.05,,
75653,A102150,0,0,0,68.17,,
75655,T12217,0,0,0,132.09,,
75656,A80012,0,0,0,1434.77,,
75657,556TID-HDD,0,0,0,1111.11,,
75682,FX-4MARINE2-PACK,0,0,0,62.44,,
75683,OCTAF1012,2,1,1,435.66,,
75685,OCTAF1212,0,0,0,474.01,,
75686,OCTAF2012,3,1,2,660.21,,
75692,SM-ACC-ACRE-240,4,2,2,82.80,,101.91
75693,T70452,1,0,1,1207.88,,
75696,E3009W,0,0,0,1165.76,,
75697,E3009B,2,0,2,1165.76,,
75698,E3009BW,4,4,0,999.99,,
75699,E3009CS,4,2,2,1099.99,,
75700,E6009BW,1,0,1,1602.55,,
75701,E6009CD,3,1,2,1604.17,,
75754,101-001,9,3,6,219.40,,279.74
75755,101-001-B,0,0,0,219.40,,279.74
75756,ZDIGWLN10SM,4,2,2,149.96,,
75757,101-002,9,3,6,219.40,,279.74
75758,101-002-B,2,2,0,219.40,,279.74
75762,101-004,0,0,0,313.75,,400.02
75764,101-004-B,0,0,0,313.75,,400.02
75769,PED70-5200-01-C,0,0,0,392.72,,
75771,PED70-5058-C,0,0,0,370.90,,
75772,PED70-5205-C,0,0,0,392.72,,
75773,PED70-5200-12-C,0,0,0,392.72,,
75774,261213,0,0,0,135.62,216.99,
75775,261313,0,0,0,187.50,299.99,
75792,101059,19,7,12,14.67,,
75793,101061,17,11,6,14.67,,
75796,12802,5,3,2,21.14,,
75803,DPT-R-COMP,1,1,0,443.81,,
75804,201-003,3,1,2,299.99,,
75806,201-004,4,2,2,352.32,,449.20
75807,201-004-B,0,0,0,352.32,,449.20
75812,201-010,2,0,2,313.75,,400.02
75813,201-010-B,0,0,0,313.75,,400.02
75816,201-011,2,2,0,538.08,,686.06
75860,201-011-B,0,0,0,538.08,,686.06
75863,201-011KL,2,0,2,449.99,,
75872,201-013V,0,0,0,426.36,,543.61
75873,201-013V-B,0,0,0,426.36,,543.61
75874,83551,0,0,0,1045.92,,
75875,40565,0,0,0,86.08,,
75876,83552,0,0,0,844.95,,
75877,83555,0,0,0,1152.91,,
75878,83556,0,0,0,795.45,,
75879,83559,0,0,0,991.71,,
75881,83560,0,0,0,1016.92,,
75882,83561,0,0,0,746.60,,
75886,201-021,3,1,2,509.99,,
75890,301-001,5,3,2,246.49,,314.27
75891,301-001-B,1,1,0,246.49,,314.27
75892,301-001ST,0,0,0,512.47,,653.39
75893,301-001ST-B,0,0,0,512.47,,653.39
75894,301-002,8,4,4,246.49,,314.27
75895,09-47165-01,0,0,0,13.58,,
75896,A80544,2,0,2,330.15,,
75898,63803,7,4,3,65.76,,
75899,606-32,17,5,12,9.01,,
75900,607-32,13,5,8,4.99,,
75901,608-32,12,9,3,7.99,,
75902,812-32,7,4,3,13.57,,
75903,870-32,9,4,5,13.15,,
75904,875-32,0,0,0,14.88,,
75905,880-32,0,0,0,7.71,,
75907,826-32,6,0,6,9.01,,
75908,826-86,16,0,16,17.65,,
75912,905Q,3,3,0,9.01,,
75913,905G,5,5,0,22.32,,
75914,909Q,3,3,0,9.01,,
75915,926,25,15,10,11.81,,
75916,925,0,0,0,10.50,,
75917,912,7,7,0,11.91,,
75918,950,5,1,4,12.26,,
75919,965,7,7,0,5.95,,
75920,970,0,0,0,6.56,,
75921,975,0,0,0,15.76,,
75922,2032,12,12,0,9.74,,
75923,2676,3,1,2,643.49,,
75925,301-002-B,2,0,2,246.49,,314.27
75926,301-002ST,0,0,0,512.47,,653.39
75927,301-002ST-B,0,0,0,512.47,,653.39
75928,301-005,6,2,4,269.99,,
75929,301-005-B,2,0,2,269.99,,
75932,301-006,6,3,3,319.77,,407.71
75933,301-006-B,2,0,2,319.77,,407.71
75934,12015,7,2,5,548.22,,
75935,12016,5,2,3,499.99,,
75936,12017,3,1,2,723.96,,
75937,61428,1,0,1,194.99,,
75938,61429,3,0,3,299.99,,
75939,61430,5,4,1,310.32,,
75940,61431,0,0,0,334.39,,
75941,61432,0,0,0,434.37,,
75942,61432A,1,0,1,326.17,,
75943,301-006ST,0,0,0,640.33,,816.43
75944,61426,1,0,1,404.43,,
75945,61427,3,2,1,404.43,,
75947,301-006ST-B,0,0,0,589.33,,751.40
75948,301-008,4,2,2,219.99,,
75949,301-008-B,3,2,1,219.99,,
75951,61433,0,0,0,415.55,,
75952,61434,0,0,0,392.03,,
75954,301-009,5,2,3,219.99,,
75955,301-009-B,3,1,2,219.99,,
75958,301-101,0,0,0,724.77,,924.08
75959,301-101-B,0,0,0,724.77,,924.08
75960,301-101ST,0,0,0,1383.67,,1764.17
75961,301-101ST-B,0,0,0,1383.67,,1764.17
75962,301-102,0,0,0,724.77,,924.08
75963,301-102-B,0,0,0,724.77,,924.08
75964,301-102ST,0,0,0,1383.67,,1764.17
75965,301-102ST-B,0,0,0,1383.67,,1764.17
75966,301-105,0,0,0,967.25,,1233.24
75967,301-105-B,0,0,0,967.25,,1233.24
75968,301-105ST,0,0,0,1581.33,,2016.20
75969,301-105ST-B,0,0,0,1581.33,,2016.20
75970,301-106,0,0,0,869.73,,1108.91
75971,301-106-B,0,0,0,869.73,,1108.91
75973,301-106ST,0,0,0,1581.33,,2016.20
75974,301-106ST-B,0,0,0,1581.33,,2016.20
75976,301-107,0,0,0,869.73,,1108.91
75977,301-107-B,0,0,0,869.73,,1108.91
75978,301-108,0,0,0,869.73,,1108.91
75979,301-108-B,0,0,0,869.73,,1108.91
75980,301-108ST,0,0,0,1383.67,,1764.17
75981,301-108ST-B,0,0,0,1383.67,,1764.17
75982,301-109,0,0,0,869.73,,1108.91
75983,301-109-B,0,0,0,869.73,,1108.91
75984,301-109ST,0,0,0,1383.67,,1764.17
75985,301-109ST-B,0,0,0,1383.67,,1764.17
75996,606-32CASE,2,0,2,52.54,,
75997,PWSA-751,15,8,7,6.67,,
75998,PWSA-1001,18,11,7,8.89,,
75999,PWSA-1251,1,0,1,8.89,,
76000,607-32CASE,1,0,1,55.11,,
76001,608-32CASE,1,1,0,84.26,,
76002,812-32CASE,0,0,0,79.11,,
76003,870-32CASE,0,0,0,76.63,,
76004,875-32CASE,0,0,0,86.74,,
76005,880-32CASE,0,0,0,44.91,,
76006,WSA-751,17,9,8,4.44,,
76007,WSA-1001,2,0,2,21.11,,
76008,WSA-1251,0,0,0,6.11,,
76010,826-32CASE,1,0,1,52.54,,
76013,93-1250-01,8,2,6,11.99,,
76015,93-2000-01,4,0,4,28.89,,
76016,93-3000-01,6,2,4,51.67,,
76017,905GCASE,1,1,0,86.74,,
76018,909QCASE,0,0,0,52.54,,
76020,926CASE,1,1,0,137.66,,
76021,925CASE,0,0,0,61.20,,
76022,950CASE,0,0,0,71.49,,
76023,93-1250-02,1,1,0,15.00,,
76024,93-2000-02,1,1,0,26.67,,
76025,965CASE,0,0,0,67.37,,
76026,93-3000-02,8,6,2,44.44,,
76027,93-1250-03,2,2,0,12.22,,
76028,93-2000-03,4,2,2,25.00,,
76029,2032CASE,1,1,0,110.23,,
76030,93-3000-03,6,0,6,41.67,,
76038,ARG-1001-PC,9,3,6,21.67,,
76039,ARG-1501-PC,12,5,7,27.22,,
76040,TSM810C-01,0,0,0,2512.00,,
76041,ARG-501-PC,15,7,8,15.56,,
76042,ARG-503,5,4,1,37.22,,
76043,ARG-753,6,6,0,41.67,,
76044,ARG-1003,3,2,1,50.56,,
76045,ARG-1253,1,1,0,59.44,,
76046,ARG-1503,2,0,2,80.56,,
76047,ARG-2003,4,4,0,92.78,,
76048,3066-P,4,0,4,16.55,,
76053,101060,9,7,2,14.67,,
76054,1111,0,0,0,38.05,44.95,
76067,A2K-GCF-0.25M,0,0,0,30.18,,
76070,02-300-512,0,0,0,933.13,1194.40,
76071,GP1040-32,0,0,0,334.53,,
76072,01052,0,0,0,3.51,,
76075,897821R,0,0,0,20.79,,
76076,8971021R,0,0,0,25.99,,
76077,897842R,1,0,1,54.99,,
76078,8971042R,0,0,0,64.99,,
76079,8971050P,0,0,0,52.99,,
76082,815CAXBX,6,4,2,59.60,69.99,
76084,010-10253-00,9,9,0,9.09,,
76086,385230980,0,0,0,123.19,,
76087,385310151,0,0,0,20.52,,
76088,810073,15,3,12,25.01,44.97,
76090,165001,0,0,0,71.62,114.97,
76092,SPD-13-W,0,0,0,398.81,,
76093,010-12163-00,0,0,0,22.49,,
76094,SPH-13-W,0,0,0,376.31,,
76095,SPD-9-W,0,0,0,376.31,,
76096,SPH-9-W,0,0,0,325.69,,
76098,SV-1,0,0,0,68.75,,
76102,980520601,4,3,1,69.62,,
76105,352,51,29,22,14.06,,
76106,"GPB-1 12V",0,0,0,327.22,,
76107,GPBR-1,0,0,0,467.78,,
76111,40200,0,0,0,60.18,89.99,
76117,210003,0,0,0,240.74,385.19,
76130,A80614,0,0,0,149.99,,
76131,A06082,15,5,10,29.82,,
76132,A06083,7,3,4,29.82,,
76133,A06084,1,0,1,29.82,,
76134,93096,7,1,6,12.69,,
76136,2018,19,0,19,13.79,,
76137,210013,0,0,0,240.74,385.19,
76139,93272,0,0,0,3.12,,
76140,210043,5,2,3,240.74,385.19,
76141,220013,0,0,0,307.62,492.19,
76142,220023,0,0,0,307.62,492.19,
76145,230003,0,0,0,381.18,609.89,
76146,230013,0,0,0,381.18,609.89,
76147,230023,0,0,0,381.18,609.89,
76149,230043,0,0,0,381.18,609.89,
76152,ELCIBRKR30SS,0,0,0,607.76,848.30,
76153,ELCIBRKR50SS,0,0,0,632.12,882.30,
76157,ELCIBRKR30PW,3,3,0,473.78,661.30,
76158,ELCIBRKR50PW,0,0,0,499.36,697.00,
76165,PKF30,4,4,0,54.81,76.50,
76166,PKF50,6,6,0,76.73,107.10,
76167,PKM30,4,4,0,51.77,72.25,
76168,PKM50,1,1,0,57.24,79.90,
76169,PKF30G,2,2,0,23.76,33.15,
76170,PKF50G,3,3,0,34.10,47.60,
76173,93072,0,0,0,11.41,,
76174,SF200B,2,0,2,290.00,,
76177,240003,0,0,0,461.43,738.29,
76178,240013,0,0,0,461.43,738.29,
76180,240023,0,0,0,461.43,738.29,
76181,556TID-LTD/12,0,0,0,888.89,,
76183,240043,0,0,0,461.43,738.29,
76185,250003,0,0,0,581.81,930.89,
76186,250013,0,0,0,581.81,930.89,
76187,250023,1,1,0,581.81,930.89,
76189,250043,1,0,1,581.81,930.89,
76190,32000,0,0,0,601.87,962.99,
76191,32001,0,0,0,601.87,962.99,
76194,32004,0,0,0,601.87,962.99,
76199,34000,0,0,0,802.49,1283.99,
76202,34004,0,0,0,802.49,1283.99,
76216,010-01248-60,0,0,0,862.49,,
76226,P101E12,1,0,1,673.08,,
76227,P102E12,0,0,0,679.49,,
76229,121613,0,0,0,675.93,1081.49,
76232,010-12717-30,0,0,0,26.07,,
76233,010-12717-20,0,0,0,32.59,,
76236,010-12846-02,8,4,4,22.49,,
76237,010-12846-01,5,5,0,22.49,,
76238,010-12846-00,0,0,0,22.49,,
76239,010-11824-01,0,0,0,3.49,,
76240,A2C1352150002,0,0,0,1296.62,1497.59,
76241,A2C1352150003,1,1,0,1429.99,2138.39,
76242,A2C1865330001,4,2,2,838.83,1019.69,
76243,A2C1352150001,3,3,0,435.85,,
76244,A2C1352090001,0,0,0,171.56,228.59,
76245,A2C1352080001,0,0,0,171.56,228.59,
76247,A2C1352010001,1,0,1,139.99,228.59,
76248,A2C1351990001,1,1,0,119.99,228.59,
76249,A2C1351980001,0,0,0,171.56,228.59,
76250,A2C1351970001,0,0,0,171.56,228.59,
76251,A2C1349730001,0,0,0,48.05,63.89,
76252,A2C1349710001,0,0,0,48.05,63.89,
76254,A2C1349700001,0,0,0,48.05,63.89,
76255,A2C1349690001,0,0,0,48.05,63.89,
76256,A2C1349680001,1,1,0,12.99,,
76257,A2C1349660001,1,1,0,29.99,63.89,
76258,A2C1349650001,0,0,0,48.05,63.89,
76259,A2C1349640001,0,0,0,48.05,63.89,
76262,A2C1066150001,0,0,0,48.05,63.89,
76263,A2C1066140001,0,0,0,48.05,63.89,
76264,A2C1066130001,0,0,0,48.05,63.89,
76265,RA2028211300,0,0,0,2260.45,2441.29,
76266,RA2028211400,0,0,0,2260.45,2441.29,
76267,RA2034211300,0,0,0,2260.45,2441.29,
76268,RA2034211400,0,0,0,2260.45,2441.29,
76269,RA2040211300,0,0,0,2260.45,2441.29,
76270,RA2040211400,0,0,0,2260.45,2441.29,
76271,RA2046211300,0,0,0,2260.45,2441.29,
76272,RA2046211400,0,0,0,2260.45,2441.29,
76273,RA2050211300,0,0,0,2260.45,2441.29,
76274,RA2050211400,0,0,0,2260.45,2441.29,
76275,020-00200-08,0,0,0,172.49,,
76276,020-00200-09,5,3,2,179.98,,
76277,020-00200-10,1,1,0,277.50,,
76278,020-00200-11,2,1,1,277.50,,
76279,1510,0,0,0,42.84,,
76281,RA2028214100,0,0,0,3984.22,4712.76,
76282,RA2028214200,0,0,0,4363.67,4712.76,
76284,RA2028215100,0,0,0,4363.67,4712.76,
76285,RA2028215200,0,0,0,4363.67,4712.76,
76286,RA2034214100,1,0,1,3984.22,4712.76,
76287,RA2034214200,0,0,0,4363.67,4712.76,
76288,RA2034215100,0,0,0,4363.67,4712.76,
76289,RA2034215200,0,0,0,4363.67,4712.76,
76290,RA2040214100,1,0,1,3984.22,4712.76,
76291,RA2040214200,0,0,0,4363.67,4712.76,
76292,RA2040215100,0,0,0,4363.67,4712.76,
76293,RA2040215200,0,0,0,4363.67,4712.76,
76294,RA2046214100,0,0,0,4508.46,5332.86,
76295,RA2046214200,0,0,0,4937.83,5332.86,
76296,RA2046215100,0,0,0,4937.83,5332.86,
76297,RA2046215200,0,0,0,4937.83,5332.86,
76298,RA2050214100,0,0,0,4508.46,5332.86,
76299,RA2050214200,0,0,0,4937.83,5332.86,
76300,RA2050215100,0,0,0,4937.83,5332.86,
76301,RA2050215200,0,0,0,4937.83,5332.86,
76303,OC16SUK08,0,0,0,41.94,,
76304,SCM-DL-WBR,4,2,2,79.00,,109.00
76308,SCM-CL-BB/GW,0,0,0,26.90,,37.95
76309,SCM-CL-RGB,5,1,4,26.90,,37.95
76312,A2C1066120001,0,0,0,48.05,63.89,
76313,A2C1066110001,2,1,1,32.99,63.89,
76314,A2C1066100001,1,1,0,48.05,63.89,
76315,80-511-0001-00,0,0,0,34.48,,
76316,80-511-0003-00,5,2,3,32.68,,
76317,A2C1066090001,3,2,1,27.99,63.89,
76318,A2C1066080001,2,0,2,48.05,63.89,
76321,A2C1066050001,0,0,0,48.05,63.89,
76322,A2C1066040001,0,0,0,48.05,63.89,
76326,A2C1066030001,2,2,0,29.99,63.89,
76327,A2C1066020001,0,0,0,48.05,63.89,
76328,A2C1066010001,0,0,0,48.05,63.89,
76329,A2C1066000001,1,1,0,32.99,63.89,
76330,A2C1065990001,0,0,0,48.05,63.89,
76331,A2C1065980001,3,2,1,27.99,63.89,
76332,A2C1065970001,4,2,2,42.99,63.89,
76333,A2C1065950001,3,1,2,42.99,63.89,
76334,A2C1065940001,1,1,0,42.99,63.89,
76335,A2C1065930001,3,1,2,48.05,63.89,
76336,A2C1065920001,1,0,1,32.99,63.89,
76337,A2C1065910001,0,0,0,48.05,63.89,
76338,A2C1065900001,3,1,2,27.99,63.89,
76339,A2C1065890001,1,1,0,32.99,63.89,
76340,A2C1065880001,2,1,1,12.99,,
76341,A2C1065870001,2,1,1,12.99,,
76342,A2C1065860001,2,1,1,24.99,63.89,
76343,A2C1065850001,2,1,1,24.99,63.89,
76345,A2C1065840001,2,2,0,32.99,63.89,
76347,A2C1065830001,3,1,2,32.99,63.89,
76349,A2C1065820001,1,0,1,144.99,206.09,
76351,A2C1065810001,0,0,0,154.68,206.09,
76352,A2C1065800001,2,2,0,144.99,206.09,
76353,A2C1065720001,0,0,0,154.68,206.09,
76355,A2C1065670001,2,1,1,124.99,206.09,
76360,A2C1065660001,1,1,0,144.99,206.09,
76369,19-0423,1,0,1,17.99,,
76370,A2C59501980,0,0,0,278.18,321.29,
76371,A2C59501984,3,2,1,399.09,485.09,
76372,A2C59501981,0,0,0,544.94,662.39,
76373,80-511-0002-00,4,0,4,32.68,,
76374,80-511-0004-00,7,2,5,32.68,,
76375,80-511-0009-00,0,0,0,32.68,,
76376,80-511-0006-00,0,0,0,32.68,,
76377,80-511-0008-00,0,0,0,32.68,,
76380,80-511-0010-00,0,0,0,32.68,,
76381,80-511-0031-00,14,3,11,12.39,,
76392,16001,0,0,0,28.38,,
76393,16002,5,0,5,24.99,,
76394,16004,1,1,0,33.15,,
76395,36004,0,0,0,93.19,,
76396,36010,0,0,0,53.10,,
76397,GP1900-11,0,0,0,319.99,,
76401,ZDIGNLINK,8,3,5,209.96,,
76407,H001F00,2,0,2,42.18,,
76408,H004F00,6,0,6,28.33,,
76409,H005F00,2,0,2,52.60,,
76411,IRID-INT-9555,0,0,0,33.33,,
76412,H006F00,0,0,0,45.62,,
76413,H007F00,1,0,1,25.36,,
76416,23-145A,0,0,0,92.15,,
76418,1001755,0,0,0,444.17,686.00,
76419,E70532,0,0,0,439.99,,
76420,E70534,4,2,2,599.99,,
76421,E70536,0,0,0,999.99,,
76422,310ST-100-125,0,0,0,78.00,,
76424,314-335,0,0,0,95.25,,
76425,316-689,3,1,2,78.00,,
76427,673ST-1-14,5,1,4,51.60,,
76429,693-5,0,0,0,42.75,,
76432,831ST-3-DISK,0,0,0,129.75,,
76433,831ST-5-DISK,0,0,0,141.00,,
76434,832ST-3-125,0,0,0,111.75,,
76435,832ST-7-125,0,0,0,120.00,,
76436,856WH-345,2,2,0,78.00,,
76437,878ST-1V,1,0,1,42.75,,
76438,963PT-55,3,2,1,66.00,,
76439,963SB-55,2,1,1,66.00,,
76440,990-23,0,0,0,107.25,,
76441,785-761-95,0,0,0,265.13,,
76442,785-737-95,0,0,0,492.63,,
76444,32181,3,0,3,8.32,17.99,
76446,32183,84,0,84,8.12,17.99,
76452,60918,6,4,2,73.49,,
76456,104213,0,0,0,167.37,267.79,
76458,104513,2,0,2,167.37,267.79,
76459,173513,0,0,0,187.49,299.99,
76460,173613,0,0,0,193.12,308.99,
76464,MSK-EXT,1,1,0,36.36,52.50,
76465,010-12133-00,0,0,0,3.74,,
76466,MA-OC8,1,0,1,99.00,,
76467,RA2028011300,0,0,0,2906.74,3214.03,
76468,RA2028011400,0,0,0,2906.74,3214.03,
76469,RA2034011300,0,0,0,3011.14,3329.46,
76470,RA2034011400,0,0,0,3011.14,3329.46,
76471,RA2040011300,0,0,0,3183.70,3520.26,
76472,RA2040011400,0,0,0,3183.70,3520.26,
76473,RA2046011300,0,0,0,3442.53,3806.46,
76474,RA2046011400,0,0,0,3442.53,3806.46,
76475,RA2050011300,0,0,0,3528.81,3901.86,
76476,RA2050011400,0,0,0,3528.81,3901.86,
76477,40335,1,1,0,93.95,169.99,
76478,RA2028014100,0,0,0,4508.46,5332.86,
76479,RA2028014200,0,0,0,4823.00,5332.86,
76480,RA2028015100,0,0,0,4823.00,5332.86,
76481,400203,0,0,0,206.25,329.99,
76482,RA2028015200,0,0,0,4823.00,5332.86,
76483,400213,0,0,0,206.25,329.99,
76485,RA2034014100,0,0,0,4653.63,5504.58,
76486,RA2034014200,0,0,0,4978.30,5504.58,
76487,400233,0,0,0,206.25,329.99,
76488,RA2034015100,0,0,0,4978.30,5504.58,
76489,400243,5,5,0,196.88,329.99,
76490,400253,0,0,0,300.00,479.99,
76491,RA2034015200,0,0,0,4978.30,5504.58,
76492,400263,0,0,0,300.00,479.99,
76494,400283,0,0,0,300.00,479.99,
76495,400293,0,0,0,300.00,479.99,
76496,RA2040014100,1,0,1,4790.74,5666.76,
76497,RA2040014200,0,0,0,5124.98,5666.76,
76498,RA2040015100,0,0,0,5124.98,5666.76,
76499,RA2040015200,0,0,0,5124.98,5666.76,
76500,RA2046014100,0,0,0,5419.83,6410.88,
76501,RA2046014200,0,0,0,5797.95,6410.88,
76502,RA2046015100,0,0,0,5797.95,6410.88,
76503,RA2046015200,0,0,0,5797.95,6410.88,
76504,RA2050014100,0,0,0,5782.76,6840.18,
76505,RA2050014200,0,0,0,6186.21,6840.18,
76506,RA2050015100,0,0,0,6186.21,6840.18,
76507,RA2050015200,0,0,0,6186.21,6840.18,
76508,B175M/12,0,0,0,1155.56,,
76509,B175M/20,0,0,0,1422.22,,
76510,B75M,0,0,0,666.67,,
76511,B150M,3,3,0,422.22,,
76512,B785M,0,0,0,800.00,,
76513,SS75M/12,0,0,0,666.67,,
76514,SS75M/20,1,1,0,666.67,,
76515,TM185M,2,2,0,888.89,,
76516,B285M,0,0,0,1155.56,,
76517,SS75H/20,0,0,0,666.67,,
76518,B175HW/20,1,1,0,1244.44,,
76520,480083,0,0,0,66.87,106.99,
76521,480093,12,12,0,66.87,106.99,
76522,480103,0,0,0,66.87,106.99,
76527,MA-OC6,2,2,0,75.00,,
76528,480333,0,0,0,66.87,106.99,
76530,482023,0,0,0,100.00,159.99,
76531,482043,2,1,1,91.30,159.99,
76532,482053,0,0,0,100.00,159.99,
76534,482343,0,0,0,100.00,159.99,
76536,482153,0,0,0,100.00,159.99,
76540,80-600-0022-00,0,0,0,325.83,,
76541,400-034,0,0,0,146.05,,186.21
76542,SPC10,4,4,0,26.67,,
76543,SPC15T,2,2,0,49.99,,
76547,C5050-12-00015,8,0,8,21.80,,
76548,C5050-12-00025,0,0,0,28.52,,
76550,C5050-16-00025,12,12,0,34.38,,
76551,C5050-16-00035,7,7,0,44.58,,
76552,C5050-20-00015,0,0,0,32.73,,
76553,C5050-20-00025,0,0,0,47.68,,
76554,C5050-20-00035,0,0,0,61.44,,
76555,C5050-20-00040,0,0,0,76.96,,
76556,C5050-20-00050,0,0,0,87.86,,
76557,C5050-24-00025,17,17,0,59.99,,
76558,C5050-24-00035,0,0,0,95.84,,
76559,C5050-24-00050,1,1,0,126.33,,
76560,C5059-12-00015,7,0,7,23.01,,
76561,C5059-12-00025,3,0,3,29.72,,
76562,C5059-16-00015,23,11,12,25.10,,
76563,C5059-16-00025,3,3,0,41.50,,
76564,C5059-16-00035,0,0,0,57.16,,
76565,C5059-20-00015,13,13,0,33.16,,
76566,C5059-20-00025,22,22,0,43.22,,
76567,C5059-20-00035,0,0,0,66.05,,
76568,C5059-20-00040,0,0,0,81.49,,
76569,C5059-20-00050,0,0,0,95.84,,
76570,C5059-24-00025,4,4,0,70.92,,
76571,C5059-24-00035,5,5,0,100.63,,
76572,C5059-24-00050,2,2,0,134.61,,
76573,C5054-12-00015,8,0,8,25.32,,
76574,C5054-12-00020,8,0,8,35.19,,
76575,C5054-12-00025,0,0,0,34.45,,
76576,C5054-16-00015,9,0,9,31.29,,
76577,C5054-16-00025,5,5,0,46.00,,
76578,C5054-16-00035,0,0,0,49.26,,
76579,C5054-20-00015,19,16,3,35.22,,
76580,C5054-20-00025,0,0,0,55.70,,
76581,C5054-20-00035,4,0,4,67.02,,
76582,C5054-20-00040,0,0,0,89.49,,
76583,C5054-20-00050,0,0,0,108.31,,
76584,C5054-24-00025,0,0,0,87.55,,
76585,C5054-24-00035,3,3,0,110.66,,
76586,C5054-24-00050,0,0,0,146.81,,
76587,C5053-12-00015,16,6,10,22.34,,
76588,C5053-12-00025,14,14,0,27.20,,
76589,C5053-16-00015,2,2,0,35.47,,
76590,C5053-16-00025,13,6,7,46.00,,
76591,C5053-16-00035,6,0,6,58.23,,
76592,C5053-20-00015,10,10,0,35.22,,
76593,C5053-20-00025,0,0,0,55.70,,
76594,C5053-20-00035,0,0,0,71.21,,
76595,C5053-20-00050,0,0,0,108.31,,
76596,C5053-24-00025,0,0,0,87.55,,
76597,C5053-24-00035,0,0,0,110.66,,
76598,C5053-24-00050,0,0,0,146.81,,
76601,40206,19,12,7,4.44,,
76602,C6050-12-00015,5,5,0,15.80,,
76603,C6050-12-00020,0,0,0,18.04,,
76604,C6050-12-00025,0,0,0,19.40,,
76605,C6050-16-00015,1,1,0,22.39,,
76606,C6050-16-00025,0,0,0,30.80,,
76607,C6050-16-00035,0,0,0,37.09,,
76608,C6050-20-00015,4,4,0,23.28,,
76609,C6050-20-00025,7,7,0,38.71,,
76610,C6050-20-00035,0,0,0,49.23,,
76611,C6050-20-00050,0,0,0,70.80,,
76612,C6050-24-00025,3,3,0,51.50,,
76613,C6050-24-00035,5,1,4,66.39,,
76614,C6050-24-00050,6,6,0,70.05,,
76615,C6054-12-00015,0,0,0,17.13,,
76616,C6054-12-00020,0,0,0,20.73,,
76617,C6054-12-00025,1,1,0,21.56,,
76618,C6054-16-00015,2,0,2,25.72,,
76619,C6054-16-00025,0,0,0,34.13,,
76620,C6054-16-00035,5,5,0,46.38,,
76621,C6054-20-00015,1,1,0,31.34,,
76622,C6054-20-00025,0,0,0,48.98,,
76623,C6054-20-00035,9,9,0,60.00,,
76624,C6054-20-00050,4,4,0,91.25,,
76625,C6054-24-00025,0,0,0,64.90,,
76626,C6054-24-00035,11,11,0,74.34,,
76627,C6054-24-00050,0,0,0,118.08,,
76628,C6053-12-00015,0,0,0,17.13,,
76629,C6053-12-00025,14,6,8,20.29,,
76630,C6053-16-00015,0,0,0,25.72,,
76631,C6053-16-00025,0,0,0,34.13,,
76632,C6053-16-00035,1,1,0,46.38,,
76633,C6053-20-00015,5,5,0,30.72,,
76634,C6053-20-00025,1,1,0,51.01,,
76635,C6053-20-00035,3,3,0,66.41,,
76636,LM0004,1,1,0,24.99,,
76638,244276,0,0,0,100.35,,
76639,12860,0,0,0,24.13,,
76642,X2000,11,6,5,7.61,,
76643,003-1000-7,0,0,0,10.29,,
76644,003-1100-7,0,0,0,10.29,,
76645,003-1200-7,0,0,0,10.29,,
76646,003-2000-7,0,0,0,10.29,,
76647,003-2100-7,0,0,0,10.29,,
76648,003-2200-7,0,0,0,10.29,,
76649,003-4000-7,0,0,0,10.29,,
76650,003-4100-7,0,0,0,10.29,,
76652,003-5000-7,7,7,0,10.29,,
76654,003-5200-7,0,0,0,10.29,,
76680,011-1500-7,0,0,0,8.23,,
76681,011-3500-7,2,2,0,8.23,,
76682,541-0000-7,0,0,0,22.89,,
76683,541-0100-7,0,0,0,22.89,,
76685,600-ACSM-KIT,0,0,0,436.63,,
76686,1684DP0CHR,1,0,1,115.39,,
76717,RF568,0,0,0,10.65,,
76719,1PCHGAL,3,1,2,78.95,,
76722,1PCHQT,21,4,17,27.30,,
76724,1PKOGAL,3,3,0,35.00,,
76726,1062,0,0,0,132.66,,
76727,33834,5,5,0,112.99,,
76728,A80542,1,1,0,99.99,,
76729,20002CASE,6,0,6,111.04,,
76730,20004CASE,2,0,2,293.31,,
76731,010-12829-00,2,0,2,19.72,,
76732,20032CASE,0,0,0,102.83,,
76733,20012CASE,4,0,4,137.57,,
76734,25002CASE,9,0,9,94.11,,
76735,25003CASE,4,0,4,58.18,,
76736,25014CASE,3,0,3,115.65,,
76737,25016CASE,1,0,1,76.71,,
76739,MERK,4,3,1,28.85,,
76743,1113,2,2,0,25.98,29.95,
76744,1116,0,0,0,21.97,,
76745,1119,0,0,0,20.81,,
76746,1148,0,0,0,22.09,,
76747,1161,0,0,0,24.53,,
76748,1163,0,0,0,50.20,59.95,
76749,1164,0,0,0,73.79,,
76750,1165,0,0,0,30.02,34.95,
76751,1173,0,0,0,20.76,,
76752,1570,0,0,0,45.99,,
76753,1578,0,0,0,65.33,74.95,
76754,1579,0,0,0,78.75,89.95,
76755,4122,0,0,0,26.60,,
76775,NTECH-EPS,0,0,0,1802.21,,
76776,SILVERSTEERXP1,0,0,0,1168.77,,
76777,SILVERSTEERXP1T,4,3,1,999.99,,
76778,SILVERSTEERXP2,0,0,0,1168.77,,
76779,SILVERSTEERXP2T,2,0,2,1406.00,,
76781,"ZTF TILLER Y1",3,0,3,1844.76,,
76782,"ZTF TILLER Y2",0,0,0,1844.76,,
76791,C1W,0,0,0,26.32,38.00,
76792,C1G,2,0,2,25.00,37.95,
76794,C1R,1,0,1,22.99,38.00,
76795,"UC128-SVS 1",3,1,2,726.44,,
76797,740165-1,7,3,4,51.94,,
76801,35040,0,0,0,98.77,,
76803,38005,0,0,0,153.35,,
76804,33037A,14,2,12,48.29,,
76807,BBWX4,4,3,1,325.95,,
76810,165T-CM54,0,0,0,1777.78,,
76811,165T/275LHW,0,0,0,3288.89,,
76813,TM265C-LH-MM,0,0,0,1225.28,,
76823,RH5327V,2,2,0,75.57,,
76827,"S-1 COBALT BLUE",0,0,0,19.76,,
76828,"S-1 WHITE",19,8,11,13.99,,
76829,"S-1 BLUE",2,2,0,13.99,,
76838,LLB-36MN-81-00,4,3,1,187.80,,
76842,647-560,0,0,0,64.72,,
76846,F38-6610D,0,0,0,125.53,,
76847,SET0088,0,0,0,88.80,,
76863,010-12908-00,4,2,2,157.49,,
76864,010-12909-00,12,8,4,277.50,,
76870,010-12928-01,0,0,0,1124.99,,
76872,010-12928-00,0,0,0,63.74,,
76873,010-12928-02,0,0,0,56.24,,
76876,010-C1205-00,0,0,0,149.99,,
76878,010-C1204-00,0,0,0,149.99,,
76903,133432,8,8,0,24.63,44.97,
76907,01-66-027,4,1,3,29.88,,
76908,02-66-022,0,0,0,63.16,,
76909,133401,11,8,3,62.64,113.97,
76921,22005,17,4,13,3.16,4.99,
76922,22214,3,3,0,12.19,,
76923,22213,34,7,27,40.41,,
76924,22239,6,1,5,6.64,,
76925,22241,10,10,0,6.64,,
76926,22240,17,7,10,18.28,,
76927,22250,6,6,0,63.83,,
76928,22001,6,4,2,4.26,5.49,
76929,22003,24,0,24,7.54,9.99,
76930,22004,31,1,30,3.28,4.49,
76931,998504001,3,2,1,86.08,,
76932,22254,25,0,25,19.09,23.99,
76933,22255,10,6,4,60.98,63.99,
76934,22206,22,22,0,4.88,,
76935,22207,24,0,24,6.57,,
76936,40333,2,1,1,55.26,99.99,
76937,A80498,0,0,0,59.65,,
76938,30445,25,11,14,5.08,8.79,
76939,GP2500-33,0,0,0,276.35,,
76940,30204,42,0,42,8.36,15.99,
76941,30570,32,0,32,24.42,44.79,
76945,30205,8,0,8,6.55,12.79,
76947,30213,6,6,0,10.70,16.79,
76949,30215,53,7,46,10.70,16.79,
76950,30306,25,0,25,14.05,24.79,
76951,30573,32,1,31,7.49,12.79,
76952,30574,15,3,12,12.49,20.79,
76953,010-11202-02,4,0,4,157.49,,
76954,010-11202-03,1,1,0,22.49,,
76955,30616,46,2,44,11.75,19.99,
76956,30604,24,0,24,20.39,29.99,
76960,30324,55,0,55,6.76,8.79,
76962,30586,11,6,5,11.38,20.79,
76967,010-12390-10,12,6,6,41.24,,
76971,MRGB10W,2,2,0,76.69,,
76980,MGD-10XL,0,0,0,78.69,,
76981,MGD-1,0,0,0,61.19,,
76984,MCK508WB.64S,2,0,2,130.61,,
76987,ATV6.5B,0,0,0,90.85,,
76988,MC425BA,0,0,0,79.49,,
76989,MCBK425BA,9,6,3,79.49,,
76996,CG1-100C,4,1,3,343.52,,
76997,PP5050-33,0,0,0,370.90,,
76998,PP4800-10,0,0,0,356.35,,
76999,PP5030-02,0,0,0,399.99,,
77000,PP4900-11,0,0,0,356.35,,
77001,R509C-LH,0,0,0,3773.01,,
77002,R509C-LHW,0,0,0,3940.34,,
77005,BEN1042,0,0,0,315.33,,
77006,BEN1050,0,0,0,323.85,,
77007,BEN1250,0,0,0,340.90,,
77008,BEN842,4,4,0,298.28,,
77009,BCA1000V-110-12,1,0,1,599.00,,
77014,E12139,0,0,0,637.49,,
77016,BCA610V-110-12,2,0,2,667.37,,
77017,BCA310V-110-12,4,2,2,449.99,,
77020,IPSI1200-20-110,2,0,2,499.00,,
77021,IPSI2400-20-110,0,0,0,2090.18,,
77022,PWI320-12,7,2,5,486.26,,
77023,PWI320-24,3,0,3,486.26,,
77024,PWS1000-110-12,0,0,0,985.64,,
77025,PWS1000-110-24,0,0,0,985.64,,
77026,VTC305-12-24,0,0,0,449.36,,
77027,VTC605-12-24,0,0,0,733.90,,
77028,VCH10W-12,2,0,2,371.46,,
77029,VCH10W-24,5,2,3,371.46,,
77030,BCH10W-12,0,0,0,391.96,,
77031,BCH10W-24,4,2,2,391.96,,
77032,IBI1-40-200,0,0,0,183.12,,
77034,IBI2-40-200,0,0,0,227.96,,
77038,010-12852-00,5,2,3,29.98,,
77043,01-07-007,0,0,0,235.77,,
77044,01-07-008,1,1,0,203.36,,
77045,"ATLANTIS 155",28,14,14,56.51,,
77046,"ATLANTIS 275",24,23,1,91.84,,
77048,GS-800-1,6,5,1,454.63,,649.99
77049,676,3,0,3,6.76,,
77060,520070-1,9,9,0,5.23,,
77061,520072-1,12,2,10,5.95,,
77062,ARG-2500,0,0,0,602.78,,
77063,520091-1,4,4,0,4.90,,
77064,ARG-2500-P,0,0,0,467.22,,
77065,520092-1,9,0,9,4.73,,
77066,ARG-2500-S,2,0,2,471.11,,
77067,520093-1,7,7,0,5.26,,
77068,ARG-2503,3,1,2,105.56,,
77069,520094-1,10,2,8,3.98,,
77070,520045-1,3,2,1,9.53,,
77071,357399-1,12,3,9,1.61,,
77074,230106-1,4,4,0,29.17,,
77077,230107-1,2,2,0,29.17,,
77084,502006-1,6,4,2,21.35,,
77096,522105-1,5,2,3,10.00,,
77106,531112,7,7,0,8.81,,
77107,521700-1,6,5,1,7.02,,
77110,521663-1,5,5,0,5.29,,
77112,521664-1,9,1,8,6.58,,
77113,521655-1,3,0,3,11.50,,
77115,521500-1,0,0,0,6.29,,
77117,351100,1,1,0,56.03,,
77119,351110,2,2,0,51.26,,
77120,351119,4,0,4,13.71,,
77123,30674,41,0,41,78.09,89.99,
77126,30370,38,2,36,43.39,64.99,
77130,30340,23,0,23,8.95,15.99,
77132,14602,0,0,0,26.04,,
77135,491134-1,6,0,6,26.92,,
77136,491140-1,0,0,0,18.84,,
77137,491070-1,4,0,4,16.29,,
77138,491080-1,3,2,1,16.55,,
77141,491090-1,2,2,0,18.37,,
77142,491060-1,0,0,0,5.35,,
77143,491100-1,2,1,1,22.98,,
77144,491105-1,2,0,2,20.50,,
77145,491107-1,1,1,0,11.68,,
77146,HCP1500HP,20,8,12,23.74,,
77147,HCP2000HP,14,6,8,29.99,,
77148,HCP2500HP,17,6,11,36.24,,
77151,491012-1,4,4,0,15.58,,
77152,491013-1,0,0,0,25.68,,
77153,491024-1,0,0,0,30.17,,
77154,490300-1,5,2,3,19.10,,
77155,491051-1,0,0,0,7.15,,
77156,50840-0024,0,0,0,348.68,,
77157,491361-1,1,1,0,6.26,,
77158,37041-0011,4,2,2,255.15,,
77159,37072-0094,4,1,3,202.81,,
77161,50890-1100,0,0,0,281.12,,
77166,23870-1300,12,12,0,257.41,,
77168,299190-1,5,5,0,24.11,,
77169,299201B-1,10,4,6,3.55,,
77170,299201W-1,4,4,0,3.55,,
77171,299202B-1,13,6,7,3.68,,
77172,299202W-1,10,4,6,3.68,,
77173,299204B-01,7,2,5,3.74,,
77174,491110-1,3,3,0,7.74,,
77175,491115-1,3,3,0,13.94,,
77176,588071-1,5,3,2,19.10,,
77177,588074-1,4,4,0,19.10,,
77178,588510-1,1,0,1,11.19,,
77179,588520-1,0,0,0,17.31,,
77180,588450-1,0,0,0,11.33,,
77181,327124-1,0,0,0,22.88,,
77182,327130-1,6,5,1,15.50,,
77183,327135-1,0,0,0,30.85,,
77184,299204W-1,0,0,0,3.74,,
77185,426506-1,7,3,4,32.26,,
77186,426505-1,6,6,0,21.86,,
77187,426513-1,5,2,3,21.30,,
77188,426515-1,11,10,1,15.70,,
77189,P1030DW,11,7,4,9.59,,
77190,426517-1,11,6,5,19.73,,
77191,426520-1,3,3,0,16.26,,
77192,426527-1,8,5,3,21.30,,
77193,426560-1,0,0,0,28.05,,
77194,431510-1,2,0,2,60.87,,
77195,431520-1,2,1,1,119.09,,
77196,405950-1,3,1,2,103.21,,
77197,405951-1,0,0,0,140.26,,
77198,400180-1,7,2,5,38.71,,
77199,400080-1,0,0,0,75.13,,
77200,LG4-NY,5,0,5,41.44,56.99,
77201,LG4-BK,5,4,1,41.44,56.99,
77202,MGV550B,9,3,6,205.99,379.99,
77204,B62RGB,4,2,2,312.50,,
77206,BOLTBLK,9,2,7,31.99,,
77207,403010-1,0,0,0,7.02,,
77208,403020-1,0,0,0,8.34,,
77209,403060-1,7,1,6,43.76,,
77210,404610-3,0,0,0,169.37,,
77211,401321-1,6,0,6,9.71,,
77212,401320-1,22,10,12,9.53,,
77254,LLB-32KC-01-00,0,0,0,35.12,,
77257,302110010BK-1,6,6,0,5.51,,
77263,302110010WH-1,0,0,0,5.21,,
77264,302110015BK-1,2,2,0,6.62,,
77271,302110020BK-1,2,2,0,8.19,,
77278,302110020WH-1,3,3,0,8.05,,
77279,302110025BK-1,0,0,0,10.46,,
77283,001-506-900-00,0,0,0,288.89,,
77285,302110025WH-1,6,6,0,9.68,,
77286,302110050BK-1,0,0,0,17.14,,
77287,302112010BK-1,0,0,0,7.53,,
77292,302112010WH-1,0,0,0,6.36,,
77293,302112015BK-1,0,0,0,10.08,,
77300,302112015WH-1,11,11,0,9.27,,
77301,302112020BK-1,0,0,0,13.09,,
77308,302112020WH-1,12,12,0,11.99,,
77309,302112025BK-1,0,0,0,15.60,,
77314,302112025WH-1,0,0,0,15.60,,
77315,302112030BK-1,0,0,0,19.15,,
77317,302112030WH-1,6,6,0,15.58,,
77318,302112035BK-1,3,3,0,21.81,,
77322,302112050BK-1,0,0,0,26.28,,
77323,302116015BK-1,0,0,0,17.14,,
77329,302116020BK-1,0,0,0,24.20,,
77334,302116020WH-1,3,3,0,19.44,,
77335,302116025BK-1,3,3,0,26.95,,
77337,302116025WH-1,3,3,0,23.47,,
77338,302116030BK-1,2,2,0,33.76,,
77341,302116030WH-1,6,6,0,30.45,,
77342,302116035BK-1,0,0,0,39.83,,
77345,302116035WH-1,2,2,0,34.74,,
77346,302116050BK-1,1,1,0,48.63,,
77347,302116050WH-1,0,0,0,45.56,,
77348,302119025BK-1,0,0,0,36.45,,
77350,302119025WH-1,4,4,0,31.78,,
77351,302119030BK-1,0,0,0,36.80,,
77352,302119035BK-1,0,0,0,51.41,,
77354,302119035WH-1,3,3,0,47.67,,
77355,302119050BK-1,6,6,0,58.04,,
77358,561010-1,10,1,9,8.52,,
77359,561012-1,14,9,5,9.05,,
77360,561016-1,5,2,3,9.21,,
77361,561019-1,0,0,0,9.53,,
77364,328908-1,0,0,0,66.96,,
77365,582501-1,3,2,1,49.73,,
77366,582502-1,4,2,2,42.64,,
77367,582503-1,15,9,6,32.53,,
77370,XT-SF-170-IR,0,0,0,477.25,539.00,
77377,254106-1,4,4,0,18.25,,
77378,254112-1,0,0,0,24.85,,
77379,254118-1,0,0,0,30.45,,
77380,254124-1,0,0,0,34.95,,
77381,254209-1,1,1,0,25.41,,
77382,254212-1,1,0,1,28.21,,
77383,254218-1,0,0,0,34.39,,
77384,254224-1,0,0,0,38.32,,
77385,254312-1,8,5,3,25.68,,
77386,254318-1,0,0,0,32.70,,
77387,254324-1,1,1,0,40.56,,
77388,254509-1,0,0,0,44.88,,
77389,254512-1,0,0,0,46.56,,
77390,254518-1,0,0,0,54.03,,
77391,751010-1,8,8,0,2.90,,
77392,751011-1,10,7,3,2.95,,
77394,751030-1,10,7,3,9.27,,
77395,751062-1,7,7,0,4.94,,
77396,752010-1,0,0,0,19.69,,
77397,753864-1,10,1,9,10.60,,
77398,753874-1,11,9,2,10.90,,
77399,753877-1,0,0,0,6.89,,
77400,755220-1,4,3,1,14.90,,
77401,331320-1,0,0,0,32.53,,
77403,331330-1,4,0,4,31.58,,
77404,331335-1,13,6,7,21.35,,
77405,331340-1,0,0,0,30.85,,
77406,331350-1,8,8,0,32.53,,
77407,331360-1,0,0,0,2.06,,
77408,331370-1,10,7,3,2.31,,
77409,331375-1,0,0,0,6.89,,
77410,331380-1,0,0,0,5.23,,
77411,331390-1,0,0,0,7.92,,
77412,331400-1,0,0,0,13.60,,
77413,331405-1,2,2,0,15.24,,
77414,331410-1,13,6,7,14.19,,
77415,331424-1,0,0,0,5.35,,
77416,331425-1,10,10,0,7.61,,
77417,331440-1,8,0,8,7.52,,
77418,331450-1,0,0,0,15.98,,
77419,331600-1,1,1,0,3.74,,
77420,331620-1,0,0,0,7.02,,
77421,335653-1,0,0,0,54.49,,
77422,90315,9,9,0,5.99,,
77424,12822,4,4,0,18.99,,
77426,335740-1,1,0,1,6.73,,
77427,335745-1,17,8,9,7.32,,
77428,335750-1,0,0,0,6.85,,
77429,335755-1,3,1,2,7.45,,
77430,335760-1,10,5,5,8.81,,
77431,335765-1,1,0,1,9.40,,
77432,336140-1,5,0,5,9.50,,
77433,336145-1,2,0,2,9.11,,
77434,336150-1,12,4,8,9.40,,
77435,336152-1,8,0,8,9.40,,
77436,A80320,0,0,0,1304.34,,
77437,336155-1,3,0,3,8.44,,
77438,336157-1,10,0,10,8.44,,
77439,336160-1,7,7,0,12.52,,
77440,336162-1,9,7,2,13.11,,
77441,336165-1,8,7,1,9.13,,
77442,336167-1,6,0,6,11.92,,
77443,336180-1,0,0,0,15.53,,
77444,336182-1,4,4,0,15.53,,
77445,336185-1,1,1,0,14.65,,
77447,336187-1,8,2,6,14.65,,
77448,336262-1,1,1,0,15.50,,
77449,336282-1,2,2,0,17.32,,
77450,336340-1,0,0,0,9.21,,
77451,336345-1,2,2,0,8.81,,
77452,336350-1,2,2,0,9.21,,
77454,336352-1,5,0,5,9.21,,
77455,336355-1,15,10,5,6.36,,
77456,336357-1,10,4,6,6.36,,
77457,336360-1,9,7,2,12.68,,
77458,336362-1,6,6,0,12.68,,
77459,336365-1,0,0,0,12.08,,
77460,336367-1,9,7,2,9.36,,
77461,336380-1,0,0,0,16.73,,
77462,336382-1,2,0,2,16.73,,
77463,336385-1,13,1,12,11.31,,
77464,336387-1,14,6,8,11.31,,
77476,782-0100-01,1,1,0,298.98,,
77481,708-0030,0,0,0,57.07,,
77482,708-0040,0,0,0,4.33,,
77483,708-0050,0,0,0,11.55,,
77484,708-0060,0,0,0,4.28,,
77486,708-0080,2,2,0,12.53,,
77498,RLS-508-402,0,0,0,75.63,,
77499,RLS-509-402,1,1,0,69.75,,
77500,RLS-509-404,0,0,0,64.83,,
77530,MAAUXUSBR,11,7,4,27.09,,
77577,415044-1,1,1,0,7.74,,
77578,415047-1,1,0,1,8.94,,
77579,415054-1,1,0,1,6.73,,
77580,415057-1,3,3,0,7.32,,
77581,415082-1,6,0,6,9.11,,
77582,415092-1,9,4,5,4.34,,
77583,415094-1,17,6,11,4.76,,
77584,415110-1,0,0,0,5.08,,
77585,415115-1,0,0,0,5.53,,
77587,415210-1,23,11,12,8.77,,
77588,222500-1,0,0,0,5.66,,
77589,222501-1,7,7,0,6.26,,
77590,222502-1,6,6,0,5.34,,
77591,222503-1,10,0,10,6.03,,
77592,222522-1,5,5,0,6.83,,
77593,222710-1,6,5,1,18.84,,
77594,222712-1,5,5,0,16.71,,
77595,225400-1,1,1,0,26.35,,
77596,225420-1,0,0,0,26.35,,
77597,226312-1,6,6,0,12.65,,
77598,227023-1,9,7,2,5.98,,
77599,227030-1,9,2,7,5.98,,
77600,227108-1,6,6,0,6.42,,
77601,227135-1,10,0,10,4.48,,
77602,227141-1,6,6,0,3.23,,
77603,221842-1,7,7,0,4.48,,
77604,221860-1,6,1,5,17.42,,
77605,221880-1,0,0,0,23.19,,
77606,221910-1,2,2,0,24.29,,
77607,221920-1,4,4,0,20.77,,
77608,221930-1,0,0,0,8.37,,
77609,222435-1,0,0,0,57.14,,
77610,222440-1,1,1,0,68.26,,
77611,221982L-1,2,0,2,56.10,,
77612,222380-1,4,4,0,17.77,,
77616,321291-1,5,5,0,25.79,,
77618,321292-1,0,0,0,24.11,,
77619,321295-1,0,0,0,21.98,,
77620,321296-1,4,0,4,23.55,,
77621,321581-1,16,11,5,6.42,,
77624,321582-1,0,0,0,7.26,,
77627,321583-1,11,8,3,5.60,,
77635,321402-1,0,0,0,17.41,,
77637,321404-1,0,0,0,17.41,,
77642,321422-1,0,0,0,18.21,,
77643,321424-1,3,2,1,18.81,,
77644,321426-1,2,2,0,18.81,,
77645,321462-1,0,0,0,17.97,,
77647,321463-1,1,0,1,17.97,,
77649,321464-1,0,0,0,16.85,,
77650,321466-1,0,0,0,17.97,,
77662,321473-1,0,0,0,18.82,,
77664,321474-1,1,1,0,18.82,,
77671,321476-1,0,0,0,18.82,,
77674,321482-1,0,0,0,18.67,,
77677,321483-1,1,1,0,18.67,,
77679,321484-1,2,2,0,18.67,,
77682,321486-1,0,0,0,18.67,,
77683,321488-1,0,0,0,21.74,,
77684,321489-1,0,0,0,21.74,,
77685,321492-1,0,0,0,21.74,,
77687,325028-1,2,1,1,13.20,,
77688,325029-1,0,0,0,13.20,,
77689,325038-1,6,0,6,12.33,,
77690,325039-1,37,10,27,7.99,,
77691,325044-1,1,0,1,10.00,,
77692,325060-1,4,4,0,5.23,,
77693,325061-1,3,0,3,5.23,,
77694,325120-1,8,0,8,6.79,,
77695,325121-1,0,0,0,7.26,,
77696,325122-1,0,0,0,7.39,,
77697,325140-1,2,2,0,12.52,,
77698,325141-1,8,0,8,12.52,,
77699,325150-1,6,2,4,34.24,,
77700,325160-1,1,1,0,6.73,,
77701,325161-1,10,2,8,6.89,,
77702,325168-1,3,0,3,20.35,,
77704,325173-1,8,2,6,27.89,,
77705,325175-1,8,0,8,26.92,,
77706,325190-1,4,4,0,77.80,,
77707,325199-1,1,1,0,14.34,,
77708,325233-1,2,0,2,39.83,,
77709,325235-1,0,0,0,40.95,,
77710,325236-1,8,0,8,30.93,,
77711,325613-1,8,8,0,11.88,,
77712,325615-1,3,2,1,15.86,,
77713,325925-1,4,0,4,9.11,,
77714,GP1030-02,0,0,0,363.62,,
77716,326510-3,3,1,2,113.01,,
77717,326515-3,3,1,2,129.91,,
77718,326520-3,0,0,0,103.49,,
77719,326525-3,4,2,2,134.19,,
77720,326530-3,2,2,0,103.49,,
77721,326535-3,3,1,2,135.24,,
77722,326580-3,0,0,0,50.70,,
77723,326585-3,1,0,1,74.36,,
77724,326598-1,4,2,2,71.96,,
77725,8309819,11,7,4,3.38,,
77726,326599-1,1,1,0,24.95,,
77727,AN110,22,9,13,11.19,,
77728,AN150SR,27,23,4,13.43,19.95,
77729,1181067,14,4,10,16.15,,
77730,ANT1B,12,5,7,5.92,,
77731,ACDC3212,0,0,0,76.00,,
77744,B265C-LM-MM,0,0,0,1522.16,,
77775,A2K-4WD-1,2,1,1,108.40,,
77780,33703,0,0,0,30.86,,
77782,AV3012,0,0,0,476.13,,
77787,010-12842-01,5,4,1,14.99,,
77788,010-12842-02,0,0,0,7.49,,
77789,010-12938-00,0,0,0,17.24,,
77790,010-12842-00,0,0,0,74.99,,
77791,010-12841-01,0,0,0,14.99,,
77792,010-12841-02,0,0,0,7.49,,
77793,010-12841-00,4,1,3,59.99,,
77800,RMX4600-06,0,0,0,414.53,,
77805,PO414DWC-20,0,0,0,172.82,,
77807,249108,0,0,0,7.17,,
77808,SBB2,26,26,0,25.09,,
77811,NDA-3,456,456,0,14.63,,
77815,LPD-6,1,1,0,111.92,,
77816,LPD-7,4,4,0,129.94,,
77817,LPD-8,2,2,0,149.41,,
77818,LPD-10,7,7,0,183.89,,
77819,D-825,8,8,0,100.86,,
77820,D-1025,6,6,0,120.29,,
77828,RLBL,3,3,0,22.35,,
77829,RJBM,6,6,0,16.20,,
77832,RUBS,37,37,0,11.38,,
77834,401412-1,2,2,0,18.04,,
77835,401413-1,0,0,0,20.74,,
77836,401417-1,12,2,10,18.50,,
77837,401418-1,5,5,0,25.23,,
77838,401420-1,2,2,0,33.65,,
77839,401421-1,7,7,0,33.65,,
77840,401422-1,3,0,3,32.53,,
77842,400193-1,0,0,0,42.64,,
77844,400198-1,9,4,5,54.49,,
77845,400200-1,5,0,5,31.41,,
77846,400203-1,2,0,2,44.90,,
77848,400208-1,6,1,5,60.31,,
77849,400209-1,3,3,0,68.79,,
77851,400353-1,11,11,0,53.96,,
77852,400358-1,4,4,0,70.90,,
77853,400400-1,7,4,3,50.26,,
77854,400410-1,3,0,3,71.96,,
77858,400710-3,3,3,0,35.89,,
77859,400730-3,1,1,0,33.79,,
77861,401240-1,11,11,0,10.87,,
77862,401270-1,8,5,3,15.50,,
77863,401274-1,0,0,0,14.90,,
77864,FASP4881TCCAA00,0,0,0,335.95,,
77865,400070-1,0,0,0,45.49,,
77866,400071-1,10,5,5,42.08,,
77867,400073-1,6,5,1,40.95,,
77868,400078-1,0,0,0,55.01,,
77869,400079-1,1,0,1,70.37,,
77870,400110-1,5,4,1,21.30,,
77871,400120-1,5,5,0,17.31,,
77872,400130-1,3,3,0,17.31,,
77873,400135-1,0,0,0,9.71,,
77874,400136-1,3,3,0,23.87,,
77875,400140-1,5,3,2,16.89,,
77876,400016-1,1,0,1,57.67,,
77878,400020-1,3,1,2,15.50,,
77879,400022-1,0,0,0,38.71,,
77880,400023-1,4,3,1,39.83,,
77881,585-0220-7,2,1,1,238.27,,
77882,400026-1,3,3,0,46.56,,
77886,405110-1,1,1,0,25.79,,
77887,405115-1,0,0,0,24.11,,
77890,405335-3,0,0,0,77.24,,
77894,13822,0,0,0,45.40,,
77896,328112-1,14,6,8,14.05,,
77897,328114-1,6,5,1,18.24,,
77898,328115-1,0,0,0,7.92,,
77899,328120-1,0,0,0,26.67,,
77900,328190-1,0,0,0,2.92,,
77901,328195-1,9,9,0,4.48,,
77902,328196-1,7,7,0,5.08,,
77903,328197-1,7,0,7,6.89,,
77904,327122-1,3,3,0,19.56,,
77905,424617-1,0,0,0,54.23,,
77906,424623-1,0,0,0,32.53,,
77907,424627-1,0,0,0,43.51,,
77908,424636-1,0,0,0,42.31,,
77909,426120-1,20,18,2,7.02,,
77910,421615-1,11,5,6,12.32,,
77911,421617-1,4,2,2,22.42,,
77912,421625-1,10,9,1,25.23,,
77913,421610-1,3,0,3,36.45,,
77914,421620-1,6,1,5,49.20,,
77917,431310-1,8,2,6,15.12,,
77918,431210-1,12,7,5,28.05,,
77919,431230-1,10,4,6,29.17,,
77920,431250-1,0,0,0,29.73,,
77921,431430-1,6,2,4,13.71,,
77922,131000-812-004-19,1,1,0,100.69,,
77924,432520-1,1,0,1,260.82,,
77926,432620-1,0,0,0,216.93,,
77927,431115-1,11,8,3,27.48,,
77928,431110-1,3,3,0,23.55,,
77929,431120-1,1,0,1,46.00,,
77930,431125-1,7,6,1,42.59,,
77931,431151-1,1,1,0,24.11,,
77932,431153-1,1,0,1,13.57,,
77933,431152-1,6,2,4,18.50,,
77934,S00-00522-04,2,0,2,3.26,,
77935,010-12773-00,4,0,4,56.50,,
77936,660040-1,1,1,0,48.14,,
77937,660020-1,2,2,0,48.80,,
77938,420350-1,8,6,2,22.03,,
77954,420488-1,11,9,2,13.11,,
77955,420486-1,9,5,4,12.52,,
77956,420487-1,12,5,7,12.71,,
77957,420498-1,2,2,0,16.29,,
77958,420496-1,12,9,3,12.52,,
77959,420495-1,5,5,0,7.15,,
77960,06-01-001,0,0,0,11.75,,
77961,06-01-002,0,0,0,11.60,,
77962,06-01-003,0,0,0,11.44,,
77963,06-01-004,0,0,0,15.90,,
77964,06-01-005,0,0,0,13.98,,
77965,06-01-006,0,0,0,13.98,,
77966,06-01-007,0,0,0,15.16,,
77967,06-01-008,0,0,0,13.98,,
77969,06-01-010,0,0,0,17.39,,
77970,06-01-011,0,0,0,16.35,,
77972,06-01-013,3,1,2,20.52,,
77973,06-01-014,0,0,0,23.49,,
77974,06-01-015,0,0,0,19.62,,
77975,06-01-016,0,0,0,17.54,,
77976,06-01-017,0,0,0,23.49,,
77977,06-01-018,0,0,0,19.32,,
77978,41670,1,1,0,85.60,149.99,
77979,06-01-019,0,0,0,29.73,,
77980,06-01-020,0,0,0,45.04,,
77981,06-01-021,0,0,0,22.59,,
77982,41671,3,0,3,57.75,109.99,
77983,06-02-022,0,0,0,34.19,,
77984,06-02-023,0,0,0,25.72,,
77985,06-02-024,0,0,0,35.38,,
77986,06-02-025,0,0,0,34.19,,
77987,06-02-026,0,0,0,46.53,,
77988,41672,1,0,1,71.84,129.99,
77989,06-02-027,0,0,0,41.77,,
77990,06-02-028,0,0,0,39.54,,
77992,06-02-029,0,0,0,61.10,,
77993,06-02-030,0,0,0,70.62,,
77994,41675,3,2,1,120.31,219.99,
77995,06-02-031,0,0,0,66.30,,
77996,06-02-032,0,0,0,82.51,,
77997,06-02-033,0,0,0,105.99,,
77998,06-02-034,0,0,0,105.99,,
77999,001-464-280-00,0,0,0,100.00,,
78001,70-17,1,0,1,30.06,,
78012,010-01499-00,5,2,3,157.48,,
78013,010-01500-00,3,1,2,233.81,,
78019,010-01628-00,12,3,9,161.06,,
78024,25SA-6WC,9,6,3,78.17,,
78025,RMX4400-09,0,0,0,392.72,,
78028,010-12920-00,0,0,0,63.74,,
78031,010-C1128-00,0,0,0,131.23,,
78034,189ATP,2,2,0,901.25,,
78035,"8/6 RS",0,0,0,10.19,,
78036,"10 RS",4,1,3,8.75,,
78037,"10/6 RS",0,0,0,10.44,,
78038,"12 PM",12,0,12,10.50,,
78039,"12/6 PM",16,15,1,13.79,,
78040,"14 PM",6,5,1,10.83,,
78041,"14/8 PM",6,3,3,14.31,,
78042,"10 VRS",0,0,0,16.74,,
78043,"12 VRS",0,0,0,18.05,,
78044,SM4,11,4,7,23.30,,
78045,SM6,17,17,0,26.25,,
78046,SM8,1,1,0,32.16,,
78047,FRBBA213,1,1,0,76.14,,
78048,FRBBA219,1,1,0,82.49,,
78050,1680DP012V,10,3,7,51.07,,
78058,SMP4,0,0,0,35.44,,
78059,SMP6,0,0,0,40.38,,
78060,SMP8,2,0,2,51.69,,
78064,PRS,1,1,0,7.46,,
78088,988-23-100,0,0,0,132.00,,
78089,010-02167-00-3,7,4,3,111.89,,
78090,010-02167-01-3,1,1,0,111.89,,
78092,SS175C-12-L-MM,0,0,0,1138.92,,
78093,010-12887-00,2,1,1,9.49,,
78094,010-12888-00,5,1,4,11.68,,
78095,010-12889-00,0,0,0,15.34,,
78096,010-12890-00,0,0,0,19.72,,
78097,010-12892-00,6,0,6,15.34,,
78098,010-12893-00,0,0,0,19.72,,
78099,010-12894-00,0,0,0,31.42,,
78100,010-12895-00,8,1,7,5.10,,
78101,010-12896-00,4,1,3,5.10,,
78102,S00-00522-15,0,0,0,26.07,,
78103,S00-00522-16,0,0,0,29.33,,
78104,S00-00522-17,0,0,0,26.07,,
78105,010-12717-00,0,0,0,26.07,,
78106,010-12717-10,2,2,0,29.33,,
78114,010-12878-00,0,0,0,12.42,,
78115,51960,0,0,0,28.49,,
78116,010-12878-10,3,0,3,15.34,,
78117,010-12878-20,0,0,0,12.42,,
78118,010-12878-30,0,0,0,12.42,,
78119,010-12879-00,7,0,7,13.87,,
78120,010-12879-10,1,1,0,10.00,,
78121,010-12879-20,1,0,1,13.87,,
78122,010-12879-30,3,3,0,13.87,,
78123,010-12880-00,2,1,1,15.34,,
78124,010-12880-10,2,2,0,19.72,,
78125,010-12880-20,0,0,0,15.34,,
78126,010-12880-30,0,0,0,15.34,,
78128,CAB000850,6,0,6,7.81,,
78131,S00-00522-23,13,2,11,1.95,,
78132,S00-00522-22,0,0,0,3.47,,
78134,S00-01195-00,5,0,5,6.94,,
78137,010-12519-42,2,1,1,20.43,,
78139,S00-00522-20,14,0,14,1.95,,
78141,S00-00522-19,1,0,1,1.29,,
78144,S00-00522-21,3,2,1,3.26,,
78147,S00-01196-00,0,0,0,3.47,,
78153,010-12789-00,4,0,4,12.42,,
78154,010-12789-10,2,0,2,15.34,,
78155,010-12789-20,3,2,1,12.42,,
78177,34000,10,3,7,144.98,,
78181,IL200P-24,6,4,2,39.57,,
78183,217,17,6,11,22.49,,34.98
78185,000-033-337-00,0,0,0,181.82,,
78186,GP1800-10,0,0,0,312.72,,
78205,OC17234,0,0,0,14.15,,
78206,OC17235,3,3,0,6.28,,
78207,OC17236,0,0,0,12.55,,
78208,D00342H,5,4,1,25.84,,
78209,INFMPK90-4,0,0,0,290.84,399.95,
78210,SC28,0,0,0,248.63,,
78211,KITOBDBR-02',1,1,0,110.37,,
78212,KITOBDBR-04',0,0,0,110.37,,
78213,KITOB-06',0,0,0,115.71,,
78226,RC88CAP12V,0,0,0,1417.76,2009.00,
78227,INFMPK250-4,0,0,0,348.95,469.95,
78229,300-138,0,0,0,2336.39,,2978.90
78230,A1200SCPEIC,2,2,0,84.44,,
78231,33751,0,0,0,91.29,,
78232,22014-P,6,3,3,76.76,,
78235,LLB-366N-31-10,0,0,0,70.73,,
78236,PP5050-15,0,0,0,370.90,,
78237,PP4400-12,0,0,0,269.08,,
78238,22005CASE,1,0,1,36.00,,
78239,22213CASE,7,1,6,153.55,,
78240,22239CASE,0,0,0,74.28,,
78241,22241CASE,0,0,0,75.75,,
78242,22240CASE,2,1,1,104.18,,
78243,22250CASE,1,1,0,242.55,,
78244,22001CASE,0,0,0,24.30,,
78245,22003CASE,4,0,4,42.98,,
78246,22004CASE,5,0,5,18.68,,
78247,22254CASE,6,0,6,72.55,,
78248,22255CASE,2,1,1,259.15,,
78252,22206CASE,1,1,0,55.65,,
78253,22207CASE,2,0,2,74.85,,
78254,30445CASE,3,1,2,28.95,,
78255,SSP-100-KIT,0,0,0,259.09,373.90,
78256,30204CASE,7,0,7,47.63,,
78257,SSP-150-KIT,0,0,0,301.14,434.60,
78258,30570CASE,8,0,8,92.80,,
78259,ADJ-28,2,2,0,85.45,123.30,
78261,SC-05,1,1,0,53.41,77.10,
78262,SC-10,1,1,0,82.39,118.90,
78264,30205CASE,1,0,1,37.35,,
78266,30213CASE,1,1,0,60.98,,
78269,30306CASE,4,0,4,80.10,,
78270,30573CASE,5,0,5,42.68,,
78271,30574CASE,2,0,2,71.18,,
78272,30616CASE,7,0,7,66.98,,
78273,30604CASE,4,0,4,116.25,,
78277,30586CASE,1,1,0,64.88,,
78279,30674CASE,10,0,10,296.75,,
78280,30370CASE,9,0,9,164.90,,
78281,30340CASE,3,0,3,51.00,,
78282,30324CASE,4,0,4,77.10,,
78285,13150,0,0,0,167.68,,
78290,JAHD240BT,10,4,6,79.55,129.95,
78294,6353EL-B.GRAY,0,0,0,74.90,,
78297,LLB-46WW-3A-SS,0,0,0,53.78,,
78298,LLB-46WW-3A-BN,0,0,0,53.78,,
78301,TMS10,0,0,0,13.39,,
78302,TMS12,8,5,3,16.41,,
78303,FFMK,1,0,1,128.63,,
78304,FFMG,0,0,0,128.63,,
78305,RF5500R,0,0,0,17.64,,
78307,90512,7,1,6,30.49,,
78310,FFWC,1,1,0,128.63,,
78311,TR,4,2,2,13.58,,
78312,SAS-900,3,1,2,1929.99,,
78314,TMCV,0,0,0,78.75,,
78315,PWC3H,1,1,0,13.48,,
78316,PWC1/2,0,0,0,19.03,,
78317,LLB-36MN-41-00,2,0,2,181.18,,
78318,PWCGW10,1,1,0,15.63,,
78319,PWC12,0,0,0,10.36,,
78320,PWC12SH,9,8,1,11.03,,
78321,PWCETS,10,10,0,13.78,,
78323,BOWA0651,0,0,0,3112.31,4150.00,
78324,BPPJA,1,1,0,703.69,,
78325,BPCANHUB,0,0,0,67.50,,
78326,BPCABCPC,1,1,0,93.00,,
78330,CQWB,4,4,0,36.98,,
78331,COW,0,0,0,21.65,,
78332,BTD,0,0,0,10.83,,
78333,EBCTD,0,0,0,27.31,,
78334,DS,5,3,2,11.24,,
78335,MCS,0,0,0,9.36,,
78336,BGTD,3,3,0,6.71,,
78337,SSBGTD,5,5,0,11.01,,
78338,WS16,8,0,8,10.96,,
78339,WS20,1,1,0,11.49,,
78340,WS16S,73,73,0,15.49,,
78341,WS20S,76,60,16,18.11,,
78342,WS25,0,0,0,13.13,,
78343,WS16T,0,0,0,11.49,,
78344,WS20T,0,0,0,11.81,,
78345,WS25T,0,0,0,13.79,,
78346,WSY20,2,2,0,21.00,,
78347,WSY25,5,5,0,23.63,,
78348,WSY30,0,0,0,29.81,,
78349,WS3Y20,0,0,0,27.49,,
78350,WS3Y25,0,0,0,32.19,,
78351,WS3Y30,0,0,0,36.44,,
78352,GP1050-33,0,0,0,327.26,,
78353,RT40,5,4,1,73.50,,
78354,SSRT40,5,3,2,103.69,,
78355,RT50,0,0,0,41.80,,
78356,RT50SH,0,0,0,44.14,,
78357,RTB,0,0,0,10.94,,
78358,RTB-U,0,0,0,10.94,,
78359,RTB80,0,0,0,10.94,,
78360,RTB-E,0,0,0,13.43,,
78361,1QRTD2,0,0,0,17.74,,
78362,1QRTD4,0,0,0,18.11,,
78363,1QT2,0,0,0,18.48,,
78364,1QT3,0,0,0,19.63,,
78365,1QT4,0,0,0,20.38,,
78366,TTDS1/2,0,0,0,17.74,,
78367,TTDS1/3,3,3,0,18.04,,
78368,TTDS1/4,0,0,0,18.11,,
78369,1PB2,0,0,0,17.74,,
78370,1PB4,0,0,0,18.48,,
78371,RTD3,0,0,0,22.64,,
78372,RTD4,2,2,0,22.98,,
78373,RTD6,1,1,0,23.95,,
78374,UTD,0,0,0,19.09,,
78375,TTD2,34,0,34,24.94,,
78376,TTD3,2,2,0,25.91,,
78377,TTD4,19,7,12,26.11,,
78378,TTD5,0,0,0,26.51,,
78379,TTD6,0,0,0,26.90,,
78380,QRTD2,1,1,0,19.63,,
78381,QRTD4,8,8,0,20.41,,
78382,QRTD6,0,0,0,21.14,,
78383,QRTD2VP,0,0,0,23.95,,
78384,QRTD4VP,6,6,0,24.48,,
78385,QRTD6VP,0,0,0,25.06,,
78387,2PB4,5,5,0,20.80,,
78388,2PB6,1,0,1,21.53,,
78389,2PB2VP,0,0,0,23.89,,
78390,2PB4VP,0,0,0,24.55,,
78391,2PB6VP,0,0,0,25.34,,
78392,R2TTD3,7,2,5,34.53,,
78393,R2TTD5,4,2,2,35.11,,
78395,31038,5,2,3,24.45,,
78399,PBGW10,0,0,0,13.06,,
78400,PBGW13,0,0,0,13.71,,
78401,PBGW16,0,0,0,14.19,,
78402,QRGW10,6,6,0,8.99,,
78403,QRGW13,0,0,0,13.98,,
78404,QRGW16,4,4,0,14.76,,
78405,R1GW10,7,2,5,14.70,,
78406,R1GW13,5,5,0,15.75,,
78407,R1GW16,8,5,3,16.86,,
78408,GW2/10,0,0,0,12.54,,
78409,GW2/13,0,0,0,13.06,,
78410,GW2/16,0,0,0,13.73,,
78411,GW2/18,0,0,0,14.19,,
78412,GW2/20,0,0,0,14.44,,
78413,SS1QRTD2,0,0,0,33.21,,
78414,SS1QRTD4,9,9,0,24.99,,
78415,SS1QRTD6,0,0,0,35.58,,
78416,SSRTD3,0,0,0,61.04,,
78417,SSRTD4,0,0,0,61.36,,
78418,SSRTD6,0,0,0,61.83,,
78419,SSRGW10,0,0,0,37.21,,
78420,SSRGW13,0,0,0,38.00,,
78421,SSRGW16,0,0,0,39.64,,
78422,SSTTD3,6,6,0,62.37,,
78423,SSTTD4,0,0,0,73.20,,
78424,SSTTD6,0,0,0,74.75,,
78425,SS/QRTD3,0,0,0,56.24,,
78426,SS/QRTD4,0,0,0,57.03,,
78427,SS/QRTD6,0,0,0,57.69,,
78428,SS/GW210,0,0,0,18.70,,
78429,SS/GW213,0,0,0,19.36,,
78430,SS/GW216,0,0,0,19.69,,
78431,SS/GW220,0,0,0,20.35,,
78432,RW,0,0,0,15.41,,
78433,RW2,2,2,0,10.18,,
78434,RW2/S,0,0,0,11.03,,
78435,CW,0,0,0,6.83,,
78436,CW2,0,0,0,7.55,,
78440,LS,0,0,0,11.49,,
78441,VRC,0,0,0,29.46,,
78442,703S-01600,1,1,0,14.21,,
78443,MSR,0,0,0,21.79,,
78444,DKMS,0,0,0,23.30,,
78445,RSS,0,0,0,8.66,,
78446,ETS,4,1,3,23.89,,
78447,SO/O,0,0,0,18.51,,
78448,PS,0,0,0,11.95,,
78449,RS57,6,4,2,8.73,,
78451,PPC-RS,8,5,3,56.76,,
78452,RRW16,2,1,1,12.54,,
78453,RRW32,0,0,0,13.45,,
78454,RPW10,0,0,0,7.68,,
78455,RPW16,0,0,0,8.20,,
78456,FDRW,2,0,2,7.85,,
78458,101545,10,4,6,78.69,,
78469,74306OB,0,0,0,496.48,,
78470,PP4502,0,0,0,276.35,,
78573,010-12547-01,24,0,24,18.74,,
78639,100-418-430-10,0,0,0,4.55,,
78641,491110-1-491115-1KIT,3,3,0,7.27,,
78648,906704,2,0,2,323.12,516.99,
78652,01-0420-SL,0,0,0,549.82,,
78653,32201,0,0,0,267.49,427.99,
78654,32202,0,0,0,267.49,427.99,
78655,32203,0,0,0,280.86,427.99,
78656,32205,2,1,1,267.49,427.99,
78669,7311,0,0,0,59.30,,
78670,7312,0,0,0,59.30,,
78671,7313,0,0,0,59.30,,
78672,7314,0,0,0,59.30,,
78673,7316,0,0,0,59.30,,
78675,7317,0,0,0,59.30,,
78687,229F,0,0,0,33.55,50.95,
78688,230F,0,0,0,71.77,107.95,
78693,300F,0,0,0,29.08,43.95,
78699,379F,0,0,0,33.31,49.95,
78752,6230,2,2,0,27.79,42.80,
78753,6231,2,0,2,35.32,54.40,
78754,6238,0,0,0,65.36,100.65,
78755,6239,0,0,0,72.90,112.25,
78756,6240,0,0,0,84.13,129.55,
78757,6241,0,0,0,90.88,139.95,
78761,HS-40,12,6,6,96.41,,
78762,010-12845-00,0,0,0,55.99,,
78763,91-001-220A-C,0,0,0,237.61,299.00,
78770,883213,1,0,1,1031.25,1649.99,
78772,SP38-2,0,0,0,3569.30,,
78773,SP38-4,0,0,0,3359.30,,
78775,SP38-17,0,0,0,2799.30,,
78776,SP38-18,0,0,0,3989.30,,
78780,TS38,0,0,0,1120.00,,
78781,NF38,0,0,0,1120.00,,
78783,20310025,0,0,0,980.00,,
78785,522112,12,8,4,2.08,,
78790,SC-CW-RCV-LU,1,1,0,8.44,,
78791,SC-CW-RCV-MU,2,2,0,8.44,,
78792,"APEX PA454",0,0,0,189.91,249.95,
78793,APT-F-150-01,7,2,5,255.94,,
78794,"APEX PA1502",0,0,0,263.45,349.95,
78795,"APEX PA1254",0,0,0,309.93,409.95,
78796,67,13,10,3,7.60,,
78821,403061-1,6,6,0,42.64,,
78822,404610-3-403061-1,0,0,0,156.00,,
78829,010-12829-03,11,6,5,19.72,,
78830,010-12817-02,0,0,0,11.68,,
78831,010-12745-01,10,3,7,14.60,,
78836,DT2B-TM,48,28,20,94.79,,
78839,PLABA700,0,0,0,94.49,,
78840,PLABA603,0,0,0,87.74,,
78841,PLABA600,0,0,0,74.24,,
78842,PLABA602,2,2,0,80.99,,
78843,PLABA601,0,0,0,53.99,,
78851,LLB-32KW-11-00,0,0,0,35.12,,
78875,273100-1,0,0,0,5.19,,
78876,273101-1,3,3,0,5.56,,
78877,273110-1,2,2,0,4.97,,
78878,273111-1,8,8,0,5.56,,
78879,273175-1,7,7,0,2.98,,
78880,273176-1,6,6,0,3.18,,
78881,273180-1,0,0,0,2.81,,
78882,273181-1,0,0,0,3.11,,
78883,273580-1,8,2,6,3.11,,
78884,273581-1,9,3,6,3.53,,
78885,270100-1,14,10,4,7.68,,
78886,270101-1,8,8,0,8.05,,
78887,270111-1,0,0,0,10.90,,
78888,270180-1,40,40,0,7.32,,
78890,270191-1,16,10,6,9.66,,
78891,270175-1,4,4,0,7.32,,
78892,S1R,1,0,1,22.99,38.00,
78893,273200-1,15,10,5,3.44,,
78894,273201-1,6,0,6,4.60,,
78895,273205-1,16,6,10,4.44,,
78896,273206-1,3,3,0,4.53,,
78897,273230-1,1,1,0,4.60,,
78898,273231-1,9,5,4,4.84,,
78899,273240-1,2,2,0,5.03,,
78900,273241-1,1,1,0,5.08,,
78901,270200-1,1,1,0,8.87,,
78902,270205-1,0,0,0,11.50,,
78903,270230-1,8,0,8,9.87,,
78904,270235-1,13,5,8,8.48,,
78905,270240-1,5,0,5,9.71,,
78906,270245-1,8,0,8,11.50,,
78907,270260-1,17,8,9,10.00,,
78908,273300-1,16,9,7,2.52,,
78909,589610-1,3,1,2,17.31,,
78910,588130-3,1,0,1,14.50,,
78911,010-12697-00,0,0,0,14.99,,
78912,010-12525-01,0,0,0,8.78,,
78915,T70321,0,0,0,1604.16,,
78917,010-12812-02,11,2,9,11.68,,
78918,001-533-250-00,0,0,0,90.91,,
78964,600-TLM-SIF,0,0,0,44.24,,
78966,010-12547-02,32,1,31,18.74,,
78968,211409,0,0,0,7.99,,
78969,211408,2,1,1,7.99,,
78970,211419,6,4,2,8.33,,
78971,211418,9,6,3,7.99,,
78972,211429,3,3,0,11.87,,
78973,211428,4,2,2,11.44,,
78974,199263,2,2,0,10.67,,
78975,199262,19,9,10,3.73,,
78987,HE-INFIN50,0,0,0,290.85,,
78988,HE-INFIN40,0,0,0,231.39,,
78989,HE-INFIN22,1,1,0,153.83,,
78990,HE-INFIN14,1,1,0,106.00,,
78991,HE-INFIN8,0,0,0,80.79,,
78992,HE-ICL2PK,0,0,0,133.15,,
78993,HE-ICL2,0,0,0,54.62,,
78995,MPS-RGBC-4,3,2,1,26.27,,
78996,010-12800-01,0,0,0,7.49,,
78999,010-12844-00,0,0,0,31.99,,
79009,150112,0,0,0,15.28,,
79011,ZDIGIKVT,4,1,3,157.46,,
79012,ZDIGIKVTUSB,4,2,2,157.46,,
79013,LLB-21KC-71-00,2,2,0,11.77,,
79014,LLB-21KW-71-00,0,0,0,11.77,,
79017,22042,18,12,6,138.33,,
79018,22043,25,18,7,138.33,,
79019,M-65-542,5,0,5,49.94,,
79020,422110-1,0,0,0,40.39,,
79021,422010-1,0,0,0,29.73,,
79022,422800-1,0,0,0,46.00,,
79023,424806-1,0,0,0,57.83,,
79024,425800-1,0,0,0,86.41,,
79026,424605-1,0,0,0,37.03,,
79027,423046-1,9,6,3,17.26,,
79028,424016-1,0,0,0,33.65,,
79029,424116-1,0,0,0,44.88,,
79031,M-65-541,0,0,0,49.94,,
79033,150,1,1,0,28.96,43.95,
79034,224,21,9,12,9.44,13.95,
79035,225,7,6,1,10.94,16.95,
79036,226,2,0,2,23.79,35.95,
79037,227,2,2,0,25.74,38.95,
79038,228,7,1,6,34.16,51.95,
79039,229,0,0,0,34.90,52.95,
79040,230,0,0,0,74.64,112.95,
79041,239,0,0,0,40.35,60.95,
79042,244,0,0,0,27.88,41.95,
79043,245,2,0,2,30.30,45.95,
79044,292,0,0,0,18.96,28.95,
79045,300,0,0,0,30.25,45.95,
79046,326,1,1,0,30.88,46.95,
79047,327,3,1,2,36.96,55.95,
79048,344,5,0,5,44.79,67.95,
79049,365,3,0,3,22.86,34.95,
79050,376,10,0,10,16.04,23.95,
79051,379,0,0,0,34.31,51.95,
79052,381,3,3,0,28.90,43.95,
79053,404,3,0,3,11.31,16.95,
79054,405,4,1,3,12.97,19.95,
79055,406,0,0,0,23.56,35.95,
79056,407,6,3,3,25.74,38.95,
79057,408,0,0,0,33.26,49.95,
79058,409,3,0,3,34.95,52.95,
79059,417,4,1,3,20.36,30.95,
79060,468,8,5,3,23.68,35.95,
79061,469,3,2,1,29.40,43.95,
79062,471,6,2,4,20.81,31.95,
79063,473,8,0,8,26.53,39.95,
79064,2103,0,0,0,8.71,12.95,
79065,2104,0,0,0,8.88,13.95,
79066,2106,7,0,7,15.05,22.95,
79067,2116,0,0,0,50.03,75.95,
79068,2131,0,0,0,5.99,8.95,
79069,2132,0,0,0,8.16,11.95,
79070,2133,0,0,0,6.10,8.95,
79072,2600,0,0,0,35.48,53.95,
79073,2622,0,0,0,46.84,70.95,
79074,2636,3,0,3,24.40,36.95,
79075,2655,6,3,3,33.40,50.95,
79076,2656,0,0,0,37.40,56.95,
79077,2660,2,0,2,62.51,93.95,
79079,340,0,0,0,18.79,28.95,
79080,348,5,3,2,11.10,16.95,
79085,010-12812-01,14,1,13,11.68,,
79101,010-12813-00,12,5,7,6.56,,
79104,010-12814-00,0,0,0,8.03,,
79107,PKF32G,2,2,0,29.23,40.80,
79113,9638,6,1,5,38.19,,
79114,9639,2,2,0,26.34,,
79115,9637,5,3,2,76.36,,
79116,2980,11,6,5,59.30,,
79117,2981,4,3,1,233.55,,
79118,2983,7,2,5,90.32,,
79136,019904,0,0,0,259.16,,
79137,019903,3,0,3,66.00,,
79138,013001,1,0,1,880.00,,
79139,013003,0,0,0,880.00,,
79142,33025,4,2,2,33.49,,
79150,RMX4502,0,0,0,399.99,,
79152,10080,8,3,5,31.12,,
79153,10079,6,2,4,28.30,,
79154,10031,4,2,2,15.26,,
79155,10082,17,6,11,20.17,,
79156,10098,6,4,2,15.56,,
79157,10099,7,4,3,15.56,,
79158,10035,19,10,9,17.78,,
79159,10001,8,5,3,36.24,,
79160,10036,7,3,4,85.60,,
79161,10028XLP,9,3,6,67.67,,
79162,10017XL,5,2,3,77.26,,
79163,10029XLP,19,6,13,130.22,,
79164,10018XL,16,10,6,142.10,,
79165,10010,4,2,2,58.57,,
79166,10011,8,5,3,115.33,,
79167,10107,5,2,3,146.30,,
79168,10108,4,2,2,195.97,,
79169,10105,4,2,2,156.38,,
79170,10524,0,0,0,173.23,,
79171,10106,8,4,4,232.13,,
79172,10122,9,3,6,232.13,,
79173,10624,1,0,1,232.13,,
79174,E70531,0,0,0,359.99,,
79176,S00-00522-10,8,0,8,7.63,,
79181,A80512,8,1,7,87.49,,
79188,E70531-00-NAG,0,0,0,519.99,,
79190,E70533,0,0,0,519.99,,
79192,E70533-00-NAG,0,0,0,679.99,,
79194,E70535,0,0,0,919.99,,
79196,E70535-00-NAG,0,0,0,1079.99,,
79208,RODE54,0,0,0,625.20,,
79214,TR05LM,0,0,0,1109.94,,
79215,TR07LM,4,4,0,1653.18,,
79218,420805-1,0,0,0,4.34,,
79219,420806-1,0,0,0,4.15,,
79220,420808-1,9,0,9,4.13,,
79221,420810-1,18,10,8,4.13,,
79222,420815-1,14,10,4,4.15,,
79223,420820-1,12,10,2,4.15,,
79224,420830-1,0,0,0,4.56,,
79225,420839-1,1,0,1,3.23,,
79227,B60-20-FISO,0,0,0,280.68,,
79255,445185-1,0,0,0,19.06,,
79256,445188-1,4,4,0,31.97,,
79257,445090-1,11,8,3,12.48,,
79258,445190-1,6,0,6,8.94,,
79259,403066-1,0,0,0,28.05,,
79260,420430-1,6,3,3,33.65,,
79266,426113-1,5,0,5,5.82,,
79271,2129,2,2,0,14.84,,
79274,911421A5,0,0,0,19.74,,
79284,010-02277-00,50,0,50,562.49,,
79285,RH5332V,4,2,2,107.69,,
79289,34012B,0,0,0,12.47,,
79290,34012S,24,18,6,12.47,,
79291,34014B,13,9,4,13.43,,
79292,34014S,18,12,6,13.43,,
79293,911313,4,2,2,257.50,411.99,
79294,34016B,14,7,7,14.52,,
79296,34018B,17,14,3,15.45,,
79297,34018S,53,35,18,15.45,,
79298,34020B,0,0,0,17.98,,
79299,34020S,9,1,8,17.98,,
79300,34022B,10,6,4,21.81,,
79301,34022S,12,7,5,21.81,,
79302,34024B,4,0,4,26.67,,
79303,34024S,5,3,2,26.67,,
79304,34026B,4,0,4,30.45,,
79305,34026S,6,3,3,30.45,,
79306,36180,6,4,2,132.15,,
79307,36110,0,0,0,132.15,,
79308,37180,13,8,5,132.15,,
79309,37110,10,8,2,132.15,,
79312,33006A,10,2,8,23.81,,
79313,33007A,15,10,5,24.80,,
79314,33010A,22,4,18,27.95,,
79315,33012A,10,10,0,24.80,,
79316,33014A,8,0,8,27.95,,
79317,33070A,6,2,4,29.67,,
79319,SCED2225,0,0,0,40.56,,
79321,34016S,30,24,6,14.52,,
79325,AVLWR02401,0,0,0,1250.00,,
79332,S11-01315-30,4,2,2,169.74,,
79335,323-500,0,0,0,10.19,,
79336,012924,0,0,0,53.80,,
79337,80-47231-01,1,1,0,304.94,,
79338,80-47232-01,0,0,0,328.40,,
79343,010-12256-12,0,0,0,18.74,,
79344,E70363,12,6,6,453.94,,
79346,E70364,6,6,0,472.09,,
79350,E70364-02,3,3,0,547.09,,
79361,E70366,22,9,13,782.25,,
79370,E70368,19,10,9,1693.54,,
79372,E70369,18,11,7,1226.66,,
79374,E70369-03,10,3,7,1476.66,,
79376,126,8,5,3,9.64,,
79378,010-11822-02,2,2,0,19.99,,
79379,S1W,6,0,6,26.67,39.90,
79380,S1G,10,0,10,26.67,39.90,
79381,S1B,7,0,7,26.67,39.90,
79385,E70481,1,1,0,1679.99,,
79411,E70371,1,1,0,1919.99,,
79419,E70483,2,0,2,3999.99,,
79421,E70373,1,1,0,4399.99,,
79424,13889,2,2,0,68.88,,
79426,GP2050-06,0,0,0,327.26,,
79427,ZDIGAISNODE,3,1,2,487.46,,
79432,289-002B,0,0,0,38.81,,
79434,32-700,2,1,1,781.25,,
79447,010-C1156-00,0,0,0,262.49,,
79463,IPB02BK,0,0,0,27.85,,
79464,DP60-B-CC,0,0,0,36.31,,
79465,012925,0,0,0,58.29,,
79466,012926,2,2,0,75.33,,
79468,012923,1,0,1,58.70,93.00,
79469,DOLLY-2-B-HD,0,0,0,55.17,,
79470,315FPX,6,5,1,35.01,,
79479,010-12832-00,0,0,0,52.49,,
79480,010-12832-01,3,1,2,52.49,,
79481,010-12832-10,0,0,0,18.74,,
79482,010-12832-18,0,0,0,18.74,,
79483,010-12832-20,0,0,0,41.24,,
79484,010-12832-22,0,0,0,41.24,,
79485,010-12832-25,0,0,0,26.24,,
79486,010-12832-30,7,2,5,44.99,,
79487,010-12833-00,2,0,2,194.99,,
79488,010-12834-00,7,4,3,236.24,,
79489,010-12832-50,0,0,0,44.99,,
79491,A80036,0,0,0,782.60,,
79496,FP-OUT3,0,0,0,18.11,,
79499,C2111-08-00600,0,0,0,292.60,,
79500,C2111-12-00600,0,0,0,493.05,,
79501,C2113-10-00600,0,0,0,380.95,,
79502,SAD-24B,6,2,4,22.50,,
79503,980500741,0,0,0,21.52,,
79504,RA38A,0,0,0,26.44,,
79519,T70320,0,0,0,1604.16,,
79526,63002,0,0,0,537.49,859.99,
79532,1363747,5,0,5,1625.00,,
79537,1902340,13,8,5,1391.19,,
79538,1902335,16,6,10,1240.79,,
79539,1903017,16,8,8,30.54,,
79540,1852075,4,1,3,25.42,,
79541,1850276,3,0,3,27.01,,
79542,A80484,0,0,0,55.39,,
79543,T232,0,0,0,195.82,,
79550,720105-1,38,34,4,25.37,,
79558,RODE47,0,0,0,391.20,,
79559,SP4156,0,0,0,49.80,,
79561,40181,2,2,0,14.37,22.99,
79562,UST850S-P17-N2,0,0,0,961.42,,
79564,710302-1,3,3,0,643.99,,
79565,720106-1,15,15,0,58.44,,
79566,720106-2,10,5,5,64.93,,
79567,720107-1,19,7,12,40.91,,
79568,720108-1,20,4,16,49.99,,
79570,411260-1,34,15,19,1064.18,,
79571,APT-F-LB-01,5,5,0,111.94,,
79593,P79-235-N2,0,0,0,310.91,,
79595,AM120W,0,0,0,31.60,,
79598,10-1476-40,8,4,4,24.07,,
79601,977339-T,3,0,3,61.94,,
79603,815000,13,7,6,111.18,,
79629,HE-SLWH1,3,1,2,22.02,,
79630,AV212,3,1,2,350.00,,
79632,322210-1,2,0,2,14.79,,
79633,324310-1,1,0,1,9.71,,
79634,329990-1,8,6,2,2.39,,
79635,412428B-1,0,0,0,87.86,,
79636,412421B-1,0,0,0,87.86,,
79637,414900-3,3,3,0,51.87,,
79638,414800-3,0,0,0,144.50,,
79639,412428W-1,0,0,0,94.21,,
79640,412421W-1,1,0,1,94.21,,
79641,151300-410-004-17,0,0,0,234.79,,
79642,LLB-32KW-01-M0,1,0,1,27.99,,
79644,C998-20,0,0,0,81.78,,
79645,227561-1,11,6,5,8.94,,
79646,227560-1,5,0,5,8.94,,
79647,322620-1,4,1,3,30.85,,
79648,327200-1,7,0,7,11.95,,
79649,328012-1,1,0,1,17.32,,
79650,328013-1,12,10,2,17.87,,
79651,328059-1,1,1,0,11.32,,
79653,322150-1,5,3,2,50.26,,
79654,321680-1,0,0,0,37.58,,
79660,ZDIGAIT5000,0,0,0,974.96,,
79688,820009,3,2,1,419.84,462.97,
79689,GP1900-04,0,0,0,319.99,,
79691,325-002,2,0,2,47.28,,
79692,R30303,0,0,0,191.22,266.90,
79693,R30303BM30NT,2,2,0,272.82,380.00,
79694,R30303BM30PW,1,1,0,272.82,380.00,
79695,R30303BM30PG,2,2,0,272.82,380.00,
79696,R30303BM30PB,2,2,0,272.82,380.00,
79697,533-VW-S,2,1,1,255.19,,
79699,40021006,0,0,0,2745.27,,
79701,CA-STREAM,0,0,0,655.18,,
79702,T70281,1,1,0,1065.78,,
79704,0111,0,0,0,72.80,,
79705,R111C-LM,0,0,0,3076.70,,
79706,329515,6,1,5,11.35,,
79711,010-12826-00,0,0,0,749.99,,
79714,PLASE360,56,44,12,18.00,,
79715,PLASE371,35,35,0,21.21,,
79716,PLASE370,57,57,0,21.21,,
79717,PLASE373,100,96,4,25.71,,
79718,PLASE400,6,6,0,38.57,,
79720,PLASE503,2,2,0,38.57,,
79721,PLASE700,3,0,3,35.36,,
79722,PLASE600,0,0,0,25.71,,
79723,PLASE800,6,2,4,35.36,,
79724,PLASV455,2,0,2,12.86,,
79725,PLASV373,2,2,0,11.08,,
79726,PLASV370,4,4,0,9.75,,
79727,PLASV371,1,1,0,9.75,,
79728,PLASV363,0,0,0,8.25,,
79729,PLASV360,6,6,0,7.50,,
79730,PLASV350,6,6,0,5.73,,
79732,2156,4,2,2,57.13,85.95,
79733,2157,2,2,0,53.42,80.95,
79734,2638,0,0,0,55.26,82.95,
79735,2639,0,0,0,59.26,88.95,
79736,2640,3,0,3,91.23,137.95,
79737,2641,0,0,0,95.21,143.95,
79738,2642,2,2,0,46.12,69.95,
79739,F-1-WHITE,0,0,0,44.69,,
79740,2643,0,0,0,50.09,75.95,
79741,F-1-BLACK,0,0,0,44.69,,
79742,2644,1,1,0,23.47,35.95,
79743,F-02-WHITE,0,0,0,52.86,,
79744,2645,0,0,0,79.55,119.95,
79745,2646,0,0,0,83.60,125.95,
79746,F-02-BLACK,0,0,0,52.86,,
79747,F-2-WHITE,3,0,3,49.99,,
79748,F-2-BLACK,0,0,0,61.26,,
79749,F-3-WHITE,0,0,0,82.50,,
79750,F-3-BLACK,0,0,0,83.93,,
79751,F-4-WHITE,0,0,0,106.66,,
79752,F-4-BLACK,0,0,0,106.66,,
79753,F-5-WHITE,0,0,0,109.59,,
79754,F-5-BLACK,0,0,0,109.59,,
79755,F-6-WHITE,5,5,0,149.74,,
79756,F-6-BLACK,0,0,0,149.74,,
79757,F-7-WHITE,0,0,0,217.83,,
79758,F-7-BLACK,5,5,0,217.83,,
79759,F-8-WHITE,0,0,0,363.49,,
79760,F-8-BLACK,0,0,0,363.49,,
79761,F-10-WHITE,0,0,0,416.43,,
79762,F-10-BLACK,0,0,0,416.43,,
79763,F-11-WHITE,0,0,0,490.47,,
79764,F-11-BLACK,0,0,0,490.47,,
79765,F-13-WHITE,0,0,0,902.76,,
79768,PP4500-10,0,0,0,276.35,,
79790,UTV4B,0,0,0,92.97,,
79800,414800-3-414900-3,0,0,0,144.50,,
79805,621-VUP-MC-120-J10,2,0,2,819.08,1003.00,
79810,07-66-035,2,0,2,22.28,,
79839,TW4B16000JV,3,3,0,34.40,,
79841,TW4B14500JV,2,2,0,42.43,,
79846,TW5M26700JV,0,0,0,48.73,,
79847,TW4B02400JV,2,2,0,30.96,,
79857,KG-1WP-R,0,0,0,37.33,47.60,
79858,KG-4WP-R,0,0,0,122.00,155.55,
79859,KG-1GP-R,0,0,0,37.33,47.60,
79860,KG-4GP-R,0,0,0,122.00,155.55,
79861,KG-1CP-R,0,0,0,37.33,47.60,
79862,KG-4CP-R,0,0,0,122.00,155.55,
79863,8014,0,0,0,9.97,,
79865,KG-4BL-PR,0,0,0,122.00,155.55,
79866,18916-0050,16,9,7,20.25,,
79867,GP2200-14,0,0,0,363.62,,
79868,549-EW-RS,0,0,0,383.81,,
79870,ZDIGGPS160,3,2,1,142.46,,
79871,ZDIGGPS160USB,0,0,0,194.96,,
79872,ZDIGGPS160N2K,1,1,0,262.46,,
79873,ZDIGGPS160ST,2,1,1,262.46,,
79874,ZDIGGPS160WL,2,2,0,262.46,,
79875,ZDIGMOBSW,4,2,2,29.96,,
79877,VDR100-01,0,0,0,636.00,,
79878,7060,1,0,1,148.01,182.00,
79899,902213,0,0,0,106.25,169.99,
79903,N20804S,31,9,22,150.27,,
79920,588250-1,9,9,0,32.14,,
79921,50070-0080,5,2,3,142.07,,
79926,400054-3,1,1,0,110.09,,
79927,400157-1,0,0,0,14.90,,
79928,400155-1,1,0,1,14.65,,
79929,30398,9,0,9,14.04,20.79,
79930,30398CASE,1,0,1,80.03,,
79934,30218,10,0,10,6.41,8.79,
79935,30571,19,6,13,5.36,8.79,
79936,30218CASE,1,0,1,36.53,,
79937,922513,0,0,0,106.25,169.99,
79938,MM3-VSA-500,0,0,0,227.27,,
79939,30571CASE,3,1,2,30.53,,
79949,FL50W,0,0,0,98.00,139.95,
79950,E6-10-301-20,17,0,17,8.63,,
79954,D16601,5,3,2,59.99,,
79955,D16601CASE,0,0,0,267.53,,
79956,M21032,0,0,0,35.70,,
79957,M21032CASE,0,0,0,208.58,,
79966,010-02184-01,12,12,0,79.99,,
79967,28512000,0,0,0,649.14,,
79968,53120,0,0,0,203.12,324.99,
79969,53121,0,0,0,203.12,324.99,
79970,53123,0,0,0,203.12,324.99,
79971,53122,0,0,0,203.12,324.99,
79972,53220,0,0,0,168.75,269.99,
79973,53221,0,0,0,178.12,284.99,
79974,53223,0,0,0,187.50,299.99,
79975,53222,0,0,0,187.50,299.99,
79982,221408,0,0,0,16.34,,
79983,221428,4,0,4,23.41,,
79984,221418,0,0,0,16.34,,
79987,2000GT,8,3,5,219.75,,299.00
79988,327150-1,2,0,2,23.55,,
79989,327151-1,0,0,0,22.98,,
79991,010-12464-00,1,1,0,15.99,,
79995,22264,14,5,9,5.49,,
79997,22275,17,8,9,12.95,,
79998,22275CASE,2,1,1,73.80,,
79999,22295,14,12,2,3.59,,
80000,22295CASE,1,1,0,27.30,,
80004,521520-1,0,0,0,6.19,,
80005,521550-1,3,1,2,14.50,,
80006,300085-1,4,0,4,17.90,,
80007,336520-3,0,0,0,45.49,,
80008,336525-3,0,0,0,45.49,,
80009,357390-1,4,1,3,9.40,,
80010,490050-1,2,2,0,22.08,,
80028,1358986,30,26,4,2871.23,,
80029,1358995,1,1,0,2778.41,,
80032,940314,2,0,2,727.43,1163.89,
80033,421645-1,2,2,0,24.11,,
80040,906513,0,0,0,160.93,257.49,
80041,491075-1,0,0,0,11.09,,
80042,429930-1,0,0,0,20.50,,
80043,432590-1,0,0,0,15.50,,
80044,491713-1,8,0,8,20.91,,
80045,512220-1,3,2,1,21.30,,
80046,513110-1,7,4,3,24.39,,
80047,513120-1,0,0,0,20.00,,
80048,520065-1,0,0,0,17.61,,
80054,67852OB,10,6,4,156.85,,
80055,67852OG,6,5,1,156.85,,
80057,83302502,0,0,0,280.02,,
80060,11701100,3,3,0,54.18,,
80063,31501330,8,5,3,320.46,,
80064,31501340,2,0,2,320.46,,
80065,31501512,6,3,3,295.15,,
80066,31501522,1,0,1,295.15,,
80067,31502331,5,1,4,320.46,,
80068,31502341,0,0,0,320.46,,
80069,31512510,0,0,0,385.26,,
80070,31512520,0,0,0,385.26,,
80071,31512710,1,0,1,385.26,,
80072,31512720,0,0,0,385.26,,
80073,041636-1,6,6,0,25.79,,
80074,041666-1,10,9,1,24.06,,
80075,221615-1,0,0,0,116.44,,
80076,337198-1,0,0,0,3.74,,
80077,10-24690-18,12,3,9,197.53,,
80078,10-24939-18,2,2,0,256.79,,
80079,09-824P-2,8,4,4,27.16,,
80080,405300-3,2,1,1,62.43,,
80081,09-849P-2,5,4,1,32.10,,
80082,405320-3,0,0,0,33.09,,
80083,405321-3,0,0,0,37.58,,
80084,421600-1,4,1,3,33.65,,
80085,422790-1,4,1,3,45.49,,
80086,31505,25,24,1,70.52,,99.99
80087,31510,8,3,5,109.71,,149.99
80088,31515,8,3,5,141.06,,189.99
80089,44006,19,7,12,91.19,,119.99
80090,44008,53,27,26,113.99,,149.99
80091,44012,135,78,57,138.59,,179.99
80092,44020,82,51,31,169.39,,219.99
80093,44021,48,12,36,179.39,,229.99
80094,44023,2,2,0,131.20,,170.39
80095,44026,1,0,1,164.26,,210.59
80096,44028,8,2,6,229.41,,290.39
80097,2133,1,1,0,61.66,,
80098,44029,9,5,4,228.93,,289.79
80099,51805,35,33,2,16.70,,
80100,51815,28,6,22,26.25,,
80101,405681-1,1,0,1,42.34,,
80102,RF35109HL,1,0,1,68.62,104.98,
80104,77010700,5,0,5,92.78,,
80105,90405,19,14,5,16.45,,
80106,91005,0,0,0,50.59,,
80107,90516,2,0,2,43.48,,
80108,90530,0,0,0,275.31,,
80110,90402,21,7,14,13.89,,
80112,13721,6,5,1,28.84,,
80113,13725,0,0,0,43.64,,
80114,13806,6,3,3,36.99,,
80116,13818,8,2,6,29.11,,
80117,13808,0,0,0,28.84,,
80118,13009,4,2,2,36.06,,
80119,13001,5,5,0,22.73,,
80120,41500700,4,2,2,18.14,,
80121,13020,0,0,0,22.78,,
80122,33009,3,0,3,46.65,,
80123,77032900,4,1,3,122.02,,
80124,33004,0,0,0,67.89,,
80126,13016,0,0,0,22.73,,
80127,13017,0,0,0,22.73,,
80128,13010,0,0,0,22.73,,
80129,13003,0,0,0,57.79,,
80130,35513000,10,4,6,1240.00,,1550.00
80131,13113,0,0,0,36.44,,
80132,35523000,5,2,3,1480.80,,1851.00
80133,13151,0,0,0,189.64,,
80134,35512000,5,3,2,1049.60,,1312.00
80135,35522000,0,0,0,1344.80,,1681.00
80136,35013000,0,0,0,1195.02,,
80137,35023000,1,1,0,1427.05,,
80138,35012000,0,0,0,1011.73,,
80139,35022000,4,2,2,1296.30,,
80142,36212000,8,0,8,645.93,,
80143,33147,3,2,1,104.93,,
80144,36211200,2,2,0,534.36,,
80145,13117,3,3,0,20.99,,
80147,44320805,0,0,0,1518.40,,1898.00
80148,44321105,5,2,3,1964.80,,2456.00
80149,12819,0,0,0,32.70,,
80150,12861,6,0,6,8.49,,
80151,32861,3,2,1,15.76,,
80153,12823,0,0,0,61.26,,
80155,12805,44,23,21,14.99,,
80156,12833,0,0,0,35.63,,
80157,12830,1,0,1,21.10,,
80158,12875,0,0,0,56.23,,
80159,12814,0,0,0,21.78,,
80160,12831,0,0,0,21.14,,
80161,12910,0,0,0,32.70,,
80163,34607,1,1,0,65.41,,
80164,360-081-029-033C,0,0,0,80.39,107.09,
80165,34617,0,0,0,67.31,,
80166,34650,3,0,3,149.35,,
80167,14607,0,0,0,26.04,,
80168,14605,0,0,0,26.04,,
80169,14612,0,0,0,53.65,,
80170,14604,0,0,0,26.04,,
80172,34611,0,0,0,53.10,,
80173,36005,0,0,0,81.28,,
80174,16016,6,6,0,28.38,,
80175,13736,0,0,0,26.53,,
80178,CW100IT5,0,0,0,2495.93,,
80179,124302,4,1,3,19.62,,
80180,124702,4,2,2,12.91,,
80181,160010,2,2,0,36.18,,
80182,160099,0,0,0,333.37,,
80183,160110,6,3,3,50.11,,
80184,160199,0,0,0,457.55,,
80185,160210,5,3,2,61.67,,
80186,160299,0,0,0,525.67,,
80187,270107,0,0,0,11.49,,
80188,270109,64,11,53,17.26,,
80189,270110,28,20,8,17.26,,
80190,270111,21,10,11,4.60,,
80191,270112,12,6,6,4.60,,
80192,270114,12,7,5,13.26,,
80193,270203,8,3,5,88.34,,
80194,326899,3,2,1,74.02,,
80195,327899,3,2,1,78.05,,
80196,336899,0,0,0,74.02,,
80197,337899,0,0,0,78.05,,
80198,404352,2,0,2,19.16,,
80199,501072-3,2,2,0,41.39,,
80200,702007,6,4,2,5.66,,
80201,702008,0,0,0,8.50,,
80202,702031,2,1,1,28.30,,
80203,702032,5,3,2,14.47,,
80204,703007,0,0,0,39.51,,
80205,703015,3,2,1,46.92,,
80206,703035,2,1,1,46.92,,
80207,703072,3,0,3,30.45,,
80208,703073,0,0,0,64.45,,
80209,703079,0,0,0,134.93,,
80210,SPKKIT,2,1,1,76.81,,
80225,BOLTBLTADJ,7,4,3,259.78,,
80234,RBA-200,0,0,0,219.38,,
80237,010-12937-00,2,2,0,13.03,,
80238,010-12937-01,0,0,0,13.03,,
80239,010-12937-10,2,1,1,11.13,,
80240,010-12937-11,0,0,0,13.03,,
80241,010-12937-20,7,4,3,11.74,,
80242,010-12937-21,0,0,0,13.03,,
80245,8HG998519001,0,0,0,13.92,,
80248,LLB-22KC-21-00,0,0,0,11.08,,
80249,LLB-22KW-21-00,0,0,0,11.08,,
80250,6123AEPA,3,2,1,46.81,,
80274,36111,8,3,5,276.32,499.99,
80276,36112,0,0,0,257.50,411.99,
80278,36113,0,0,0,257.50,411.99,
80279,36114,9,6,3,257.50,411.99,
80280,36115,0,0,0,257.50,411.99,
80281,36116,0,0,0,257.50,411.99,
80284,36117,0,0,0,257.50,411.99,
80285,36118,6,2,4,257.50,411.99,
80286,36119,0,0,0,257.50,411.99,
80288,36208,1,1,0,240.33,411.99,
80292,36200,0,0,0,399.12,638.59,
80293,36201,10,6,4,399.12,638.59,
80295,36202,0,0,0,399.12,638.59,
80297,36203,0,0,0,399.12,638.59,
80298,36204,0,0,0,399.12,638.59,
80299,36205,0,0,0,399.12,638.59,
80300,36206,20,8,12,399.12,638.59,
80301,36207,0,0,0,399.12,638.59,
80302,36360,4,1,3,70.81,109.99,
80310,36363-TC,1,0,1,23.97,41.99,
80312,255,12,6,6,18.51,,
80313,257,4,0,4,18.51,,
80314,355,9,6,3,18.51,,
80315,357,1,1,0,18.51,,
80316,12003OB,6,4,2,158.29,,
80317,12003ON,6,2,4,158.29,,
80318,12003OS,13,9,4,158.29,,
80321,55745,5,3,2,69.25,,
80322,67867,0,0,0,72.40,,
80323,22048,2,2,0,138.33,,
80324,12004OB,11,6,5,126.64,,
80325,12004OS,8,1,7,126.64,,
80327,12005OB,10,5,5,151.00,,
80328,12005OS,2,1,1,151.00,,
80330,1092,2,0,2,16.73,,
80332,GS-390,4,2,2,2625.09,,3299.99
80333,GS-390XL,3,2,1,3081.05,,3849.99
80358,GS-850,5,2,3,560.04,,749.99
80359,GS-900-1,1,0,1,677.74,,949.99
80360,GS-950,2,0,2,832.32,,1149.99
80362,10-13409-02,0,0,0,555.56,,
80363,4000,0,0,0,3.41,,
80365,7062,15,6,9,7.22,,
80366,7063,25,17,8,7.22,,
80368,7064,6,2,4,7.22,,
80369,7065,15,7,8,7.22,,
80370,7066,24,9,15,7.22,,
80371,7067,10,6,4,7.22,,
80372,7068,15,5,10,7.22,,
80379,2356,8,4,4,24.96,,
80382,5056,8,5,3,28.00,,
80383,46310,15,2,13,33.64,,
80385,1739,11,2,9,38.42,,
80386,1739200,9,4,5,38.42,,
80388,1732200,10,3,7,66.53,,
80389,1733200,3,1,2,36.58,,
80392,1741200,5,0,5,50.72,,
80408,010-02236-00,0,0,0,479.98,,
80409,010-02236-02,0,0,0,519.99,,
80410,010-12946-00,0,0,0,63.74,,
80419,2000035023,10,2,8,52.94,,
80423,6234,4,3,1,72.90,112.25,
80424,6235,3,3,0,68.35,105.25,
80425,6260,1,0,1,41.21,60.15,
80426,6261,2,0,2,48.33,70.55,
80427,6269,3,1,2,95.86,139.95,
80428,6270,0,0,0,104.59,152.70,
80429,6272,0,0,0,116.51,170.10,
80430,6273,0,0,0,131.55,192.05,
80439,W733-SS,0,0,0,15.12,,
80443,010-12105-20,15,5,10,18.74,,
80483,UMC1RTL,9,2,7,340.79,579.99,
80484,500-0398-10,0,0,0,1275.80,,
80487,T70477,1,0,1,876.86,,
80490,T70478,0,0,0,1355.59,,
80514,2007GT,8,6,2,267.10,,369.00
80528,742132BFGK,0,0,0,422.95,,
80529,CAP030B,11,5,6,16.23,,
80530,DEF150101,0,0,0,82.96,,
80531,DEF228101,1,0,1,62.51,,
80532,DE248101,1,1,0,89.79,,
80535,JMS3RTL,9,5,4,176.54,285.99,
80568,AIR-033-745,0,0,0,250.00,,
80569,GP1050-26,0,0,0,327.26,,
80580,GP1500-32,0,0,0,276.35,,
80581,01-05-074,0,0,0,14.84,,
80582,01-05-075,0,0,0,20.23,,
80583,01-05-076,0,0,0,21.58,,
80584,01-05-077,4,2,2,13.90,,
80585,DE2044F,0,0,0,187.97,,
80586,01-05-078,1,1,0,13.90,,
80587,01-05-079,2,1,1,17.53,,
80588,01-05-080,5,2,3,15.72,,
80589,01-05-081,3,1,2,22.92,,
80591,01-05-082,4,1,3,20.55,,
80592,02-01-003,0,0,0,76.91,,
80593,02-01-004,0,0,0,89.76,,
80594,02-02-006,0,0,0,140.62,,
80595,02-02-008,0,0,0,173.05,,
80596,02-04-014,0,0,0,101.93,,
80597,02-04-015,1,1,0,166.25,,
80598,02-99-023,2,1,1,13.61,,
80605,BOWA0301,0,0,0,2203.88,2939.00,
80606,BOWA0361,0,0,0,2459.81,3280.00,
80607,BOWA0421,0,0,0,2680.88,3575.00,
80609,37-10-065-20,8,3,5,7.92,,
80611,E3-15-22,3,0,3,39.00,,
80612,E3-15-30,0,0,0,68.62,,
80614,E3-5-15,30,21,9,6.42,,
80616,M1-25-62-28,0,0,0,77.66,,
80617,MP-04-33-22,0,0,0,83.12,,
80618,MR-01-122-24,0,0,0,69.14,,
80619,BP110G75,0,0,0,79.80,100.00,
80620,MF-02-110-70,0,0,0,125.50,,
80621,BPPPA,0,0,0,508.50,,
80622,M1-44-8,18,0,18,48.82,,
80623,M1-25-42-28,0,0,0,82.11,,
80625,M1-20-31-58,0,0,0,100.19,,
80626,JMS3SPKG,3,2,1,210.08,,
80627,JMS4SPKG,8,2,6,265.66,,
80628,JMS4RTL,4,0,4,157.68,270.99,
80630,JOY1000,6,4,2,169.36,,
80631,OBI9000-E,8,5,3,285.67,,
80632,OBI9000-H,10,5,5,305.67,,
80633,BOLT1216HD,3,1,2,898.11,,
80634,1852084,25,12,13,23.46,,
80635,BOLT129ADJ,4,2,2,393.67,,
80651,010-12753-20,0,0,0,9.77,,
80657,010-12584-00,11,4,7,3.24,,
80658,112302,4,2,2,25.45,,
80659,010-12466-00,2,0,2,15.43,,
80676,T1125-30,2,2,0,39.72,,
80677,3947,16,16,0,105.19,,
80679,S2-4643,0,0,0,71.48,,
80680,S2-6645,0,0,0,71.48,,
80685,A80537,0,0,0,136.35,,
80691,ER370B,0,0,0,58.75,,
80692,SPC104,0,0,0,25.00,,
80696,53711,0,0,0,60.97,119.99,
80697,53716,9,6,3,60.97,119.99,
80698,53721,26,3,23,60.97,119.99,
80699,53726,12,9,3,60.97,119.99,
80700,27411,0,0,0,66.32,,
80701,27412,12,6,6,66.32,,
80703,53770,5,0,5,80.57,149.99,
80704,53771,6,3,3,80.57,149.99,
80705,53772,12,5,7,80.57,149.99,
80706,53773,7,0,7,80.57,149.99,
80707,53774,18,8,10,80.57,149.99,
80708,53775,6,2,4,80.57,149.99,
80709,16662A,0,0,0,24.64,,
80710,16672A,1,0,1,29.47,,
80714,351320-1,0,0,0,34.50,,
80715,351321-1,0,0,0,28.46,,
80717,SBH-32,16,10,6,22.50,,
80718,351322-1,0,0,0,34.50,,
80719,351323-1,2,0,2,26.61,,
80720,351300-1,1,0,1,18.64,,
80721,DS16-P-BLK,0,0,0,16.85,,
80722,DS21A-P-BLK,7,6,1,18.39,,
80723,DS21B-P-BLK,5,3,2,18.39,,
80724,P2030BK,0,0,0,10.96,,
80725,DS30-P-BLK,12,0,12,19.73,,
80726,P1334314,3,0,3,4.79,,
80727,C1334314,0,0,0,15.07,,
80728,DS40-P-BLK,8,5,3,21.93,,
80729,DS6-P-BLK,0,0,0,10.95,,
80730,DS-H10-BLK,5,1,4,18.09,,
80731,DS-H6-BLK,2,0,2,12.98,,
80740,010-12931-00,0,0,0,29.98,,
80743,SAD-25B,43,6,37,22.50,,
80748,55613,0,0,0,96.03,,
80750,55616,6,4,2,38.86,,
80753,55621,0,0,0,247.71,,
80754,55623,0,0,0,603.55,,
80755,55625,0,0,0,43.81,,
80757,55635,0,0,0,43.19,,
80758,50030,7,1,6,32.60,,
80759,50031,0,0,0,34.26,,
80761,50033,10,2,8,18.01,,
80762,DSM570-01,0,0,0,876.00,,
80776,BOS12V2,1,0,1,285.98,,
80777,BOS12V3,1,1,0,285.98,,
80783,TW5M33600SO,6,6,0,27.52,,
80808,710294-1,1,1,0,363.66,,
80813,TW7C77500XY,3,3,0,20.04,,
80827,FSGP22012D05A00,0,0,0,1789.59,,
80840,LLB-53SW-81-00,4,3,1,41.54,,
80841,826-128,11,10,1,31.47,,
80843,SBH-25,13,5,8,15.00,,
80844,CD-48,10,4,6,22.50,,
80845,SBH-27,7,4,3,15.00,,
80846,91-063A,0,0,0,21.69,,
80852,100538857,8,8,0,9.99,,
80865,44320605,18,4,14,1074.40,,1343.00
80868,61434-61433-KIT,0,0,0,799.13,,
80869,61427-61426-KIT,1,0,1,777.74,,
80870,61431-61430-KIT,0,0,0,500.85,,
80875,3126,8,5,3,7.42,,
80877,BOW7512D,0,0,0,2095.88,2795.00,
80880,83558,0,0,0,411.24,,
80882,APT-F-250-01,5,3,2,261.56,,
80888,385310969,3,3,0,54.25,,
80890,385311009,0,0,0,50.59,,
80892,385311292,0,0,0,49.31,,
80895,385311013,0,0,0,48.39,,
80919,DT2BX-TM,58,31,27,113.16,,
80920,01-0423-01SL,1,0,1,10076.40,,
80922,041608-1,26,10,16,29.73,,
80923,060060-1,5,4,1,25.82,,
80924,205420-1,0,0,0,21.17,,
80925,221835-1,7,1,6,47.56,,
80926,353210-1,9,9,0,21.59,,
80927,491912-1,0,0,0,18.81,,
80928,080036-1,4,0,4,13.00,,
80930,221244-1,4,4,0,20.89,,
80931,205705-1,1,1,0,26.62,,
80933,169601,10,5,5,41.92,59.97,
80934,169601CASE,2,1,1,167.67,239.88,
80935,169622,9,9,0,15.82,19.97,
80936,169622CASE,0,0,0,189.88,239.64,
80938,LS-2900,3,0,3,35.53,,
80939,LS-3100,4,0,4,59.21,,
80940,LS-3170,3,0,3,44.86,,
80941,LS-3200,0,0,0,29.46,,
80942,LS-3300,4,0,4,29.61,,
80943,LS-3400,3,0,3,26.50,,
80944,LS-3600,3,0,3,21.46,,
80945,LS-3650,0,0,0,19.39,,
80946,LS-5200,2,0,2,57.74,,
80947,20-61,0,0,0,18.80,,
80948,20-62,3,0,3,17.76,,
80949,20-63,0,0,0,17.62,,
80950,20-64,0,0,0,17.17,,
80952,SLK-30,1,0,1,291.32,,
80953,SLK-40,0,0,0,319.74,,
80954,SLK-GKM,0,0,0,168.89,,
80955,SLK-GKA,1,0,1,128.49,,
80956,26-884,0,0,0,54.47,,
80958,21-80,0,0,0,47.37,,
80959,21-80-1,1,0,1,47.37,,
80960,21-81,0,0,0,47.37,,
80961,27-316,0,0,0,48.70,,
80962,26-314,0,0,0,49.29,,
80963,26-412,0,0,0,25.76,,
80964,27-412,0,0,0,26.05,,
80965,26-412-1T,0,0,0,22.80,,
80966,27-412-1T,0,0,0,22.95,,
80967,26-409,0,0,0,19.99,,
80968,27-409,0,0,0,18.95,,
80969,26-407,0,0,0,22.05,,
80970,27-407,0,0,0,23.24,,
80971,26-410,0,0,0,37.30,,
80972,27-410,0,0,0,35.83,,
80973,26-408,0,0,0,43.96,,
80974,27-408,0,0,0,47.51,,
80975,26-415-1T,2,0,2,10.21,,
80976,27-415-1T,0,0,0,9.18,,
80977,26-415,0,0,0,13.17,,
80978,27-415,0,0,0,12.14,,
80979,26-406,0,0,0,19.25,,
80980,27-406,0,0,0,16.43,,
80981,22-100,0,0,0,38.63,,
80982,LS-2500,0,0,0,17.17,,
80983,LS-2550,0,0,0,15.11,,
80985,29-501,2,0,2,8.00,,
80987,40-530,5,0,5,55.21,,
80988,161200,0,0,0,16.26,,
80989,BT1-641-2,1,1,0,11.99,19.99,
80995,BX1-588-2,2,2,0,22.99,39.99,
80996,R70615,3,2,1,25.56,,
80997,BX1-750-2,9,5,4,13.49,34.99,
80998,BX1-590-2,2,0,2,15.99,29.99,
81001,142036,0,0,0,41.84,,
81004,1138,0,0,0,10.61,,
81005,1138CASE,0,0,0,127.26,,
81006,1134,9,0,9,12.73,,
81007,1134CASE,0,0,0,176.84,,
81008,1116,0,0,0,16.09,,
81009,1116CASE,0,0,0,193.11,,
81010,1119,0,0,0,17.50,,
81011,1119CASE,0,0,0,210.00,,
81012,1112,9,9,0,7.58,,
81013,1112CASE,0,0,0,90.95,,
81014,S2-5111,1,0,1,549.99,,
81015,1185,15,3,12,22.77,,
81016,1185CASE,1,0,1,316.42,,
81017,1188,10,0,10,27.53,,
81018,1188CASE,0,0,0,330.32,,
81019,GP330B/0183,2,1,1,344.25,,
81032,40020756,0,0,0,2122.14,,
81035,1059,11,11,0,15.56,,
81036,1059CASE,0,0,0,216.16,,
81037,1056,0,0,0,20.34,,
81038,1056CASE,0,0,0,244.11,,
81039,1123,0,0,0,16.45,,
81040,1123CASE,0,0,0,197.37,,
81042,ZDIGAIT2500,3,1,2,749.96,,
81044,ZDIGWND100,2,1,1,344.96,,
81045,ZDIGDST800,0,0,0,374.96,,
81046,BOW22024D,0,0,0,5931.00,7908.00,
81048,54033PK,0,0,0,4.69,,
81049,81-47239-01,0,0,0,66.67,,
81051,R70530,3,3,0,51.13,,
81052,R70533,0,0,0,51.13,,
81054,817-2000-21,4,2,2,805.62,,
81056,T9027407,5,3,2,9.20,,
81057,RA6060600,2,1,1,5.43,,
81060,GP2600-16,0,0,0,341.81,,
81064,I21VSD,3,0,3,3638.70,,
81068,260413,0,0,0,562.50,899.99,
81069,270413,0,0,0,750.00,1199.99,
81070,280413,0,0,0,937.50,1499.99,
81071,290413,2,1,1,1187.50,1899.99,
81084,503124-1,1,1,0,19.69,,
81085,503236-1,5,3,2,20.18,,
81086,503372-1,1,0,1,22.42,,
81095,BT2-952-2,0,0,0,37.45,49.99,
81111,6235-R,1,0,1,230.40,,
81144,HE-BRS,0,0,0,11.04,,
81145,HE-RMBK,0,0,0,10.26,,
81148,ACC-FF-1772,1,1,0,16.14,,
81162,SICO,0,0,0,330.75,,
81166,321820-1,0,0,0,38.15,,
81168,321825-1,0,0,0,52.18,,
81172,322080-1,5,2,3,25.41,,
81173,321850-1,4,3,1,29.17,,
81174,327357-1,2,2,0,66.16,,
81175,327359-1,7,2,5,79.40,,
81176,327361-1,0,0,0,87.33,,
81177,A80448,0,0,0,158.32,,
81178,A80447,0,0,0,158.32,,
81179,A80446,0,0,0,249.99,,
81180,A80479,1,0,1,74.99,,
81181,A80480,1,0,1,74.99,,
81182,N05-801-336,6,0,6,38.96,39.59,
81183,N05-800-286,0,0,0,47.79,48.59,
81186,305,0,0,0,48.42,,
81188,M6601,4,0,4,30.85,,
81189,M6601CASE,1,0,1,120.05,,
81190,001-325-970-00,0,0,0,354.55,,
81207,"BM-1 LI",0,0,0,142.53,,
81209,HE-RRS,0,0,0,11.04,,
81211,0158,12,0,12,11.16,,
81212,0159,3,3,0,10.09,,
81213,0168,0,0,0,13.58,,
81214,0169,0,0,0,11.14,,
81215,0367,17,5,12,19.70,,
81216,A80581,1,1,0,212.49,,
81219,SS175C-20-L-MM,0,0,0,1138.92,,
81233,20004GT,17,9,8,404.71,,559.00
81234,20074GT,11,7,4,453.56,,619.00
81235,2051GT,5,2,3,211.34,,289.00
81236,20514GT,9,6,3,399.02,,549.00
81237,2057GT,0,0,0,258.68,,359.00
81238,20574GT,7,5,2,447.87,,609.00
81239,2020GT,4,2,2,207.70,,279.00
81240,2021GT,8,5,3,197.42,,269.00
81241,7900GT,4,2,2,222.81,,299.00
81242,7901GT,13,10,3,238.34,,319.00
81243,7951GT,7,0,7,228.08,,309.00
81246,20204GT,8,4,4,380.14,,519.00
81247,20214GT,7,6,1,372.76,,509.00
81248,79004GT,6,3,3,419.79,,579.00
81249,79014GT,7,5,2,436.16,,599.00
81250,79514GT,10,4,6,425.35,,589.00
81258,WINDCPS-WT,0,0,0,20.26,,
81259,WINDVNE-WT,0,0,0,20.26,,
81262,MCU005,0,0,0,1240.00,,
81265,HCE75CB,0,0,0,45.86,,
81267,WN510,10,0,10,4.27,,
81268,WN815,2,2,0,10.39,,
81270,A2C59501972,0,0,0,26.49,30.59,
81271,A2C59501973,0,0,0,59.22,68.39,
81272,A2C1083230001,0,0,0,17.92,20.69,
81273,A2C1152980001,0,0,0,17.92,20.69,
81274,A2C59501968,0,0,0,23.38,26.99,
81275,A2C3995200001,0,0,0,23.38,26.99,
81276,A2C1141440001,0,0,0,7.53,8.63,
81277,A2C1352110001,0,0,0,7.53,8.63,
81278,A2C5336487001,0,0,0,13.25,15.29,
81279,A2C1111380001,0,0,0,9.22,10.52,
81280,A2C1352140001,0,0,0,9.22,10.52,
81281,A2C1141580001,0,0,0,21.04,24.29,
81282,A2C1376090001,0,0,0,9.22,10.52,
81283,A2C5205947101,0,0,0,6.62,7.64,
81284,A2C1433330001,0,0,0,22.60,26.09,
81285,A2C1507870001,0,0,0,17.92,20.69,
81286,A2C1697530001,0,0,0,21.82,25.19,
81287,A2C1697540001,0,0,0,21.82,25.19,
81288,A2C1957420001,0,0,0,160.78,214.19,
81289,A2C1957400001,0,0,0,160.78,214.19,
81290,A2C1957390001,0,0,0,160.78,214.19,
81291,A2C1957380001,0,0,0,160.78,214.19,
81292,A2C1957360001,0,0,0,160.78,214.19,
81295,AK1008,6,3,3,153.66,,
81311,E1150Z-11CAB,11,3,8,51.22,,
81318,E1150Z-12AAH,0,0,0,51.22,,
81319,T10-7579VEL2,6,3,3,16.19,,
81320,E1150Z-12CAB,0,0,0,51.22,,
81322,E1150Z-11H,0,0,0,51.22,,
81323,E1150Z-12H,0,0,0,51.22,,
81324,01-02-002,3,1,2,13.36,,
81325,01-02-003,2,1,1,19.04,,
81326,01-02-005,2,1,1,23.60,,
81327,01-02-007,2,0,2,19.04,,
81328,01-02-008,3,1,2,21.16,,
81330,530-00486,4,2,2,4.88,,
81332,C15503,0,0,0,300.83,419.90,
81334,E1150Z-42AAH,0,0,0,51.22,,
81335,E1150Z-41CAB,0,0,0,51.22,,
81336,E1150Z-42CAB,0,0,0,51.22,,
81337,E1150Z-41H,0,0,0,51.22,,
81338,E1150Z-42H,0,0,0,51.22,,
81347,3000ST,9,6,3,286.22,,389.00
81348,3051ST,6,2,4,281.29,,389.00
81349,3006ST,2,0,2,338.54,,469.00
81350,30002ST,2,0,2,315.18,,429.00
81351,30512ST,5,2,3,310.25,,429.00
81352,30062ST,0,0,0,367.49,,499.00
81354,30004ST,16,9,7,492.29,,679.00
81355,30514ST,15,9,6,486.79,,669.00
81356,30064ST,0,0,0,544.07,,749.00
81357,30005ST,12,6,6,515.62,,709.00
81358,30515ST,10,5,5,510.09,,709.00
81359,30065ST,0,0,0,567.39,,789.00
81360,6100,6,2,4,223.33,,
81363,HCE25SW-BLUE,0,0,0,110.08,,
81364,HCE50SW-BLUE,0,0,0,122.31,,
81365,6466,5,1,4,127.84,,
81366,6464,6,4,2,115.06,,
81367,A3120Z-11HCE,4,1,3,89.63,,
81368,A3120Z-31HCE,0,0,0,89.63,,
81369,A3120Z-41HCE,0,0,0,89.63,,
81371,7120132,5,1,4,4.88,,
81372,V11-9960BBK60-2,5,2,3,381.42,,
81373,V11-9960WCM60-2,9,2,7,401.59,,
81374,V11-9990BBK60-2,7,3,4,462.09,,
81375,V11-9990BBK80-2,5,2,3,577.79,,
81376,V11-9990WCM60-2,6,2,4,508.60,,
81377,V11-9990WCM80-2,3,2,1,641.49,,
81378,01-45315,0,0,0,3.68,,
81379,0.2173.475,0,0,0,2.83,,
81380,A1120Z-11HAE,7,2,5,89.63,,
81382,1949,1,0,1,334.06,,
81397,A1120Z-11HCE,4,1,3,89.63,,
81398,7701100,0,0,0,157.15,,
81402,A1120Z-12HCE,0,0,0,89.63,,
81403,7703100,0,0,0,157.15,,
81404,A1120Z-12HAE,0,0,0,87.50,,
81405,A1120Z-14HCE,0,0,0,89.63,,
81406,A1120Z-14HAE,0,0,0,89.63,,
81407,A1120Z-41HAE,8,2,6,89.63,,
81408,A1120Z-41HCE,6,4,2,89.63,,
81409,A1120Z-42HAE,0,0,0,89.63,,
81410,7700100,1,1,0,167.87,,
81411,A1120Z-42HCE,0,0,0,89.63,,
81412,A1120Z-44HAE,0,0,0,89.63,,
81413,A1120Z-44HCE,0,0,0,89.63,,
81414,7702100,0,0,0,167.87,,
81415,7620100,0,0,0,185.37,,
81416,10-24488-03,0,0,0,106.17,,
81417,7621100,0,0,0,185.37,,
81418,77125,2,1,1,6.17,,
81419,10-24504-03,9,9,0,106.17,,
81420,10-24486-03,0,0,0,106.17,,
81421,7713100,1,0,1,193.13,,
81422,75035-00,1,1,0,7.26,,
81423,09-821BT-1,2,0,2,66.67,,
81425,7717100,0,0,0,193.13,,
81426,7622100,3,0,3,194.85,,
81427,09-45587,0,0,0,39.51,,
81428,72303,0,0,0,70.37,,
81429,72303-001,0,0,0,72.84,,
81430,10-24228-1,0,0,0,222.22,,
81431,09-46939,1,1,0,7.41,,
81432,7623100,0,0,0,194.85,,
81433,09-47163-01,3,1,2,18.52,,
81434,01-45680,0,0,0,2.65,,
81435,10-13405-103,2,1,1,81.48,,
81440,23505,1,1,0,12.99,,
81441,23506,0,0,0,29.79,,
81442,23507,0,0,0,17.18,,
81443,23500,0,0,0,11.26,,
81444,28552-24,4,4,0,28.00,,
81446,09-47426,0,0,0,64.81,,
81448,M183089,2,0,2,39.98,,
81449,03605,0,0,0,5.10,,
81450,22084,0,0,0,100.62,,
81451,03609,0,0,0,5.10,,
81452,40057,0,0,0,12.35,,
81453,03606,0,0,0,6.24,,
81454,03607,0,0,0,7.82,,
81455,03608,0,0,0,10.12,,
81456,54124,4,2,2,54.32,,
81457,80-47420-01,1,1,0,143.21,,
81458,92205,0,0,0,4.94,,
81459,01-42398,0,0,0,27.05,,
81460,82024,4,3,1,27.16,,
81461,40084,0,0,0,154.32,,
81462,09-45825,4,1,3,51.85,,
81463,10-13406-103,1,1,0,155.56,,
81464,10-22020-101,0,0,0,56.43,,
81465,01-46535,0,0,0,16.46,,
81466,LLB-541A-31-00,0,0,0,428.58,,
81468,RA078410C,2,1,1,2.62,,
81471,1482,0,0,0,248.39,,
81473,GFEL-MG-BK-DP,1,1,0,44.99,,
81476,GFEL-MG-BU-DP,8,4,4,42.62,,
81477,GFEL-MG-C-DP,5,4,1,44.01,,
81478,GFEL-MG-R-DP,2,2,0,44.01,,
81479,GFEL-MK-BK-DP,3,0,3,44.99,,
81480,GFEL-MK-BU-DP,4,4,0,44.01,,
81481,GFEL-MK-C-DP,3,0,3,44.01,,
81482,GFEL-MK-R-DP,4,4,0,44.99,,
81483,GFEL-MKS-BK-DP,3,3,0,44.01,,
81484,GFEL-MKS-BU-DP,6,3,3,44.01,,
81485,GFEL-MKS-C-DP,9,6,3,44.99,,
81487,00726,0,0,0,18.78,,
81488,GFEQ-MG-BK-DP,3,0,3,93.58,,
81489,00728,2,0,2,5.96,,
81490,GFEQ-MG-BU-DP,3,3,0,116.34,,
81491,00733,0,0,0,16.26,,
81492,GFEQ-MG-R-DP,6,5,1,93.58,,
81493,00733BIS,0,0,0,23.85,,
81494,GFES-BLK-DP,12,12,0,5.00,,
81495,GFES-RED-DP,10,6,4,5.00,,
81496,00734,0,0,0,27.93,,
81497,00735,0,0,0,10.57,,
81498,GFGG-MG-DP,0,0,0,33.86,,
81499,00706-1,0,0,0,29.01,,
81500,PLAC-2,0,0,0,21.31,,
81501,GFGG-MKL-DP,3,3,0,30.27,,
81503,GFGG-MKS-DP,2,2,0,27.97,,
81504,GFH-1G-DP,9,3,6,43.28,,
81505,GFH-1R-DP,7,2,5,45.03,,
81506,GFH-CA1R-DP,6,0,6,52.60,,
81508,QF-1K-DP,14,9,5,19.13,,
81509,QF-2K-DP,19,7,12,19.13,,
81511,P1120Z-11HCE,0,0,0,102.44,,
81513,P1120Z-31HCE,0,0,0,102.44,,
81514,P1120Z-41HCE,0,0,0,102.44,,
81517,P1100Z-11H,0,0,0,128.05,,
81518,P1100Z-11E,0,0,0,128.05,,
81527,P1100Z-41H,0,0,0,128.05,,
81528,P1100Z-41E,0,0,0,128.05,,
81532,P1100Z-31H,0,0,0,128.05,,
81533,P1100Z-31E,0,0,0,128.05,,
81538,A2C59501781,0,0,0,148.31,209.69,
81539,A2C59501782,0,0,0,148.31,209.69,
81540,A2C59501987,0,0,0,148.31,209.69,
81541,A2C59512328,0,0,0,45.19,63.89,
81542,A2C59512330,1,1,0,19.99,63.89,
81543,A2C59512329,1,0,1,37.99,63.89,
81544,A2C59512331,0,0,0,45.19,63.89,
81545,A2C59512332,0,0,0,38.83,54.89,
81546,A2C59512333,0,0,0,38.83,54.89,
81547,A2C59512334,3,1,2,38.83,54.89,
81548,A2C59512335,0,0,0,38.83,54.89,
81561,A2C59512350,0,0,0,108.18,152.99,
81563,A2C59512367,0,0,0,125.45,177.29,
81564,A2C59512369,0,0,0,125.45,177.29,
81565,A2C59512370,0,0,0,125.45,177.29,
81566,A2C59512371,0,0,0,125.45,177.29,
81569,A2C59512390,18,12,6,108.18,152.99,
81570,A2C59512391,3,0,3,108.18,152.99,
81571,A2C59512392,0,0,0,108.18,152.99,
81572,A2C59512393,7,4,3,108.18,152.99,
81573,A2C59512394,0,0,0,108.18,152.99,
81574,A2C59512395,0,0,0,108.18,152.99,
81575,A2C59512396,0,0,0,108.18,152.99,
81576,A2C59512397,0,0,0,108.18,152.99,
81577,A2C59512398,0,0,0,108.18,152.99,
81578,A2C59512399,0,0,0,108.18,152.99,
81579,A2C59512400,0,0,0,108.18,152.99,
81581,A2C59512402,0,0,0,63.64,89.99,
81582,A2C59512403,0,0,0,63.64,89.99,
81583,A2C59512410,4,1,3,56.99,89.99,
81584,A2C59512411,0,0,0,63.64,89.99,
81588,182608-1,2,2,0,43.76,,
81589,182612-1,0,0,0,71.43,,
81592,A1110Z-41CAB,8,4,4,87.07,,
81596,P1101Z-11AAH,0,0,0,89.63,,
81597,P1101Z-11CAB,0,0,0,89.63,,
81600,P11001Z-41AAH,0,0,0,89.63,,
81601,P1101Z-41CAB,1,1,0,89.63,,
81602,P1101Z-31AAH,0,0,0,89.63,,
81603,P1101Z-31CAB,0,0,0,89.63,,
81604,HN-G1080A,0,0,0,292.94,,
81609,00825,0,0,0,5.85,,
81610,00825AL,0,0,0,4.13,,
81611,00829,0,0,0,9.46,,
81612,00829AL,0,0,0,5.34,,
81613,00833,0,0,0,3.90,,
81614,00833AL,0,0,0,3.35,,
81615,00835,0,0,0,4.91,,
81617,00835AL,0,0,0,5.50,,
81618,00847,0,0,0,11.24,,
81619,301-001-6M,2,2,0,278.57,,355.18
81620,301-002-6M,4,2,2,278.57,,355.18
81622,00847AL,0,0,0,10.66,,
81624,KIT-843AL,0,0,0,108.10,,
81631,A3101Z-11A08N,0,0,0,76.83,,
81633,E1150Z-41AAH,0,0,0,51.22,,
81637,A3101Z-31A08N,0,0,0,76.83,,
81638,A3101Z-41A08N,0,0,0,76.83,,
81639,A3101Z-11CAB,9,3,6,76.83,,
81641,A3101Z-31CAB,6,4,2,76.83,,
81642,A3101Z-41CAB,0,0,0,76.83,,
81643,20817,8,0,8,43.41,,
81644,20817AL,0,0,0,36.03,,
81645,01040,0,0,0,12.03,,
81646,01050,0,0,0,3.41,,
81647,01053,2,2,0,19.99,,
81648,02480,0,0,0,9.46,,
81649,01080,0,0,0,9.74,,
81650,01081,0,0,0,13.26,,
81651,01082,0,0,0,21.34,,
81652,01146,0,0,0,3.40,,
81653,01146-1,0,0,0,6.69,,
81654,01156,0,0,0,11.60,,
81655,01156AL,0,0,0,6.68,,
81656,01156-1,0,0,0,3.41,,
81657,01156-1AL,0,0,0,3.74,,
81658,21107,0,0,0,29.47,,
81659,21107AL,0,0,0,27.35,,
81660,21107MG,0,0,0,26.90,,
81661,MCBK634B.6,9,5,4,68.13,,
81662,AHJ-10V-B-DP,0,0,0,1493.88,,
81664,AHJ-10V-DP,0,0,0,1378.63,,
81665,AHJ-10VHD-B-DP,0,0,0,1658.80,,
81666,AHJ-10VHD-DP,1,0,1,1577.15,,
81667,AHJ-12V-B-DP,1,1,0,1583.67,,
81668,AHJ-12V-DP,3,1,2,1503.48,,
81669,AHJ-12VHD-B-DP,1,0,1,1745.32,,
81670,AHJ-12VHD-DP,2,1,1,1601.11,,
81671,AHJ-14V-DP,0,0,0,1492.24,,
81673,AHJ-14VHD-DP,1,1,0,1656.35,,
81674,300-039,0,0,0,2055.85,,2621.22
81675,AHJ-4V-B-DP,1,0,1,1386.11,,
81677,01305/1,4,0,4,29.53,,
81678,01305/1AL,0,0,0,24.37,,
81679,01305/1MG,0,0,0,28.31,,
81680,PLAC-1,0,0,0,20.37,,
81681,AHJ-4VHD-B-DP,2,1,1,1428.77,,
81682,AHJ-4VHD-DP,1,0,1,1386.11,,
81683,AHJ-6V-B-DP,1,0,1,1405.17,,
81685,AHJ-6VHD-B-DP,1,0,1,1571.96,,
81686,AHJ-6VHD-DP,1,0,1,1450.77,,
81687,AHJ-8V-B-DP,0,0,0,1436.75,,
81688,AHJ-8V-DP,1,0,1,1358.11,,
81689,AHJ-8VHD-B-DP,0,0,0,1581.37,,
81690,AHJ-8VHD-DP,2,0,2,1542.85,,
81691,KITYANMARSTD,0,0,0,70.99,,
81693,KITYANMARSTDAL,0,0,0,46.34,,
81694,DP36/12,1,1,0,739.27,,
81695,TEC-AB,0,0,0,5.06,,
81696,TEC-AB/AL,0,0,0,5.90,,
81697,TEC-AB/MG,0,0,0,9.78,,
81698,AHJACT-3-DP,0,0,0,596.15,,
81699,TEC-CDE,0,0,0,7.88,,
81700,TEC-CDE/AL,0,0,0,6.75,,
81701,TEC-CDE/MG,0,0,0,12.85,,
81702,TEC-FF1,0,0,0,8.41,,
81703,TEC-FF1/AL,0,0,0,7.15,,
81704,TEC-FF1/MG,0,0,0,13.68,,
81705,TEC-F2F3,0,0,0,10.93,,
81706,TEC-F2F3/AL,0,0,0,9.31,,
81707,TEC-F2F3/MG,0,0,0,17.74,,
81708,TEC-DIVERS-AL,3,3,0,26.94,,
81709,TEC-DIVERS-S,0,0,0,17.94,,
81710,TEC-DIVERS-SAL,0,0,0,12.22,,
81711,TEC-DIVERS-SMG,0,0,0,22.03,,
81712,TEC-40MG,0,0,0,20.65,,
81713,TEC-Z-406MG,1,0,1,42.07,,
81714,AHJRELAYKIT-2-DP,1,1,0,129.73,,
81715,AHJSWITCH-1-DP,0,0,0,19.99,,
81716,FAGK-1-DP,1,1,0,254.88,,
81717,FAGK-1SS-DP,0,0,0,254.88,,
81718,FAGK-2-DP,1,0,1,254.88,,
81719,FAGK-2SS-DP,0,0,0,254.88,,
81720,O2-BK3-DP,0,0,0,136.38,,
81721,PMW-1-DP,6,3,3,17.33,,
81722,GFC-CCSG2-DP,10,8,2,48.12,,
81723,A3100Z-11H,0,0,0,128.05,,
81724,A3100Z-11E,0,0,0,128.05,,
81729,A3100Z-41H,0,0,0,128.05,,
81730,A3100Z-41E,0,0,0,128.05,,
81732,A3100Z-31H,0,0,0,128.05,,
81735,A526-11AAG,4,4,0,128.05,,
81736,A526-11BBD,0,0,0,128.05,,
81737,A526-11CBBR,8,0,8,128.05,,
81738,A526-11AAG-H,0,0,0,128.05,,
81739,A526-11AAG-E,0,0,0,128.05,,
81745,0493DP599L,2,2,0,19.80,,
81747,0493DP799L,7,5,2,22.13,,
81749,0493DP999L,10,7,3,28.06,,
81751,049300699D,0,0,0,71.04,,
81758,70020P-10,1,1,0,174.99,,
81789,GFC-WK-DP,10,6,4,8.99,,
81793,71113C-SG,0,0,0,144.38,,
81794,71114C-SG,0,0,0,145.46,,
81795,71115C-SG,0,0,0,153.21,,
81796,71116C-SG,0,0,0,170.83,,
81819,72215P-10,2,2,0,119.99,,
81826,72316P-10,1,1,0,139.99,,
81828,72318P-10,2,2,0,139.99,,
81830,RFSPLICE-KIT1,0,0,0,129.60,178.46,
81831,RFSPLICE-KIT2,0,0,0,184.57,254.15,
81832,RFSPLICE-KIT3,1,0,1,240.12,330.65,
81855,74200C-SG,0,0,0,147.03,,
81856,74201C-SG,0,0,0,147.73,,
81857,74203C-SG,1,1,0,174.14,,
81869,A526-41AAG,0,0,0,128.05,,
81870,A526-41BBD,0,0,0,128.05,,
81871,A526-41CBBR,7,3,4,128.05,,
81872,A526-41AAG-H,0,0,0,128.05,,
81873,A526-41AAG-E,0,0,0,128.05,,
81874,A526-31AAG,0,0,0,128.05,,
81875,A526-31BBD,0,0,0,128.05,,
81876,A526-31CBBR,0,0,0,128.05,,
81877,A526-31AAG-H,0,0,0,128.05,,
81878,A526-31AAG-E,0,0,0,128.05,,
81897,010-02167-01-5,0,0,0,213.74,,
81898,010-02167-00-5,4,2,2,213.74,,
81918,77319P-10,1,1,0,109.99,,
81930,SS-3-DP,6,6,0,14.59,,
81933,MSS-1-DP,13,6,7,33.00,,
81940,BS-1-42SS-DP,10,0,10,7.81,,
81944,BS-1-54SS-DP,8,0,8,8.81,,
81956,77815C-SG,0,0,0,175.26,,
81957,77816C-SG,0,0,0,182.94,,
81958,77817C-SG,1,1,0,192.86,,
81959,77818C-SG,0,0,0,208.71,,
81996,95120P-10,1,1,0,179.99,,
82002,HF-1CT-DP,2,0,2,160.83,,
82003,HF-1-DP,4,1,3,142.87,,
82004,HF-1T-DP,3,1,2,150.48,,
82005,HFM-1-DP,10,6,4,64.78,,
82006,HFS-1-DP,13,10,3,14.20,,
82008,ZL-10-DP,3,1,2,34.39,,
82012,ZL-15-DP,9,3,6,38.28,,
82013,ZL-20-DP,7,6,1,38.18,,
82028,HW-PKG-H2CAT,2,0,2,368.47,,
82030,HW-PKG-H2INSH,1,0,1,368.47,,
82032,HW-PKG-H2KVD,6,4,2,447.71,,
82035,HW-PKG-H2MRCRAP,1,0,1,341.88,,
82037,HW-PKG-H2WALL,0,0,0,368.47,,
82055,HW-ASSY-MINI12VK,0,0,0,24.81,,
82097,A503-11AAG,0,0,0,89.63,,
82098,A503-11BBD,0,0,0,89.63,,
82099,A503-11CBBR,0,0,0,89.63,,
82100,A503-11AAG-H,0,0,0,89.63,,
82101,A503-11AAG-E,0,0,0,89.63,,
82102,A503-12AAG,0,0,0,89.63,,
82103,A503-12BBD,0,0,0,89.63,,
82104,A503-12CBBR,0,0,0,89.63,,
82105,A503-12AAG-H,0,0,0,89.63,,
82106,A503-12AAG-E,0,0,0,89.63,,
82114,61000,2,2,0,20.11,,
82115,61020,1,1,0,11.99,,
82116,61050,3,3,0,21.46,,
82117,60000,3,3,0,20.44,,
82118,60002,3,3,0,31.59,,
82120,60008,6,6,0,36.09,,
82121,VENTII,0,0,0,16.19,,
82123,SNAP,2,2,0,4.54,,
82139,LED-34143-DP,10,4,6,66.76,,
82142,ST-1-DP,0,0,0,90.08,,
82143,TTC-1-DP,11,11,0,40.97,,
82144,FRH-1P-DP,18,14,4,16.44,,
82146,ZRS-1-DP,20,8,12,42.86,,
82151,TWA-1-DP,1,0,1,112.91,,
82152,TWAR-1-DP,1,1,0,32.21,,
82153,LB-TLRLCK-DP,6,2,4,41.95,,
82154,1461,0,0,0,229.30,,
82156,A503-14AAG,0,0,0,89.63,,
82157,A503-14BBG,0,0,0,89.63,,
82158,A503-14CBBR,0,0,0,89.63,,
82159,A503-14AAG-H,0,0,0,89.63,,
82160,A503-14AAG-E,0,0,0,89.63,,
82161,A506-11AAG,0,0,0,102.44,,
82163,A506-11BBD,0,0,0,102.44,,
82165,A506-11CBBR,0,0,0,102.44,,
82166,A506-11AAG-H,0,0,0,102.44,,
82167,A506-11AAG-E,0,0,0,102.44,,
82168,A506-12AAG,0,0,0,102.44,,
82169,A506-12BBD,0,0,0,102.44,,
82170,A506-12CBBR,0,0,0,102.44,,
82171,A506-12AAG-H,0,0,0,102.44,,
82172,A506-12AAG-E,0,0,0,102.44,,
82173,A506-14AAG,0,0,0,102.44,,
82174,A506-14BBD,0,0,0,102.44,,
82175,A506-14CBBR,0,0,0,102.44,,
82176,A506-14AAG-H,0,0,0,102.44,,
82177,A506-14AAG-E,0,0,0,102.44,,
82208,A503-41AAG,0,0,0,89.63,,
82209,A503-41BBD,0,0,0,89.63,,
82210,A503-41CBBR,0,0,0,89.63,,
82211,A503-41AAG-H,10,5,5,89.63,,
82212,A503-41AAG-E,0,0,0,89.63,,
82213,A503-42AAG,0,0,0,89.63,,
82214,A503-42BBD,0,0,0,89.63,,
82215,A503-42CBBR,0,0,0,89.63,,
82216,A503-42AAG-H,0,0,0,89.63,,
82217,A503-42AAG-E,0,0,0,89.63,,
82218,A503-44AAG,0,0,0,89.63,,
82219,A503-44BBD,0,0,0,89.63,,
82220,A503-44CBBR,1,0,1,89.63,,
82221,A503-44AAG-H,0,0,0,89.63,,
82222,A503-44AAG-E,0,0,0,89.63,,
82223,A506-41AAG,0,0,0,102.44,,
82224,A506-41BBD,0,0,0,102.44,,
82225,A506-41CBBR,0,0,0,102.44,,
82226,A506-41AAG-H,0,0,0,102.44,,
82227,A506-41AAG-E,0,0,0,102.44,,
82228,A506-42AAG,0,0,0,102.44,,
82229,A506-42BBD,0,0,0,102.44,,
82230,A506-42CBBR,0,0,0,102.44,,
82231,A506-42AAG-H,0,0,0,102.44,,
82232,A506-42AAG-E,0,0,0,102.44,,
82233,A506-44AAG,0,0,0,102.44,,
82234,A506-44BBD,0,0,0,102.44,,
82235,A506-44CBBR,0,0,0,102.44,,
82236,A506-44AAG-H,0,0,0,102.44,,
82237,A506-44AAG-E,0,0,0,102.44,,
82238,A503-31AAG,6,0,6,89.63,,
82239,A503-31BBD,0,0,0,89.63,,
82240,A503-31CBBR,3,3,0,89.63,,
82241,A503-31AAG-H,0,0,0,89.63,,
82242,A503-31AAG-E,0,0,0,89.63,,
82243,A503-32AAG,0,0,0,89.63,,
82244,A503-32BBD,0,0,0,89.63,,
82245,A503-32CBBR,0,0,0,89.63,,
82246,A503-32AAG-H,0,0,0,89.63,,
82247,A503-32AAG-E,0,0,0,89.63,,
82248,A503-34AAG,0,0,0,89.63,,
82249,A503-34BBR,0,0,0,89.63,,
82250,A503-34CBBR,0,0,0,89.63,,
82251,A503-34AAG-H,0,0,0,89.63,,
82252,A503-34AAG-E,0,0,0,89.63,,
82253,A506-31AAG,0,0,0,102.44,,
82254,A506-31BBD,0,0,0,102.44,,
82255,A506-31CBBR,0,0,0,102.44,,
82256,A506-31AAG-H,0,0,0,102.44,,
82257,A506-31AAG-E,0,0,0,102.44,,
82258,A506-32AAG,0,0,0,102.44,,
82259,A506-32BBD,0,0,0,102.44,,
82260,A506-32CBBR,0,0,0,102.44,,
82261,A506-32AAG-H,0,0,0,102.44,,
82262,A506-32AAG-E,0,0,0,102.44,,
82263,A506-34AAG,0,0,0,102.44,,
82264,A506-34BBD,0,0,0,102.44,,
82265,A506-34CBBR,0,0,0,102.44,,
82266,A506-34AAG-H,0,0,0,102.44,,
82267,A506-34AAG-E,0,0,0,102.44,,
82268,A1110Z-11AAH,0,0,0,87.07,,
82269,A1110Z-11CAB,1,0,1,87.07,,
82271,A1110Z-12CAB,5,0,5,72.95,,
82272,A1110Z-14AAH,0,0,0,87.07,,
82273,A1110Z-14CAB,0,0,0,87.07,,
82288,A1110Z-41AAH,4,0,4,87.07,,
82291,A1110Z-44AAH,6,6,0,87.07,,
82292,A1110Z-44CAB,2,1,1,87.07,,
82293,A1110Z-45AAH,0,0,0,87.07,,
82294,A1110Z-45CAB,0,0,0,87.07,,
82295,A1110Z-46AAH,0,0,0,87.07,,
82296,A1110Z-46CAB,0,0,0,87.07,,
82297,A1110Z-31AAH,0,0,0,87.07,,
82298,A1110Z-31CAB,6,0,6,87.07,,
82301,A1110Z-34AAH,0,0,0,87.07,,
82302,A1110Z-34CAB,0,0,0,87.07,,
82303,A1110Z-35AAH,0,0,0,87.07,,
82304,A1110Z-35CAB,0,0,0,87.07,,
82305,A1110Z-36AAH,0,0,0,87.07,,
82306,A1110Z-36CAB,0,0,0,87.07,,
82355,101609,7,2,5,138.39,,
82357,101621,3,3,0,79.95,,
82358,101450,6,2,4,1105.59,,
82359,101451,4,0,4,1259.72,,
82360,101605,1,0,1,81.63,,
82361,101606,3,3,0,81.63,,
82362,101611,2,2,0,140.88,,
82363,101627,45,31,14,114.63,,
82364,101628,0,0,0,114.63,,
82365,101629,58,36,22,102.26,,
82367,101630,0,0,0,102.26,,
82368,101631,36,12,24,114.63,,
82369,101632,0,0,0,114.63,,
82370,101633,0,0,0,102.26,,
82371,101634,0,0,0,102.26,,
82372,01-91-065,1,1,0,18.79,,
82373,01-91-066,0,0,0,18.79,,
82374,101636,0,0,0,344.80,,
82375,101637,0,0,0,482.94,,
82376,101640,11,3,8,156.26,,
82377,101641,5,0,5,234.94,,
82378,101642,4,0,4,298.49,,
82379,101643,0,0,0,344.91,,
82382,A2C1156050001,0,0,0,14.81,17.09,
82385,5588-BP,14,8,6,8.76,,
82405,58029-1000,8,4,4,193.36,,
82419,C15043,0,0,0,137.63,192.10,
82420,BAM010702200R,15,9,6,117.13,,144.50
82425,RNSTROBE,0,0,0,11.38,,
82437,379700026,5,5,0,28.34,,
82439,379700027,0,0,0,13.30,,
82441,379700029,9,6,3,27.77,,
82443,379711001,3,3,0,13.30,,
82465,40-767758,1,0,1,11.62,,
82480,N02-240-902,0,0,0,193.25,257.39,
82481,A2C59514180,2,2,0,27.99,54.89,
82489,A2C59514154,3,0,3,38.83,54.89,
82495,A2C59514091,1,1,0,34.99,54.89,
82497,A2C39308500,0,0,0,41.30,47.69,
82498,A2C39310500,0,0,0,27.27,31.49,
82499,A2C3931060001,0,0,0,17.92,20.69,
82500,A2C3931100001,0,0,0,17.92,20.69,
82501,A2C3931250001,0,0,0,27.27,31.49,
82502,A2C3931270002,0,0,0,33.51,38.69,
82504,A2C59501950,2,0,2,86.49,99.89,
82505,A2C9624370001,0,0,0,30.39,35.09,
82506,A2C9624380001,0,0,0,40.52,46.79,
82507,A2C9624400001,1,1,0,32.99,54.89,
82508,A2C9624420001,0,0,0,58.44,67.49,
82509,A2C99794200,0,0,0,45.19,52.19,
82510,A2C38804900,0,0,0,42.08,48.59,
82511,A2C38805500,0,0,0,27.27,31.49,
82512,A2C38805700,1,0,1,27.99,55.79,
82513,A2C96244600,0,0,0,35.84,41.39,
82514,A2C96245000,1,0,1,34.99,62.99,
82515,A2C96245100,2,2,0,44.99,80.09,
82516,A2C39488200,0,0,0,45.19,52.19,
82517,A2C96244900,4,3,1,24.99,50.39,
82518,A2C3997600001,0,0,0,14.81,17.09,
82526,A2C9875480001,0,0,0,122.34,141.29,
82528,A2C99793400,0,0,0,123.12,142.19,
82529,A2C59501979,0,0,0,555.58,641.69,
82540,A2C59501931,1,0,1,22.99,,
82568,A2C59501937,4,4,0,22.99,,
82604,A2C59501908,1,1,0,99.99,,
82605,PIN245020000,0,0,0,1350.44,,1666.00
82608,PIN123020100,6,4,2,1039.70,,1282.65
82616,A2C59501997,0,0,0,838.83,1019.69,
82617,A2C59501983,0,0,0,556.75,676.79,
82618,A2C5323888101,0,0,0,7.53,8.63,
82619,A2C59500139,0,0,0,13.25,15.29,
82620,A2C9875610001,0,0,0,122.34,141.29,
82623,PIN123750500,7,1,6,95.77,,118.15
82624,PIN125010500,1,0,1,119.89,,147.90
82625,A2C99791100,0,0,0,51.43,59.39,
82626,PIN121800500,7,3,4,204.63,,252.45
82628,A2C3997620001,1,0,1,109.99,,
82629,A2C59501982,1,1,0,164.99,246.59,
82630,PIN243020100,4,2,2,1039.70,,1282.65
82631,PIN241800500,8,4,4,204.63,,252.45
82632,A2C1845710001,0,0,0,55.32,63.89,
82634,PIN482120500,2,2,0,297.00,,420.75
82637,PMP122301102,2,0,2,999.74,,1233.35
82638,QUA125021100,5,3,2,2546.54,,3141.60
82639,PMP243021102,28,14,14,999.74,,1233.35
82640,PMP242301102,3,1,2,1032.81,,1274.15
82641,QUA245023110,4,2,2,2240.63,,2764.20
82642,QUA485021100,3,0,3,1905.77,,2351.10
82643,QUA483100100,0,0,0,2926.18,,3609.95
82644,BPC120731104R,9,0,9,90.26,,111.35
82645,BPC121031104R,11,10,1,106.79,,131.75
82646,BPC121531104R,11,8,3,123.33,,152.15
82647,BPC240831104R,15,9,6,123.33,,152.15
82650,BPC120715106,5,3,2,76.48,,94.35
82653,A2C1313150001,0,0,0,99.74,115.19,
82654,A2C17563000,0,0,0,23.38,26.99,
82655,A2C1766930001,0,0,0,109.87,126.89,
82656,A2C1821960001,2,1,1,64.99,115.19,
82657,A2C1856150001,0,0,0,55.32,63.89,
82658,A2C3986520001,1,1,0,27.99,,
82659,A2C59514043,0,0,0,40.52,53.99,
82660,A2C59514047,0,0,0,40.52,53.99,
82661,A2C5321223801,0,0,0,5.84,6.65,
82663,A2C1650700001,0,0,0,14.81,17.09,
82664,A2C1992110001,0,0,0,17.92,20.69,
82665,N05-800-792,0,0,0,31.95,36.89,
82666,A2C1029570001,0,0,0,1269.61,1543.49,
82667,A2C1029570002,0,0,0,1361.43,1655.09,
82669,A2C1029570003,0,0,0,1361.43,1655.09,
82670,A2C59501974,0,0,0,24.16,27.89,
82671,A2C1720030001,0,0,0,25.45,42.29,
82672,A2C1720100001,0,0,0,45.97,76.49,
82673,A2C1742410001,0,0,0,25.97,43.19,
82674,A2C1742980001,0,0,0,26.49,44.09,
82675,A2C1744170001,0,0,0,26.49,44.09,
82676,A2C1744180001,0,0,0,26.49,44.09,
82677,A2C1744190001,1,1,0,19.99,44.99,
82678,A2C1744200001,0,0,0,27.66,45.89,
82679,A2C1744210001,0,0,0,28.18,46.79,
82680,A2C1744220001,0,0,0,28.70,47.69,
82681,A2C1744230001,0,0,0,28.70,47.69,
82682,A2C1744240001,0,0,0,29.22,48.59,
82683,A2C1744250001,0,0,0,29.74,49.49,
82684,A2C1744260001,0,0,0,30.91,51.29,
82685,A2C1744270001,0,0,0,30.91,51.29,
82686,A2C1744280001,0,0,0,31.43,52.19,
82687,A2C1744290001,2,2,0,19.99,53.09,
82688,010-12505-00,0,0,0,18.74,,
82689,A2C1744300001,0,0,0,32.47,53.99,
82690,A2C1744310001,0,0,0,32.47,53.99,
82693,A2C1744320001,0,0,0,33.51,55.79,
82694,A2C1744350001,0,0,0,34.16,56.69,
82695,A2C1744360001,0,0,0,34.68,57.59,
82696,A2C1744370001,1,1,0,22.99,57.59,
82697,A2C1744380001,0,0,0,35.19,58.49,
82698,A2C1744390001,0,0,0,35.71,59.39,
82699,A2C1744400001,0,0,0,36.75,61.19,
82700,A2C1744410001,0,0,0,37.27,62.09,
82701,A2C1744420001,0,0,0,37.92,62.99,
82702,A2C1744430001,0,0,0,37.92,62.99,
82703,A2C1744440001,0,0,0,38.44,63.89,
82704,A2C1744450001,0,0,0,38.96,64.79,
82705,A2C1744460001,0,0,0,38.96,64.79,
82706,A2C1744470001,0,0,0,39.48,65.69,
82707,A2C1744480001,0,0,0,40.00,66.59,
82708,A2C1745780001,0,0,0,40.00,66.59,
82709,A2C1745790001,0,0,0,41.17,68.39,
82710,A2C1745800001,2,2,0,41.69,69.29,
82711,A2C1745810001,0,0,0,43.77,72.89,
82712,A2C1745820001,0,0,0,49.74,82.79,
82713,A2C1745830001,0,0,0,51.95,86.39,
82714,A2C1745840001,0,0,0,55.19,91.79,
82715,A2C1745880001,0,0,0,57.92,96.29,
82716,A2C1745890001,0,0,0,61.17,101.69,
82717,A2C1745900001,0,0,0,63.77,106.19,
82718,A2C1745910001,0,0,0,67.01,111.59,
82719,A2C1745920001,0,0,0,69.74,116.09,
82720,A2C1745960001,0,0,0,82.21,136.79,
82721,A2C1745950001,0,0,0,78.96,131.39,
82722,A2C1745940001,0,0,0,76.23,126.89,
82723,A2C1745930001,0,0,0,73.51,122.39,
82724,A2C1746020001,0,0,0,25.45,42.29,
82725,A2C1746030001,2,2,0,16.99,43.19,
82726,A2C1746040001,0,0,0,26.49,44.09,
82727,A2C1746060001,0,0,0,26.49,44.09,
82728,A2C1746100001,0,0,0,26.49,44.09,
82729,A2C1746120001,0,0,0,27.01,44.99,
82730,A2C1746130001,0,0,0,27.66,45.89,
82731,A2C1746140001,0,0,0,28.18,46.79,
82732,A2C1746150001,0,0,0,28.70,47.69,
82733,A2C1746170001,0,0,0,28.70,47.69,
82734,A2C1746190001,0,0,0,29.22,48.59,
82735,A2C1746220001,0,0,0,29.74,49.49,
82736,A2C1746300001,0,0,0,30.91,51.29,
82737,A2C1746390001,0,0,0,30.91,51.29,
82738,A2C1746420001,0,0,0,31.43,52.19,
82739,A2C1746450001,0,0,0,31.95,53.09,
82740,A2C1746990001,0,0,0,32.47,53.99,
82741,A2C1747000001,0,0,0,32.47,53.99,
82742,A2C1747020001,0,0,0,33.51,55.79,
82743,A2C1747030001,0,0,0,34.16,56.69,
82744,A2C1747050001,0,0,0,34.68,57.59,
82745,A2C1747060001,0,0,0,34.68,57.59,
82746,A2C1747080001,0,0,0,35.19,58.49,
82747,A2C1747090001,0,0,0,35.71,59.39,
82748,A2C1747130001,0,0,0,36.75,61.19,
82749,A2C1747140001,1,1,0,24.99,62.09,
82750,A2C1747150001,0,0,0,37.92,62.99,
82751,A2C1747160001,0,0,0,37.92,62.99,
82752,A2C1747170001,2,0,2,24.99,63.89,
82753,A2C1747190001,0,0,0,38.96,64.79,
82754,A2C1747200001,0,0,0,38.96,64.79,
82755,A2C1747210001,0,0,0,39.48,65.69,
82756,A2C1747220001,0,0,0,40.00,66.59,
82757,A2C1747230001,0,0,0,40.00,66.59,
82758,A2C1747240001,0,0,0,41.17,68.39,
82759,A2C1747250001,0,0,0,41.69,69.29,
82760,A2C1747260001,0,0,0,43.77,72.89,
82761,A2C1747270001,0,0,0,45.97,76.49,
82762,A2C1747280001,0,0,0,49.74,82.79,
82763,A2C1747290001,0,0,0,51.95,86.39,
82764,A2C1747300001,0,0,0,55.19,91.79,
82765,A2C1747340001,0,0,0,57.92,96.29,
82766,A2C1747350001,0,0,0,61.17,101.69,
82767,A2C1747360001,0,0,0,63.77,106.19,
82768,A2C1747370001,0,0,0,67.01,111.59,
82769,A2C1747380001,0,0,0,69.74,116.09,
82770,A2C1747390001,0,0,0,73.51,122.39,
82771,A2C1747410001,0,0,0,76.23,126.89,
82772,A2C1747420001,0,0,0,78.96,131.39,
82773,A2C1747430001,0,0,0,82.21,136.79,
82774,A2C1749300001,0,0,0,25.45,42.29,
82775,A2C1749310001,0,0,0,25.97,43.19,
82776,A2C1749370001,0,0,0,26.49,44.09,
82777,A2C1749950001,0,0,0,26.49,44.09,
82778,A2C1750030001,0,0,0,26.49,44.09,
82779,A2C1750040001,0,0,0,27.01,44.99,
82781,A2C1750100001,0,0,0,27.66,45.89,
82782,A2C1750120001,0,0,0,28.18,46.79,
82783,A2C1750130001,0,0,0,28.70,47.69,
82784,A2C1750170001,0,0,0,28.70,47.69,
82786,A2C1750190001,0,0,0,29.22,48.59,
82787,A2C1750200001,0,0,0,29.74,49.49,
82788,A2C1750210001,0,0,0,30.91,51.29,
82789,A2C1750220001,0,0,0,30.91,51.29,
82790,A2C1750230001,0,0,0,31.43,52.19,
82791,A2C1750240001,0,0,0,31.95,53.09,
82792,A2C1750250001,0,0,0,32.47,53.99,
82793,A2C1750260001,0,0,0,32.47,53.99,
82795,A2C1750270001,0,0,0,33.51,55.79,
82796,A2C1750280001,0,0,0,34.16,56.69,
82797,A2C1750290001,0,0,0,34.68,57.59,
82798,A2C1750300001,0,0,0,34.68,57.59,
82799,A2C1750310001,0,0,0,35.19,58.49,
82800,A2C1750320001,0,0,0,35.71,59.39,
82801,A2C1750330001,0,0,0,36.75,61.19,
82802,A2C1750340001,0,0,0,37.27,62.09,
82803,A2C1750350001,0,0,0,37.92,62.99,
82804,A2C1750360001,0,0,0,37.92,62.99,
82805,A2C1750380001,0,0,0,38.44,63.89,
82806,A2C1750390001,0,0,0,38.96,64.79,
82807,A2C1750420001,0,0,0,38.96,64.79,
82808,A2C1750440001,0,0,0,39.48,65.69,
82809,A2C1750460001,0,0,0,40.00,66.59,
82810,A2C1750470001,0,0,0,40.00,66.59,
82811,A2C1750490001,0,0,0,41.17,68.39,
82812,A2C1750500001,0,0,0,41.69,69.29,
82813,A2C1750530001,0,0,0,43.77,72.89,
82814,A2C1750570001,0,0,0,45.97,76.49,
82815,A2C1750620001,0,0,0,49.74,82.79,
82816,A2C1750650001,0,0,0,51.95,86.39,
82817,A2C1750730001,0,0,0,55.19,91.79,
82818,A2C1750740001,0,0,0,57.92,96.29,
82819,A2C1750750001,0,0,0,61.17,101.69,
82820,A2C1750760001,0,0,0,63.77,106.19,
82821,A2C1750770001,0,0,0,67.01,111.59,
82822,A2C1750790001,0,0,0,69.74,116.09,
82823,A2C1750810001,0,0,0,73.51,122.39,
82824,A2C1750840001,0,0,0,76.23,126.89,
82825,A2C1750850001,0,0,0,78.96,131.39,
82826,BPC121715106,6,3,3,111.62,,137.70
82828,A2C1750860001,0,0,0,82.21,136.79,
82830,CCH012040000,2,1,1,382.39,,471.75
82831,CCH012060000,3,1,2,412.71,,509.15
82832,CCH012080000,2,0,2,685.55,,845.75
82833,CCH012100000,3,1,2,837.13,,1032.75
82834,CCH024030000,3,2,1,481.61,,594.15
82835,CCH024040000,4,2,2,629.06,,776.05
82836,CCH024060000,5,2,3,719.32,,887.40
82837,SM-SAT-OFFS,3,0,3,194.99,,259.99
82841,LYN040102100,13,8,5,303.16,,374.00
82842,LYN020102000,11,2,9,120.57,,148.75
82843,LYN060102000,23,12,11,171.56,,211.65
82845,21410006,0,0,0,2458.55,,
82861,ORI241221226,15,6,9,184.65,,227.80
82866,ORI121210110R,3,2,1,51.67,,63.75
82868,ORI121222110,7,5,2,92.33,,113.90
82870,ORI121240110,6,1,5,163.29,,201.45
82871,"N03 141",3,0,3,51.18,,
82876,ORI241224110,6,4,2,92.33,,113.90
82877,ORI241240110,3,2,1,163.29,,201.45
82878,ORI481240110,9,6,3,163.29,,201.45
82879,"N04 150",0,0,0,33.54,,
82880,"N04 160",2,2,0,27.54,,
82881,"N05 140",1,0,1,71.98,,
82883,"N05 420",2,0,2,35.12,,
82884,"N05 631",2,0,2,94.15,,
82887,"N05 430",3,0,3,40.43,,
82888,"N05 641",1,0,1,119.46,,
82889,ARG160201020,25,19,6,73.03,,90.10
82890,ARG100201020,7,4,3,81.30,,100.30
82891,ARG200201020R,24,12,12,97.15,,119.85
82894,01-0290-03SL,2,2,0,1379.99,,
82895,LLB-57WW-01-00,2,2,0,9.99,,
82896,LLB-571B-01-00,0,0,0,17.76,,
82897,LLB-46WW-0A-SS,0,0,0,55.98,,
82898,LLB-46WR-0A-SS,0,0,0,62.01,,
82899,LLB-46WB-0A-SS,0,0,0,62.01,,
82900,LLB-46WW-0A-BN,0,0,0,55.98,,
82901,LLB-46WR-0A-BN,0,0,0,62.01,,
82902,385310635,0,0,0,31.52,,
82903,BCD000802000,22,16,6,40.65,,50.15
82904,LLB-46WB-0A-BN,0,0,0,62.01,,
82905,BPR000065400,12,5,7,47.54,,58.65
82906,LLB-46WW-0A-WH,1,1,0,27.99,,
82907,BPR000100400,24,4,20,47.54,,58.65
82908,LLB-46WR-0A-WH,0,0,0,62.01,,
82909,LLB-46WB-0A-WH,0,0,0,62.01,,
82910,LLB-46RG-3A-SS,0,0,0,62.01,,
82911,LLB-46RG-3A-BN,0,0,0,62.01,,
82912,LLB-46RG-3A-WH,0,0,0,62.01,,
82913,LLB-33VW-81-OT,0,0,0,41.71,,
82915,BPR000220400,26,15,11,78.55,,96.90
82916,LLB-45WG-01-00,0,0,0,73.17,,
82917,BPR065022000,22,11,11,48.23,,59.50
82918,BPR110022000,6,2,4,63.39,,78.20
82919,BPR122022000,5,2,3,95.08,,117.30
82920,BAM030712000R,16,6,10,135.04,,166.60
82921,BAM010702000R,9,3,6,117.13,,144.50
82922,ASS000100000,6,4,2,25.49,,31.45
82923,77010600,6,3,3,116.06,,
82925,BPP010300100R,11,10,1,351.39,,433.50
82926,BPP900400100,4,2,2,221.17,,272.85
82928,BPP900100200,5,3,2,18.60,,22.95
82929,ASS030536011,5,2,3,32.38,,39.95
82930,ASS030537010,5,2,3,75.79,,93.50
82932,SBS050150200,1,0,1,31.69,,39.10
82933,REC020005010,6,0,6,113.00,,139.40
82934,DMC000200010R,15,4,11,100.59,,124.10
82935,REC030001210,3,1,2,70.97,,87.55
82936,ASS030064900,14,5,9,6.20,,7.65
82937,ASS030064920,34,19,15,6.20,,7.65
82938,ASS030064980,10,2,8,10.33,,12.75
82939,ASS030065000,12,3,9,12.40,,15.30
82940,ASS030065010,23,10,13,15.16,,18.70
82941,ASS030065030,7,5,2,25.49,,31.45
82942,ASS030065050,27,6,21,29.63,,36.55
82943,ASS030065510,32,25,7,15.16,,18.70
82944,ASS030531203,14,8,6,11.02,,13.60
82945,ASS030531209,17,9,8,11.02,,13.60
82946,ASS030531230,14,8,6,12.40,,15.30
82947,ASS030531250,10,3,7,13.78,,17.00
82948,ASS030531320,13,10,3,16.54,,20.40
82949,ASS030530010,30,10,20,22.74,,28.05
82950,ASS030140000,7,4,3,55.81,,68.85
82951,ASS030520200,24,6,18,57.19,,70.55
82952,SCC010005000,4,2,2,14.47,,17.85
82953,SCC010010000,1,1,0,21.00,,29.75
82954,SCC010020020,2,1,1,22.05,,27.20
82955,323-801-001-006N,0,0,0,56.75,75.59,
82956,304206050YW-1,11,8,3,6.42,,
82957,304210100YW-1,0,0,0,22.45,,
82958,304206100YW-1,10,8,2,8.39,,
82959,304210075YW-1,1,0,1,16.71,,
82960,563310-1,9,5,4,18.50,,
82961,565050-1,4,3,1,17.31,,
82962,563151-1,3,0,3,12.52,,
82963,563320-1,0,0,0,21.53,,
82964,322270-1,7,0,7,33.41,,
82965,322271-1,7,0,7,29.48,,
82966,SCC010030020,4,1,3,31.00,,38.25
82967,400058-1,0,0,0,40.20,,
82968,400059-1,2,0,2,48.67,,
82969,SCC010010050R,15,8,7,36.52,,45.05
82970,SCC010015050R,11,8,3,40.65,,50.15
82971,SCC010015200R,8,2,6,49.61,,61.20
82972,SCC075010060R,10,8,2,50.30,,62.05
82973,SCC075015060R,8,6,2,54.43,,67.15
82974,SCC110015060R,8,4,4,63.39,,78.20
82976,SCC110030210,6,6,0,104.04,,128.35
82977,SCC110050210,4,4,0,149.51,,184.45
82978,404230-3,5,0,5,29.33,,
82979,404232-3,8,4,4,29.33,,
82981,404330-3,8,3,5,31.58,,
82983,404332-3,10,5,5,31.58,,
82985,401755-1,6,4,2,35.33,,
82988,401757-1,0,0,0,31.97,,
82990,CIP100200100,16,7,9,28.94,,35.70
82991,CIP100400070,6,2,4,35.83,,44.20
82992,CIP136200010,11,5,6,11.71,,14.45
82993,CIP136250010,17,10,7,11.71,,14.45
82995,CIP136400010,8,3,5,19.29,,23.80
82996,327194-1,8,8,0,8.52,,
82997,ITR040202041,4,2,2,322.45,,397.80
82998,ITR000100101,6,2,4,412.71,,509.15
82999,323-801-001-007N,0,0,0,56.75,75.59,
83000,323-801-001-008N,0,0,0,56.75,75.59,
83002,432599-1,0,0,0,45.49,,
83003,432598-1,0,0,0,51.31,,
83004,404541-1,7,3,4,91.04,,
83005,323-801-001-040N,0,0,0,56.75,75.59,
83006,404546-1,9,5,4,112.02,,
83007,323-801-001-029N,0,0,0,56.75,75.59,
83008,BPC121315106,11,2,9,101.28,,124.95
83009,CIP000100001,13,6,7,9.65,,11.90
83010,CIP136300010,16,9,7,11.71,,14.45
83012,401686-1,5,5,0,42.64,,
83013,400112-1,7,5,2,20.74,,
83014,400005-1,0,0,0,17.90,,
83020,323-801-005-001D,0,0,0,56.75,75.59,
83021,323-801-017-001N,0,0,0,56.75,75.59,
83023,323-805-001-004N,0,0,0,56.75,75.59,
83024,323-805-001-005N,0,0,0,56.75,75.59,
83025,323-805-001-015N,0,0,0,56.75,75.59,
83028,A2C5318602201,0,0,0,5.84,6.65,
83029,A2C5318602301,0,0,0,11.69,13.49,
83030,A2C5318604001,0,0,0,5.84,6.65,
83031,A2C5318602401,0,0,0,5.84,6.65,
83032,A2C5318602501,4,4,0,3.99,6.65,
83033,A2C5318602601,0,0,0,11.69,13.49,
83034,A2C5318602701,0,0,0,5.84,6.65,
83035,A2C5318602801,0,0,0,5.84,6.65,
83036,A2C5318602901,0,0,0,11.69,13.49,
83037,A2C5319291001,0,0,0,12.47,14.39,
83038,A2C5319291101,0,0,0,6.62,7.64,
83039,A2C5319291201,0,0,0,6.62,7.64,
83040,A2C5319291301,0,0,0,6.62,7.64,
83041,A2C5319291601,2,2,0,3.99,7.64,
83042,A2C5319291401,1,1,0,12.47,14.39,
83043,A2C5319291701,0,0,0,6.62,7.64,
83044,A2C5319292001,0,0,0,6.62,7.64,
83045,A2C5319291801,0,0,0,12.47,14.39,
83046,A2C5321074501,0,0,0,8.31,9.53,
83048,A2C5321074701,0,0,0,14.81,17.09,
83051,A2C5321076101,0,0,0,14.81,17.09,
83052,A2C5321076301,0,0,0,8.31,9.53,
83054,A2C5321076501,4,2,2,6.99,17.09,
83055,A2C59514123,0,0,0,38.83,54.89,
83057,N02-240-402,2,0,2,120.91,161.09,
83058,N02-240-404,0,0,0,217.53,289.79,
83059,N02-240-406,0,0,0,297.14,395.99,
83060,N02-240-802,2,0,2,120.91,161.09,
83061,N02-240-904,1,0,1,214.99,385.19,
83062,N02-240-906,0,0,0,369.48,492.29,
83063,N03-320-264,0,0,0,160.78,214.19,
83064,N03-320-266,0,0,0,20.26,26.99,
83065,A2C3935310001,2,0,2,879.99,1069.19,
83066,A2C5312164501,0,0,0,8.31,9.53,
83067,A2C59510854,4,2,2,34.99,63.89,
83068,A2C59510864,0,0,0,8.31,9.53,
83070,A2C99793900,0,0,0,27.27,31.49,
83071,N05-016-930,0,0,0,44.16,44.99,
83072,N05-001-370,4,2,2,12.99,27.89,
83073,N05-008-750,0,0,0,31.17,35.99,
83074,226-828-001-001K,0,0,0,289.09,385.19,
83075,A2C59514079,0,0,0,38.83,54.89,
83076,A2C59514182,1,1,0,22.99,54.89,
83079,A2C59514128,18,5,13,38.83,54.89,
83081,A2C59514136,0,0,0,38.83,54.89,
83082,A2C59514137,0,0,0,42.08,59.39,
83083,A2C59514139,0,0,0,38.83,54.89,
83084,A2C59514141,0,0,0,38.83,54.89,
83086,A2C59514145,11,0,11,38.83,54.89,
83087,A2C59514149,1,0,1,38.83,54.89,
83088,A2C59514152,1,0,1,24.99,54.89,
83089,A2C59514088,0,0,0,38.83,54.89,
83090,A2C59514085,0,0,0,38.83,54.89,
83091,A2C59514082,2,0,2,38.83,54.89,
83092,A2C59514083,1,0,1,27.99,54.89,
83094,A2C59514094,8,1,7,38.83,54.89,
83096,A2C59514096,2,0,2,38.83,54.89,
83097,A2C59514097,0,0,0,38.83,54.89,
83100,A2C59514099,0,0,0,38.83,54.89,
83101,404520-1,8,3,5,64.57,,
83102,ZDIGIAISTX,1,0,1,562.46,,
83103,ZDIGIAISTXPL,0,0,0,637.46,,
83105,327175-1,5,3,2,56.20,,
83107,328025-1,6,1,5,22.68,,
83132,GS-390-180,2,0,2,2625.09,,3299.99
83134,S32-1031-0100,0,0,0,599.25,,
83136,CS2596701,4,2,2,21.41,,
83137,CS2596702,5,2,3,21.41,,
83138,RA6203900,3,1,2,6.49,,
83141,226-801-015-001G,4,2,2,50.65,67.49,
83142,323-801-004-002N,14,3,11,34.99,,
83145,323-801-010-001D,0,0,0,56.75,75.59,
83147,323-805-003-001N,0,0,0,56.75,75.59,
83148,323-805-003-002N,0,0,0,56.75,75.59,
83153,357204031,2,2,0,32.93,,
83154,357204041,6,3,3,32.93,,
83155,357203001,1,1,0,25.61,,
83156,357203051,2,0,2,28.05,,
83157,357208001,0,0,0,82.93,,
83158,357208011,5,3,2,84.15,,
83159,ARG-756,15,8,7,4.67,,
83161,YACHT-AP-MINI,2,1,1,79.99,,
83163,YACHT-AP-DB,0,0,0,269.32,,
83190,SM-ACC-ALRM,13,6,7,44.78,,55.11
83191,556TID-HDN,0,0,0,1111.11,,
83194,RST1619,3,3,0,49.99,,
83195,TDL1619,0,0,0,65.63,,
83196,SNR1619,0,0,0,65.63,,
83197,SST1619,2,2,0,49.99,,
83198,F16-0274,12,5,7,17.36,,
83199,FSAL1512D008A00,0,0,0,2758.80,,
83204,TM185C-M-8G,0,0,0,912.22,,
83206,70-XT-170,2,0,2,187.23,230.00,
83207,XT-DF-170-K6-IG,0,0,0,876.62,1073.00,
83208,XT-SF-170-K6-IG,1,1,0,876.62,1073.00,
83209,XT-VT-170-K6-IG,0,0,0,876.62,1073.00,
83210,XT-SF-170-IR-IG,2,0,2,550.30,622.00,
83211,XT-VT-170-IR-IG,0,0,0,550.30,622.00,
83212,SG2-0402,2,0,2,11.71,13.99,
83213,UAA2,3,0,3,42.94,52.99,
83214,60-120-K6,3,0,3,625.99,766.00,
83216,621-120-K6,2,0,2,625.99,766.00,
83219,CFII-12/24,3,0,3,181.16,222.00,
83225,ES-8015-01,0,0,0,450.00,,
83227,72-0563,1,1,0,119.99,,
83230,TM275C-LHW-MM,0,0,0,1484.38,,
83241,44310755,9,4,5,1020.00,,1275.00
83242,R70621,0,0,0,68.17,,
83243,942100020,3,2,1,1230.80,,
83244,942100040,2,2,0,1299.99,,
83245,942100030,1,1,0,1358.13,,
83246,942100050,0,0,0,1527.90,,
83247,941900020,5,2,3,2235.99,,2599.99
83248,941900040,4,2,2,2399.99,,2899.99
83249,941900030,2,1,1,2199.99,,2699.99
83250,941900050,2,1,1,2449.99,,2999.99
83251,A80535,1,1,0,63.91,,
83256,E70537,1,1,0,468.74,,
83257,8M4004173,5,1,4,32.93,,
83258,10-13409-01,0,0,0,543.21,,
83277,"LQ 04502",64,25,39,3.69,4.95,
83283,H1170B,4,2,2,27.00,,
83289,77060050,0,0,0,11.97,,
83290,77060100,0,0,0,12.71,,
83291,77060200,13,4,9,13.92,,
83292,77060500,1,1,0,18.37,,
83293,44311005,9,3,6,1322.40,,1653.00
83294,44320405,5,2,3,778.40,,973.00
83295,77020115,13,7,6,275.50,,
83296,147080,0,0,0,33.74,,
83297,146070,0,0,0,22.48,,
83298,145040,2,2,0,16.48,,
83299,144930,5,5,0,12.37,,
83300,PLABG371,0,0,0,124.60,,
83301,PLABG350,1,1,0,58.83,,
83302,PLABG360,3,3,0,83.06,,
83303,PLABG370,8,7,1,103.83,,
83304,PLABG100,3,1,2,17.29,,
83305,PLABG110,0,0,0,24.22,,
83308,FRBO1440,1,0,1,9.51,,
83333,B175C-0-L-MM,0,0,0,1171.31,,
83334,MMC-8G-L,0,0,0,95.00,,
83336,BAM010700000R,7,0,7,94.39,,116.45
83337,SAS-600,2,1,1,1329.30,,
83338,KRD-10,0,0,0,489.30,,
83341,BPA000100010R,4,2,2,46.85,,57.80
83349,H25-0016,6,2,4,317.19,,
83353,010-12797-00,57,1,56,26.24,,
83355,BPP900450100,36,19,17,234.95,,289.85
83356,BPP900455050,27,17,10,178.45,,220.15
83357,18920-9043,4,0,4,89.58,,
83358,BAM030712200,16,3,13,135.04,,166.60
83359,18916-0040,17,8,9,20.25,,
83360,58100-2000,5,1,4,149.14,,
83362,G200416,0,0,0,19.29,,
83363,G200416CASE,0,0,0,106.85,,
83364,G200526,1,0,1,11.99,,
83365,G200526CASE,0,0,0,87.08,,
83366,G200200,0,0,0,28.08,,
83367,M6701,4,0,4,52.15,,
83368,M6701CASE,1,0,1,203.11,,
83370,MMC-11R-HM,3,0,3,95.00,,
83376,88331,0,0,0,812.50,1299.99,
83377,VECTOR200-0,2,1,1,1469.30,,
83378,VECTOR200-2,5,2,3,1119.30,,
83384,HE-EYHK,0,0,0,30.79,,
83385,HE-DLWH1,0,0,0,27.54,,
83386,HE-DTPIGTAIL,0,0,0,29.85,,
83387,HE-DTPLUG,0,0,0,33.63,,
83388,NCTP100,8,6,2,208.27,249.99,
83389,NCTP1002,4,2,2,82.33,97.99,
83390,G190526-X2000KIT,8,3,5,22.99,,
83393,706-62,0,0,0,165.36,,
83394,A2K-SBN-2,1,0,1,218.19,,
83401,HE-WRRK,0,0,0,61.16,,
83405,"LQ 04502CASE",2,1,1,88.59,118.95,
83406,90100,11,3,8,7.67,,
83407,300-037B,0,0,0,1256.36,,1601.85
83410,283008,1,0,1,33.40,,
83431,S72-0436,0,0,0,991.06,,
83436,S72-0638,0,0,0,292.50,,
83437,S72-0629,0,0,0,667.88,,
83438,E-DC-30,6,4,2,22.25,,
83445,A80451,0,0,0,1120.82,,
83446,S72-0695,0,0,0,390.74,,
83453,PKMGKT,4,4,0,25.58,35.70,
83457,1710ST-16-75T,0,0,0,493.50,,
83492,010-12883-00,0,0,0,55.99,,
83499,RF25109HL,5,2,3,41.12,69.91,
83500,010-12548-00,0,0,0,11.24,,
83503,S2-0313,0,0,0,284.78,,
83504,S2-2638,0,0,0,71.48,,
83505,S2-0314,0,0,0,284.78,,
83506,S2-3641,0,0,0,71.48,,
83507,S2-0334,0,0,0,284.78,,
83508,S2-00315,0,0,0,284.78,,
83509,S2-0633,1,0,1,329.99,,
83510,S2-6661,0,0,0,133.74,,
83511,S2-6544,0,0,0,340.12,,
83512,S2-6663,0,0,0,76.09,,
83513,S2-9628,0,0,0,14.70,,
83514,S2-9632,0,0,0,14.70,,
83529,610568,43,27,16,8.49,,
83530,610566,37,25,12,7.99,,
83535,610586,24,5,19,10.39,,
83536,610587,54,29,25,8.99,,
83561,960-G-230-A,0,0,0,107.25,,
83562,B285C-M-MM,0,0,0,982.39,,
83567,22010,0,0,0,117.79,,
83568,22009,0,0,0,86.35,,
83570,22024,2,0,2,46.39,,
83571,22017,7,3,4,47.09,,
83572,22022,2,2,0,42.41,,
83573,22021,0,0,0,43.78,,
83577,T-04MSB,0,0,0,363.64,,
83579,IBI3-40-200,2,0,2,277.98,,
83586,0424DP0CHR,10,0,10,29.67,,
83587,MD32T,3,1,2,2326.94,,
83588,30300,4,3,1,41.33,,
83589,CCH012030000,1,1,0,311.43,,384.20
83590,CCH012050000,4,2,2,397.55,,490.45
83592,VP0128,3,3,0,9.99,,
83593,610572,10,0,10,7.70,,
83594,610588,4,0,4,7.70,,
83595,611547,8,2,6,39.36,,
83596,611395,6,6,0,45.10,,
83597,607393,8,1,7,204.93,,
83598,607405,0,0,0,49.97,,
83599,607407,6,0,6,49.97,,
83600,607400,0,0,0,49.97,,
83607,166001,4,2,2,12.51,23.97,
83608,166201,4,2,2,23.46,34.97,
83609,166101,0,0,0,43.15,64.97,
83611,CAM-PT-150-03,1,0,1,246.94,,
83612,CAM-PT-300-03,2,1,1,267.19,,
83613,CAM-MM-03,0,0,0,289.69,,
83614,AIR-033-203-33,0,0,0,86.94,,
83616,MDS-12WIFI,0,0,0,1539.30,,
83617,10-24946-01,9,3,6,148.15,,
83618,90110,65,53,12,8.37,,
83619,90130,9,4,5,7.99,,
83620,90140,4,0,4,12.99,,
83624,NAVPRO900R,0,0,0,2308.61,,
83625,NAVPRO900FR,0,0,0,2448.61,,
83626,NAVPRO1200R,0,0,0,3148.61,,
83627,NAVPRO1200FR,0,0,0,3288.61,,
83631,281301-1,8,8,0,14.50,,
83632,281300-1,17,7,10,10.14,,
83633,281451-1,0,0,0,15.10,,
83634,281601-1,3,3,0,15.39,,
83635,281901-1,10,2,8,14.61,,
83636,280301-1,10,6,4,15.24,,
83637,280451-1,6,6,0,16.58,,
83638,280601-1,3,2,1,15.81,,
83639,280901-1,2,0,2,14.61,,
83640,010-12226-00,0,0,0,33.74,,
83641,010-12545-01,0,0,0,26.24,,
83642,959940401,0,0,0,174.68,,
83645,241287802,2,2,0,12.66,,
83646,980910121,8,4,4,86.08,,
83654,2982,12,8,4,114.74,,
83656,A2C59514118,4,1,3,38.83,54.89,
83658,B265LH-12P,2,1,1,1422.22,,
83659,B275LHW-12P,3,1,2,1866.67,,
83660,CM275LH-W-12P,0,0,0,1862.22,,
83661,PM265LH-12P,0,0,0,1422.22,,
83662,PM275LHW-12P,0,0,0,1688.89,,
83663,CM599LHG,0,0,0,3551.11,,
83664,VWC100012V105,0,0,0,2176.94,3084.00,
83668,R70727,0,0,0,42.60,,
83669,R70728,0,0,0,42.60,,
83670,R70729,0,0,0,42.60,,
83671,R70525,0,0,0,46.86,,
83672,A80501,7,5,2,51.13,,
83673,A80503,0,0,0,59.65,,
83674,A80534,0,0,0,63.91,,
83675,A80536,3,0,3,119.31,,
83676,GP1920-01,0,0,0,392.72,,
83677,ASK902B.6,3,1,2,147.47,,
83678,ZDIGWLN30SM,3,3,0,209.96,,
83679,ZDIGCLA2000,1,0,1,1949.96,,
83690,SC29,2,0,2,237.38,,
83691,010-12528-10,0,0,0,48.74,,
83692,010-12067-10,0,0,0,78.75,,
83700,AHJHSP-T-12V-DP,3,2,1,99.69,,
83707,GP2920-00,0,0,0,378.17,,
83715,2984,2,0,2,140.36,,
83716,2985,3,1,2,245.92,,
83717,2986,1,1,0,122.05,,
83719,SCM-MFD-CABLE-GARMIN,1,0,1,36.25,,39.95
83720,SCM-MFD-CABLE-NAVICO,0,0,0,36.25,,39.95
83722,PMPS-1-DP,71,45,26,10.27,,
83726,010-12970-00,4,0,4,74.99,,
83727,RF47109,0,0,0,215.43,296.65,
83728,RF67109,0,0,0,388.27,534.65,
83729,RF77109,0,0,0,647.53,891.65,
83730,139800-300-999-17,10,6,4,9.69,,
83747,360-005,2,2,0,36.15,,
83748,1101,29,12,17,9.10,,
83750,MM3-VNA-035,0,0,0,454.55,,
83756,77317,2,1,1,2.61,,
83757,77022,0,0,0,4.21,,
83758,77027,0,0,0,8.40,,
83759,77037,0,0,0,32.01,,
83760,77042,0,0,0,44.96,,
83761,20623,0,0,0,128.19,,
83762,77347,5,5,0,2.91,,
83763,77052,0,0,0,4.37,,
83764,77057,0,0,0,10.03,,
83765,77062,0,0,0,18.63,,
83766,77067,0,0,0,33.87,,
83767,77072,0,0,0,47.07,,
83768,20638,0,0,0,143.55,,
83769,77607,0,0,0,3.15,,
83770,77023,0,0,0,3.71,,
83771,77028,0,0,0,11.80,,
83772,77033,0,0,0,17.09,,
83773,77038,0,0,0,27.39,,
83774,77043,0,0,0,37.99,,
83775,20653,0,0,0,86.32,,
83776,77637,0,0,0,2.49,,
83777,77053,0,0,0,3.52,,
83779,77058,0,0,0,11.51,,
83780,77063,0,0,0,17.09,,
83782,77068,0,0,0,25.87,,
83783,77073,0,0,0,38.75,,
83784,20668,0,0,0,105.29,,
83785,77377,0,0,0,3.97,,
83786,77387,0,0,0,6.96,,
83787,77412,0,0,0,12.76,,
83788,77442,0,0,0,21.97,,
83789,77457,0,0,0,41.84,,
83790,77477,0,0,0,51.68,,
83791,20683,0,0,0,161.41,,
83792,78047,0,0,0,2.52,,
83793,78052,0,0,0,3.56,,
83794,78057,0,0,0,7.13,,
83795,78062,0,0,0,9.20,,
83796,78067,0,0,0,16.77,,
83797,78072,0,0,0,21.39,,
83798,20728,0,0,0,63.87,,
83799,78172,0,0,0,5.81,,
83800,78177,0,0,0,7.64,,
83801,78182,0,0,0,9.71,,
83802,78187,0,0,0,15.07,,
83803,78192,0,0,0,22.77,,
83804,78197,0,0,0,26.00,,
83805,79005,0,0,0,17.87,,
83806,79010,0,0,0,19.68,,
83807,79015,0,0,0,24.87,,
83808,79020,0,0,0,32.12,,
83809,79025,0,0,0,46.52,,
83810,79030,0,0,0,56.93,,
83811,20743,0,0,0,64.73,,
83812,78147,0,0,0,10.76,,
83813,78152,0,0,0,12.57,,
83814,78157,0,0,0,18.93,,
83815,15588,0,0,0,31.47,,
83816,15608,0,0,0,48.52,,
83817,78167,0,0,0,31.36,,
83818,79923,0,0,0,33.05,,
83819,79928,0,0,0,38.97,,
83820,79933,0,0,0,51.09,,
83821,79938,0,0,0,95.79,,
83824,79035,0,0,0,21.49,,
83825,79040,0,0,0,27.49,,
83826,79045,0,0,0,31.69,,
83827,79050,0,0,0,45.83,,
83828,79055,0,0,0,65.05,,
83829,79060,0,0,0,118.39,,
83830,17768,0,0,0,1.37,,
83831,17778,0,0,0,2.07,,
83832,17788,0,0,0,2.40,,
83833,17803,0,0,0,2.87,,
83834,17818,0,0,0,5.41,,
83835,17823,0,0,0,5.61,,
83838,001-512-620-00,3,2,1,163.64,,
83839,131824000,3,2,1,70.35,,
83840,95005,0,0,0,50.31,,
83841,95010,0,0,0,58.28,,
83842,95015,8,8,0,14.99,,
83843,95020,0,0,0,117.92,,
83844,95025,0,0,0,149.55,,
83845,95030,0,0,0,50.34,,
83846,95035,10,10,0,12.99,,
83847,95040,10,10,0,14.99,,
83848,95045,0,0,0,117.97,,
83849,95050,0,0,0,149.62,,
83850,95055,0,0,0,50.31,,
83851,95060,0,0,0,58.28,,
83852,UPLI28PV,1,1,0,658.00,,769.95
83853,95065,0,0,0,70.77,,
83854,DPT-C-PLATE-03,6,1,5,127.13,,
83855,95070,0,0,0,117.92,,
83856,95075,0,0,0,149.55,,
83857,95080,0,0,0,50.34,,
83858,95085,0,0,0,58.32,,
83859,95090,0,0,0,70.80,,
83860,95095,0,0,0,117.97,,
83861,95100,0,0,0,149.62,,
83862,95105,0,0,0,103.09,,
83863,95110,9,9,0,29.99,,
83864,95115,0,0,0,134.43,,
83865,95120,0,0,0,190.08,,
83866,95125,0,0,0,224.65,,
83867,95285,0,0,0,23.94,,
83868,95290,0,0,0,29.68,,
83869,95295,0,0,0,37.66,,
83870,95300,0,0,0,48.58,,
83871,95305,0,0,0,61.22,,
83872,95310,1,1,0,22.99,,
83873,95315,0,0,0,35.94,,
83874,95320,0,0,0,46.49,,
83875,95325,0,0,0,58.29,,
83876,95330,0,0,0,73.46,,
83877,95335,0,0,0,63.42,,
83878,95340,1,1,0,19.99,,
83879,95345,0,0,0,101.11,,
83880,95350,0,0,0,112.40,,
83881,26500,0,0,0,163.05,,
83882,26505,0,0,0,187.40,,
83883,26510,0,0,0,241.75,,
83884,26530,0,0,0,147.29,,
83885,26535,0,0,0,183.08,,
83886,26540,0,0,0,227.91,,
83887,26560,0,0,0,192.49,,
83888,26565,0,0,0,240.03,,
83889,26570,0,0,0,328.34,,
83890,26670,0,0,0,94.25,,
83891,26675,0,0,0,118.03,,
83892,26680,0,0,0,153.08,,
83893,26685,0,0,0,110.08,,
83894,26690,0,0,0,129.85,,
83895,26695,0,0,0,181.32,,
83915,010-12165-03,0,0,0,18.74,,
83916,FSDP31012010B00,0,0,0,1618.99,,
83918,BK-1-DP,8,5,3,25.54,,
83919,FFBT-D-DP,10,2,8,106.94,,
83920,FFBT-S-DP,34,16,18,59.90,,
83922,2134,22,16,6,47.05,,
83928,GP2040-34,0,0,0,334.53,,
83929,1201R,19,10,9,7.81,,
83930,1207R,17,8,9,7.97,,
83932,980910521,6,4,2,86.08,,
83957,19-0747,1,1,0,84.99,,
83960,PNBCK1,0,0,0,33.44,57.99,
83961,ILS-750-DP,11,0,11,15.71,,
83962,ILS-1200-DP,17,8,9,15.71,,
83963,ILS-1500-DP,24,12,12,15.71,,
83964,SHU050210050,3,3,0,157.09,,193.80
83966,SHU050220050,8,4,4,214.28,,264.35
83977,22011,0,0,0,61.70,,
83978,22023,0,0,0,71.93,,
83979,22020,3,0,3,39.99,,
83980,22018,0,0,0,51.08,,
83981,22019,6,4,2,43.70,,
83982,22025,0,0,0,160.74,,
83983,22014,0,0,0,137.89,,
83984,22015,0,0,0,97.14,,
83985,22016,3,0,3,114.80,,
83986,22013,1,0,1,104.16,,
83987,KTF0186,0,0,0,336.51,,
83988,KTF0185,0,0,0,251.10,,
83990,FLX-25-DP,1,0,1,37.52,,
83991,FLX-50-DP,4,2,2,75.07,,
83992,FLX-75-DP,3,2,1,101.16,,
83993,FLX-125-DP,1,0,1,75.07,,
83994,FLX-150-DP,3,2,1,94.67,,
83995,FLX-200-DP,3,1,2,117.00,,
83996,A80235,0,0,0,46.86,,
83998,GX2400B,52,26,26,360.50,,
83999,848-SW-S,0,0,0,329.94,,
84001,411390-1,0,0,0,1309.76,,
84013,BBA000100100,11,1,10,43.41,,53.55
84024,808-0817-02,24,8,16,84.92,,
84027,SHU050150050,38,34,4,95.08,,117.30
84033,73129,0,0,0,11.69,,
84034,75974,12,7,5,30.47,,
84041,UDST800P-N2,0,0,0,902.97,,
84043,001-1,2,2,0,68.33,,
84044,305-1,5,3,2,76.33,,
84045,010-1,3,2,1,60.99,,
84046,910-1,0,0,0,29.13,,
84047,920-1,0,0,0,28.04,,
84048,120-1,4,0,4,12.79,,
84049,110-1,4,2,2,17.08,,
84050,055-1,3,0,3,59.27,,
84051,355-1,3,1,2,53.99,,
84052,220-1,7,0,7,36.99,,
84053,041-1,1,1,0,65.73,,
84054,341-1,2,2,0,76.33,,
84055,771-1,0,0,0,127.84,,
84057,361-1,6,6,0,67.03,,
84058,040-1,0,0,0,59.27,,
84059,340-1,2,2,0,67.03,,
84060,905-1,6,4,2,41.99,,
84061,950-1,2,1,1,9.37,,
84062,952-1,3,2,1,9.37,,
84063,954-1,0,0,0,15.95,,
84064,956-1,2,1,1,15.00,,
84065,960-1,2,0,2,12.19,,
84068,042-1,0,0,0,59.27,,
84069,045-1,0,0,0,59.27,,
84070,342-1,1,0,1,67.03,,
84072,951-1,0,0,0,9.37,,
84073,953-1,0,0,0,9.37,,
84074,955-1,0,0,0,15.95,,
84075,957-1,2,2,0,15.00,,
84076,763-1,1,1,0,78.59,,
84077,769-1,19,9,10,160.99,,
84078,915-1,0,0,0,44.60,,
84079,775-1,0,0,0,163.17,,
84080,112-1,0,0,0,9.44,,
84081,114-1,3,2,1,9.77,,
84084,ST850PV-N2,0,0,0,244.30,,
84089,142012100,0,0,0,193.60,,
84090,930-1,0,0,0,26.93,,
84092,MIL-BC1,0,0,0,35.63,,
84112,A2C59514176,31,3,28,38.83,54.89,
84117,A2C59512545,12,5,7,38.83,54.89,
84118,A2C59514165,4,0,4,38.83,54.89,
84129,TS4-BLK,2,2,0,172.99,,
84130,TS4-WHT,2,2,0,172.99,,
84131,TS5-BLK,2,2,0,182.99,,
84132,TS5-WHT,2,2,0,182.99,,
84133,TS6-BLK,2,2,0,192.99,,
84134,TS6-WHT,2,2,0,192.99,,
84148,958126101,4,0,4,15.19,,
84153,MOFC12GA150SW,0,0,0,103.13,,199.95
84154,MOFC16GA150SW,0,0,0,48.80,,94.95
84155,MFH8,9,4,5,5.55,,11.95
84156,MFH4,5,4,1,8.52,,16.95
84159,201510,12,8,4,4.63,,
84160,ASS050600000,4,2,2,30.32,,37.40
84161,SCC900650010,16,10,6,26.18,,32.30
84164,201510-1,15,5,10,10.16,,
84165,201510-CASE,0,0,0,40.15,,
84166,7782B,2,2,0,5.64,,
84167,PP-118-DP,0,0,0,5.85,,
84168,PP-150-DP,21,12,9,9.38,,
84196,001-563-930-00,2,2,0,236.36,,
84197,79948,0,0,0,217.89,,
84200,010-11376-04,0,0,0,41.24,,
84202,779-LBJ-3,6,5,1,9.45,,
84208,001-563-940-00,0,0,0,309.09,,
84209,001-563-980-00,0,0,0,227.27,,
84213,GP2200-16,0,0,0,363.62,,
84214,AHJHSP-10V-DP,2,0,2,71.15,,
84215,AHJHSP-12V-DP,0,0,0,82.01,,
84216,AHJHSP-4V-DP,2,2,0,45.32,,
84217,AHJHSP-6V-DP,0,0,0,49.64,,
84218,910322,0,0,0,212.43,339.89,
84219,AHJHSP-8V-DP,1,1,0,64.69,,
84220,AHJHSP-14V-DP,3,2,1,85.17,,
84221,FSRK-3-DP,14,3,11,9.75,,
84222,358115091,0,0,0,43.04,,
84223,ORI121236120,16,9,7,197.74,,243.95
84224,ORI121222120,14,4,10,129.53,,159.80
84225,ORI241236120,7,4,3,197.74,,243.95
84226,ORI121236140,0,0,0,174.32,,215.05
84227,ORI122436120,6,5,1,197.74,,243.95
84228,ORI241236140,2,0,2,174.32,,215.05
84229,ORI122436140,8,5,3,174.32,,215.05
84230,A2C59514850,2,1,1,29.99,55.79,
84238,88385,8,8,0,7.99,,
84239,88390,0,0,0,47.88,,
84242,88100,1,1,0,34.99,,
84245,88095,8,8,0,12.99,,
84251,88005,8,8,0,12.99,,
84256,88010,3,3,0,34.99,,
84272,A2C59514241,2,1,1,38.83,54.89,
84287,SAD-17B,11,2,9,13.50,,
84288,CA28BL-6HR,0,0,0,2888.89,,
84291,S2-6331,1,0,1,749.99,,
84295,010-11078-00CASE,1,1,0,183.76,,
84296,6415,2,0,2,553.98,,
84299,T9101606,8,3,5,8.00,,
84304,2465,0,0,0,115.07,,168.98
84316,S-0981C,2,0,2,23.00,,
84330,10-1477-40,2,0,2,24.07,,
84344,CLIP-22,26,12,14,5.25,,
84346,PP4600-10,0,0,0,303.60,,
84347,0439,0,0,0,4.96,,
84352,20761-001,0,0,0,295.33,,
84353,LTVLF-6,2,2,0,364.33,,
84354,LTVLF-8,25,25,0,324.38,,
84357,EXT-2,5,5,0,18.62,,
84358,EXT-3,5,5,0,23.59,,
84361,MB-825B,27,27,0,22.41,,
84362,MB-1025B,3,3,0,24.02,,
84363,LPD-6PB,10,10,0,33.84,,
84365,LPD-8PB,1,1,0,39.45,,
84366,LPD-10PB,16,16,0,42.51,,
84367,MD-5B,6,6,0,19.42,,
84369,MD-7B,10,10,0,23.32,,
84372,LD-5B,0,0,0,27.60,,
84374,LD-7B,1,0,1,31.04,,
84376,CIP050060000,7,2,5,22.05,,27.20
84381,TM165C-HW-MM,3,1,2,350.85,,
84387,290900-1,4,4,0,11.85,,
84388,BPC900120114,16,6,10,10.33,,12.75
84389,BPC900200014,11,6,5,7.58,,9.35
84390,BPC920100200,4,1,3,4.13,,5.10
84391,BPC940100100,13,5,8,22.74,,28.05
84392,010-11055-02,0,0,0,83.99,,
84427,BPCAB10HF,1,0,1,105.19,,
84428,BPCAB1HF,0,0,0,43.31,,
84429,BPCAB15HF,0,0,0,111.94,,
84430,BPCAB20HF,1,0,1,106.58,,
84431,BPCAB25HF,0,0,0,132.19,,
84432,BPCAB5HF,0,0,0,60.00,,
84444,2637,1,0,1,28.40,42.95,
84445,2649,0,0,0,31.70,47.95,
84446,2650,0,0,0,19.99,29.95,
84447,2652,4,4,0,26.86,40.95,
84448,2659,0,0,0,27.21,40.95,
84449,2608,3,0,3,46.43,69.95,
84450,2609,0,0,0,50.32,75.95,
84451,2610,0,0,0,97.97,147.95,
84452,2135,1,1,0,54.91,82.95,
84453,2136,0,0,0,59.52,89.95,
84454,2137,0,0,0,59.21,88.95,
84455,CA-0183,2,2,0,7.79,,
84456,PIII-20-ER,6,3,3,50.29,,
84458,SP120C-RF-1,0,0,0,1889.30,,
84459,SP120C-RF-2,0,0,0,2029.30,,
84460,SP120C-RF-3,0,0,0,2589.30,,
84461,SP120C-RF-4,0,0,0,2659.30,,
84462,SP120C-RF-5,0,0,0,2939.30,,
84463,SP120C-RF-6,0,0,0,3079.30,,
84466,SP120C-RF-9,0,0,0,2799.30,,
84469,SSM-72H,12,8,4,99.99,,
84473,TM200HWKIT,0,0,0,22.07,,
84474,TM201HWKIT,0,0,0,22.07,,
84475,TM203HWKIT,3,3,0,22.07,,
84476,TM206HWKIT,0,0,0,22.07,,
84477,TM207HWKIT,0,0,0,22.07,,
84478,TM208HWKIT,3,2,1,22.07,,
84479,TM209HWKIT,0,0,0,22.07,,
84480,TM210HWKIT,2,2,0,22.07,,
84481,TM212HWKIT,5,3,2,22.07,,
84482,TM214HWKIT,0,0,0,22.07,,
84483,TM215HWKIT,1,0,1,22.07,,
84484,TM216HWKIT,0,0,0,22.07,,
84486,51100,0,0,0,131.25,209.99,
84487,51101,0,0,0,131.25,209.99,
84488,51102,0,0,0,106.24,169.99,
84489,51200,0,0,0,112.50,179.99,
84490,51201,0,0,0,112.50,179.99,
84491,51202,0,0,0,93.74,149.99,
84492,52100,0,0,0,106.24,169.99,
84493,52101,0,0,0,106.24,169.99,
84494,52102,0,0,0,106.24,169.99,
84495,52200,0,0,0,85.59,149.99,
84497,52202,0,0,0,93.74,149.99,
84498,62000,19,10,9,499.99,,
84499,62001,5,0,5,499.99,,
84500,62002,20,10,10,329.99,,
84503,62102,0,0,0,499.99,799.99,
84506,PM2,20,14,6,17.99,,
84507,SB50G,0,0,0,19.94,,
84509,301-011KLST,0,0,0,1618.64,,2063.77
84510,925513BLK,21,2,19,218.75,349.99,
84511,818-2010,2,2,0,1075.17,,
84512,818-3010,5,4,1,1325.03,,
84515,01-0343-01,0,0,0,25124.40,,
84524,BOWA0761,0,0,0,3462.75,4617.00,
84525,DBPPJA,0,0,0,865.20,,
84526,STERN185P,0,0,0,336.00,,
84527,600-807,0,0,0,5.44,,
84528,WP-850-950,7,5,2,38.00,,
84529,BP-850AEY,3,0,3,33.01,,
84538,40131,0,0,0,12.79,,
84539,101638,0,0,0,1317.02,,
84547,UD-ME100LED,7,1,6,14.99,,
84550,UD-ME650LED,9,4,5,24.99,,
84552,TS-ME650FS,7,7,0,104.99,,
84553,GM-ME500X1,2,2,0,124.99,,
84560,SCM-ZC-KIT,4,2,2,370.55,,529.00
84562,A80469,0,0,0,866.66,,
84565,IF-NMEAFI,1,0,1,245.45,,
84566,4141,7,1,6,8.46,,
84658,010-13060-00,1,1,0,36.52,,
84659,66517-7,13,6,7,55.50,,
84668,SP120RF-1,0,0,0,1539.30,,
84669,SP120RF-2,1,1,0,1739.99,,
84670,SP120RF-3,0,0,0,2449.30,,
84671,SP120RF-4,0,0,0,2519.30,,
84672,SP120RF-5,0,0,0,2799.30,,
84673,SP120RF-6,0,0,0,3009.30,,
84680,A2C3832980030,1,1,0,162.57,,
84681,A2C3833350030,1,0,1,81.72,,
84682,A2C3832770030,3,2,1,81.79,,
84683,A2C3833500030,3,2,1,81.60,,
84684,362-004,4,3,1,41.16,,
84685,A2C3833190030,0,0,0,81.72,,
84686,A2C3833120030,0,0,0,81.71,,
84699,INFMPK250-4W,0,0,0,348.95,469.95,
84700,SCA520300000,51,20,31,8.27,,10.20
84703,S24-0201,0,0,0,76.00,,
84704,S72-0652,0,0,0,1142.40,,
84705,S72-0656,0,0,0,148.80,,
84706,S24-0098,0,0,0,16.00,,
84707,082,0,0,0,13.59,19.95,
84708,S24-0116,0,0,0,72.00,,
84709,083,6,3,3,16.27,22.95,
84710,S72-0625,0,0,0,288.00,,
84711,S72-0626,0,0,0,489.60,,
84712,084,0,0,0,36.89,52.95,
84713,S72-0627,0,0,0,249.60,,
84714,085,0,0,0,39.60,56.95,
84715,S72-0468,1,0,1,229.99,,
84717,125,0,0,0,24.73,34.95,
84718,126,2,2,0,27.59,39.95,
84719,127,0,0,0,62.01,88.95,
84720,128,0,0,0,64.95,92.95,
84729,0160-0150,0,0,0,11.19,,18.99
84730,PLAMT6211,7,7,0,11.30,,
84731,PLAMT6221,16,8,8,14.13,,
84732,PLAMT6231,2,2,0,17.67,,
84735,118752,0,0,0,93.60,,
84745,B00041201,0,0,0,211.82,257.39,
84746,B00041401,1,1,0,239.99,385.19,
84747,B00041501,2,1,1,304.99,492.29,
84749,87231,10,0,10,502.16,,
84754,3269,0,0,0,13.30,15.95,
84755,3270,0,0,0,16.62,19.95,
84756,3271,9,6,3,17.82,20.95,
84757,3272,0,0,0,22.75,26.95,
84758,3273,0,0,0,33.38,38.95,
84780,15-2030,1,0,1,250.00,,
84833,20-1030,2,0,2,160.98,,
84845,GS-500,5,4,1,2866.67,,3499.99
84846,OT-4240CF-HD,0,0,0,2689.62,,
84853,RA078400C,9,4,5,3.49,,
84866,19-5060,37,0,37,8.00,,
84867,19-5270,1,1,0,10.00,,
84883,R70741,0,0,0,38.34,,
84884,45510500,0,0,0,11.47,,
84885,41500400,6,3,3,10.66,,
84898,001-468-520-00,0,0,0,172.73,,
84899,72-0900-H24,9,4,5,131.25,,
84901,72-0900-HR24,0,0,0,234.12,,
84902,72-0900-H25COM,3,1,2,131.25,,
84903,FVC070312210Q00,0,0,0,188.76,,
84904,FVC080391220Q00,0,0,0,321.61,,
84913,SCC900500000,29,21,8,41.34,,51.00
84914,ASS050500000,4,2,2,18.60,,22.95
84919,BAT512120610,2,0,2,899.14,,1109.25
84920,BMS300200000,6,2,4,95.08,,117.30
84923,BPP900600100,6,3,3,205.26,,331.50
84933,AHJM-4-DP,2,0,2,904.36,,
84947,011708,0,0,0,90.00,,
84956,10259S-2,0,0,0,587.84,,
84961,MM-8G,0,0,0,72.65,,
84967,TPC6,0,0,0,34.29,,57.95
84968,TPC8,0,0,0,37.75,,63.95
84977,RFSKNIFE-2,0,0,0,22.20,30.56,
84979,T112510,1,0,1,16.82,,
84982,GFTJ-1-DP,4,4,0,29.43,,
84986,NS-24,2,1,1,99.99,,
85005,281900-1,9,9,0,13.05,,
85008,75-5000,5,5,0,42.45,,
85009,55-2100,7,2,5,43.51,,
85010,55-1900,24,17,7,44.30,,
85012,75-6060,1,0,1,57.36,,
85013,75-6025,3,3,0,40.94,,
85014,75-6015,0,0,0,114.28,,
85015,75-6065,4,3,1,79.63,,
85016,75-6099,3,2,1,23.64,,
85022,3102100,0,0,0,119.67,,
85023,3103,0,0,0,286.01,,
85024,3104,0,0,0,340.10,,
85027,CYR010120450,4,2,2,53.05,,65.45
85028,S72-0692,0,0,0,1916.00,,
85032,E70634,0,0,0,639.99,,
85033,E70634-00-102,0,0,0,679.99,,
85034,E70634-00-NAG,0,0,0,849.59,,
85038,E70635,11,10,1,749.99,,
85039,E70635-00-102,1,0,1,839.99,,
85040,E70635-00-NAG,2,2,0,993.59,,
85041,E70635-03-102,1,0,1,1119.99,,
85042,E70635-03-NAG,2,2,0,1273.59,,
85043,R70794,11,0,11,119.67,,
85059,980960291,3,1,2,98.54,,
85062,SHU500050100,0,0,0,21.36,,26.35
85064,SPR00053,6,5,1,23.43,,28.90
85070,"KIT 95-2S",0,0,0,67.76,,
85073,E70533-00-102,0,0,0,559.99,,
85074,E70535-00-102,0,0,0,959.99,,
85075,E70534-00-102,2,0,2,639.99,,
85076,E70534-05-102,2,0,2,719.99,,
85077,E70536-00-102,0,0,0,1039.99,,
85078,E70536-05-102,0,0,0,1119.99,,
85085,21001600600,0,0,0,754.30,,
85089,APT-150-01-BLK,3,1,2,255.94,,
85090,APT-250-01-BLK,3,2,1,261.56,,
85091,APT-LB-01-BLK,1,0,1,118.13,,
85094,87531,6,0,6,749.00,,
85095,87431,1,1,0,893.74,1429.99,
85096,PXXRCASA,12,6,6,4.53,,
85098,010-12898-00,1,0,1,40.26,,
85100,010-12898-10,0,0,0,56.97,,
85101,010-12898-20,1,1,0,296.32,,
85102,010-12899-00,1,0,1,24.31,,
85103,010-12899-10,3,2,1,32.67,,
85104,010-12899-20,1,1,0,197.55,,
85105,ST800PV-N2,0,0,0,263.69,,
85106,33032A,6,4,2,43.22,,
85111,SBH-36,14,5,9,40.50,,
85115,ARG200301020,18,11,7,113.68,,140.25
85116,V11-9970BKA100-1,0,0,0,516.29,,
85119,010-12831-20,2,0,2,130.41,,
85120,010-12922-01,0,0,0,10.82,,
85132,3120,2,1,1,422.06,,
85134,41-135A,29,11,18,56.58,,
85139,03-91-032,0,0,0,6.06,,
85156,RMX300-RD-TN,4,2,2,31.65,43.99,
85157,RMX300-RD-MC,8,7,1,31.65,43.99,
85159,2000035457,1,0,1,225.00,,
85161,TZ3-12P-PGT,0,0,0,131.82,,
85164,010-11849-10,0,0,0,26.24,,
85165,32ALA,11,6,5,68.11,,
85166,60-YP-MC-120-J10,2,0,2,819.08,1003.00,
85180,T70278,0,0,0,324.99,,
85182,1810600,12,2,10,1197.23,,1599.99
85183,1810601,1,0,1,1197.23,,1599.99
85184,1810620,8,4,4,1346.89,,1799.99
85185,1810621,13,0,13,1346.89,,1799.99
85186,1810622,7,0,7,1346.89,,1799.99
85187,1810623,11,0,11,1346.89,,1799.99
85188,1810630,13,6,7,1496.54,,1999.99
85189,1810631,0,0,0,1496.54,,1999.99
85190,1810632,10,4,6,1496.54,,1999.99
85191,1810633,2,0,2,1496.54,,1999.99
85192,1810253,15,5,10,82.30,,
85193,1810258,7,4,3,134.68,,
85194,1810360,0,0,0,229.30,,
85195,1810365,2,0,2,229.30,,
85196,1810361,0,0,0,229.30,,
85197,1810366,0,0,0,229.30,,
85198,1810362,10,6,4,229.30,,
85199,1810367,4,0,4,229.30,,
85200,1810363,0,0,0,229.30,,
85201,1810368,2,0,2,229.30,,
85202,1810370,3,0,3,70.97,,
85203,1810375,3,1,2,70.97,,
85204,1810371,2,0,2,78.07,,
85205,1810376,5,3,2,78.07,,
85213,12732-A,3,3,0,12.00,,
85219,7653L3,13,6,7,5.20,,
85220,1580017-BLK,12,4,8,93.63,,
85221,2171042,4,4,0,15.31,,
85227,TS0101,6,4,2,21.99,,
85231,M25033,13,4,9,18.67,,
85232,M25053,0,0,0,18.67,,
85233,M25063,70,0,70,15.49,,
85234,M25073,109,71,38,15.49,,
85235,M25083,120,52,68,18.67,,
85236,M25093,81,32,49,14.49,,
85237,M25103,0,0,0,18.67,,
85238,M25113,9,9,0,14.49,,
85239,M25123,0,0,0,18.67,,
85240,M25193,24,24,0,18.67,,
85241,1061016,8,7,1,98.49,,
85242,1061018,7,0,7,93.16,,
85243,1061025,1,0,1,83.99,,
85244,39362,6,0,6,11.99,,
85245,38343,38,21,17,14.49,,
85246,1040647,0,0,0,107.47,,
85247,1040667,0,0,0,82.94,,
85248,38353,23,0,23,17.10,,
85249,1062031,0,0,0,90.66,,
85250,1062034,1,1,0,90.66,,
85251,39643,32,26,6,17.21,,
85252,1040651,7,6,1,81.17,,
85253,1040653,4,2,2,70.60,,
85254,M25610,0,0,0,152.73,,
85255,M25620,0,0,0,152.73,,
85256,M25630,0,0,0,152.73,,
85257,M25640,2,1,1,104.99,,
85258,M25650,2,1,1,109.99,,
85261,71140,0,0,0,10.59,,
85263,TYN-08BLKSP,38,28,10,4.17,,
85264,TYN-08RSP,48,38,10,4.17,,
85269,AK0553,9,7,2,21.56,,
85270,601015-1,16,8,8,97.40,,149.99
85271,SP120VF-1,0,0,0,1259.30,,
85272,SP120VF-2,0,0,0,1609.30,,
85273,SP120C-VF-1,1,1,0,1534.99,,
85274,SP120C-VF-2,0,0,0,2029.30,,
85278,"DIGITAL C CABLE",0,0,0,34.97,,
85290,RF3911,139,0,139,29.99,,
85292,RF3941,21,0,21,14.99,,
85293,RF3951,159,0,159,9.99,,
85294,RF70,2,0,2,76.39,118.32,
85295,SN0036A,0,0,0,115.50,,
85296,IBC320-12,4,3,1,601.06,,
85297,001-081-140,0,0,0,31.82,,
85301,ASS000001000,7,3,4,16.54,,20.40
85305,E1150Z-13CAB,1,1,0,51.22,,
85333,286,0,0,0,7.30,,9.98
85338,SSM-17H,40,34,6,21.18,,
85362,SCC115035210,3,3,0,149.51,,184.45
85368,ORI242428110,9,4,5,92.33,,113.90
85372,HC2400,24,5,19,7.50,,
85377,713,8,4,4,13.23,,
85378,YBP-0203,0,0,0,73.17,,99.98
85384,TM275LHW-12P,1,0,1,1600.00,,
85388,CS-6/WH,17,10,7,9.13,,14.95
85389,CS-6/BK,5,1,4,9.13,,14.95
85390,CS-8W,5,0,5,11.59,,18.95
85391,CS-8B,8,2,6,11.59,,18.95
85392,001-193-460-10,0,0,0,122.73,,
85400,55-9815,12,6,6,72.60,,
85401,MG1002-BLK,4,1,3,25.54,38.60,
85402,MG1002-GRY,4,2,2,25.54,38.60,
85403,MG1002-TWH,2,0,2,25.54,38.60,
85404,MG1003-BLK,4,1,3,30.28,45.75,
85405,MG1003-GRY,3,3,0,30.28,45.75,
85406,MG1003-TWH,4,3,1,30.28,45.75,
85407,MG1006-BLK,6,3,3,39.71,60.00,
85408,MG1006-GRY,2,0,2,39.71,60.00,
85409,MG1006-TWH,3,0,3,39.71,60.00,
85410,MG10HC-BLK,0,0,0,39.71,60.00,
85411,MG10HC-GRY,4,1,3,39.71,60.00,
85412,MG10HC-TWH,3,3,0,39.71,60.00,
85413,AO-1500-CRC,0,0,0,552.90,,
85414,CA-0000,1,1,0,361.11,,
85420,1PCP32,70,70,0,11.43,,
85421,1PKO32,109,18,91,10.67,,
85426,SM-S3P-917,20,7,13,617.56,,796.86
85427,SM-ACC3-WIRE,8,3,5,17.74,,21.83
85428,SM-WLS3-TEMP-917,14,6,8,107.80,,139.09
85429,SM-WLS3-BATT-917,23,9,14,107.80,,139.09
85430,SM-WLS3-HIWS-917,13,4,9,107.80,,139.09
85431,SM-WLS3-BILG-917,15,3,12,107.80,,139.09
85432,SM-WLS3-ENTR-917,22,4,18,107.80,,139.09
85433,96590,0,0,0,9.24,12.36,
85434,HL-501,5,3,2,3.62,,
85435,HL-501-OD,4,3,1,3.62,,
85436,HL-501-TAN,0,0,0,3.62,,
85437,HL-APX-BK,3,1,2,4.55,,
85438,HL-500-BK,1,1,0,3.62,,
85481,GDI000032000,0,0,0,201.88,,249.05
85482,WN810,8,4,4,9.36,,
85483,GDI000064000,6,3,3,247.35,,305.15
85486,21010,46,37,9,2.93,4.88,
85487,21030,0,0,0,4.80,6.08,
85489,21036,7,7,0,5.41,6.85,
85490,41150,845,0,845,8.99,13.26,
85492,41160,44,11,33,10.69,17.82,
85495,91003,36,36,0,7.71,12.86,
85497,97008,3,3,0,9.75,16.26,
85499,93003,23,23,0,8.49,14.13,
85502,48008,25,7,18,14.80,24.65,
85506,51010,110,62,48,3.39,5.64,
85509,54200,14,12,2,17.78,29.62,
85510,12004,21,13,8,4.03,6.72,
85511,56204,0,0,0,5.45,9.08,
85513,31110,0,0,0,9.64,16.07,
85514,11016,3,0,3,7.96,13.28,
85515,83110,22,12,10,7.79,12.97,
85516,85011,35,31,4,7.45,12.41,
85517,91110,40,17,23,8.14,10.53,
85518,51600,4,0,4,15.91,26.51,
85519,85032,29,18,11,19.53,32.54,
85520,83032,17,5,12,20.84,34.73,
85521,19003,31,15,16,6.14,10.22,
85522,19008,10,3,7,15.29,25.49,
85523,98003,30,20,10,5.45,9.07,
85524,82003,67,52,15,5.79,9.65,
85525,82016,23,15,8,11.65,19.43,
85526,80320,45,36,9,7.21,12.02,
85527,11520,23,9,14,7.48,12.46,
85529,740151-1,2,2,0,38.95,,
85532,0173,0,0,0,54.06,,
85533,001-533-080-00,1,0,1,72.73,,
85534,79943,0,0,0,151.09,,
85537,MRGB55B,7,4,3,51.13,,
85538,MRGB55W,6,1,5,51.13,,
85543,289-050,0,0,0,32.37,,
85545,QSR2419,0,0,0,92.50,,
85546,TDL2419,4,4,0,72.99,,
85549,13894,0,0,0,172.54,,
85550,18670-9407,15,10,5,255.51,,
85553,SCM-SNLC,3,2,1,124.00,,169.00
85566,GP2920-05,0,0,0,390.35,,
85567,BT1-985-2,5,2,3,16.99,34.99,
85569,55-0010,6,2,4,114.00,,
85570,55-0012,3,1,2,144.35,,
85572,55-0021,2,2,0,162.84,,
85573,55-0024,1,1,0,78.95,,
85574,55-0027,4,3,1,235.68,,
85575,55-0028,0,0,0,105.92,,
85576,55-0407AL,0,0,0,222.65,,
85580,LSP15K,29,5,24,25.38,,
85592,T500-NY,3,0,3,64.05,87.99,
85593,T500-BK,0,0,0,64.05,87.99,
85597,SW-804II,4,0,4,6.11,,
85598,GG-128-R,0,0,0,2.63,,
85607,VTC305-12-12,0,0,0,449.36,,
85610,87331,10,2,8,706.24,,
85613,DT2BX-TH,0,0,0,129.00,,
85618,R70496,0,0,0,25.56,,
85645,RMX4800-10,0,0,0,436.35,,
85648,36212001,0,0,0,771.20,,964.00
85650,RLGCT,3,3,0,24.45,,
85660,22590,7,2,5,9.56,,
85661,22592,16,11,5,13.85,,
85662,22594,21,6,15,20.56,,
85663,22595,12,7,5,24.08,,
85664,22596,15,12,3,31.19,,
85667,79001,1,1,0,104.29,,
85668,79002,2,2,0,89.99,,
85669,79003,1,1,0,132.20,,
85670,79004,1,1,0,132.20,,
85671,79005,0,0,0,146.11,,
85672,79006,0,0,0,171.88,,
85673,79009,0,0,0,208.30,,
85674,79010,2,2,0,109.99,,
85675,79011,1,1,0,139.99,,
85676,79012,1,1,0,134.99,,
85677,AK1005,7,2,5,114.08,,
85680,69361,9,9,0,29.71,,
85681,69362,10,6,4,34.46,,
85682,41971,4,2,2,87.28,,
85684,1105.91,0,0,0,64.04,,
85685,MMC-9N2,4,2,2,95.00,,
85687,53671CA,9,1,8,54.06,107.99,
85688,08-66-010,1,0,1,108.94,,
85689,R70387,0,0,0,55.39,,
85690,R70598,0,0,0,79.16,,
85708,751S-01771,2,2,0,42.39,,
85712,010-12922-02,17,15,2,4.51,,
85716,VC100012V,0,0,0,1304.47,,
85717,5161812304,0,0,0,47.08,,
85723,TS-ME770FS,13,9,4,129.99,,
85724,TS-ME770FC,11,5,6,124.99,,
85726,B117-DT-RAY,0,0,0,240.29,,
85728,T10-7001VEL,11,5,6,262.68,,
85729,T10-7005CF,2,2,0,1020.42,,
85730,F31-0702BXY,9,4,5,44.96,,
85731,T10-3000-1,10,4,6,1030.62,,1299.99
85732,T10-3000-2,5,2,3,1030.62,,1299.99
85733,T10-3000-3,7,3,4,1101.69,,1399.99
85734,T10-3000-4,5,2,3,1101.69,,1399.99
85735,T10-3000-5,5,2,3,164.19,,
85737,T10-3000-6,4,2,2,265.36,,
85741,T10-3000-7,3,2,1,265.36,,
85744,411370-1CHO,22,22,0,974.56,,1099.99
85745,411370-1,7,6,1,1063.16,,1199.99
85746,T10-3000-11,1,0,1,112.77,,
85748,411380-1CHO,8,3,5,1151.76,,1299.99
85749,411380-1,3,0,3,1417.55,,1599.99
85751,411410-1CHO,16,16,0,1240.36,,1399.99
85752,411410-1,29,15,14,1328.95,,1499.99
85753,411420-1CHO,17,11,6,1550.66,,1949.99
85754,411420-1,20,11,9,1860.54,,2099.99
85756,411440-1CHO,20,20,0,1949.14,,2199.99
85757,411440-1,5,3,2,2037.74,,2299.99
85760,411310-1CHO,10,7,3,2392.13,,2699.99
85761,411320-1CHO,5,2,3,2569.32,,2899.99
85762,411320-1,9,8,1,2835.11,,3199.99
85763,411530-1CHO,12,10,2,2074.47,,2399.99
85764,411530-1,7,3,4,2333.78,,2699.99
85765,411550-1CHO,9,8,1,2448.99,,2899.99
85766,411550-1,15,3,12,2702.33,,3199.99
85767,411570-1CHO,7,5,2,2871.23,,3399.99
85768,411570-1,13,9,4,3124.57,,3699.99
85769,411470-1CHO,0,0,0,3377.92,,3999.99
85770,411470-1,7,3,4,3631.26,,4299.99
85771,411500-1CHO,14,11,3,3800.16,,4499.99
85772,411500-1,5,3,2,4053.51,,4799.99
85773,411240-1CHO,8,6,2,4222.40,,4999.99
85774,411240-1,3,1,2,4475.75,,5299.99
85775,740194-1,0,0,0,68.18,,
85776,740191-1,0,0,0,60.60,,
85777,740192-1,0,0,0,64.39,,
85778,740193-1,0,0,0,68.18,,
85779,740189-1,7,7,0,60.60,,
85780,720110-1,0,0,0,40.91,,
85781,720111-1,12,0,12,42.85,,
85782,720112-1,6,6,0,42.85,,
85783,700063-1,0,0,0,175.33,,
85784,700062-1,0,0,0,175.33,,
85785,411580-1,10,7,3,1013.37,,
85786,720115-1,0,0,0,83.33,,
85787,720113-1,0,0,0,33.33,,
85788,720114-1,0,0,0,24.24,,
85789,700064-1,3,0,3,83.33,,
85790,700065-1,0,0,0,113.64,,
85791,760035-1,6,6,0,16.66,,
85792,760036-1,0,0,0,16.66,,
85793,760038-1,4,0,4,24.24,,
85794,720117-1,0,0,0,24.24,,
85795,720117-2,8,4,4,33.33,,
85796,720117-3,6,3,3,40.91,,
85797,720117-4,6,1,5,60.60,,
85805,HID8,0,0,0,250.00,,
85806,HT471TW,4,2,2,117.50,,
85810,N8NRL2TB,0,0,0,372.50,,
85811,H6HRL2TB,0,0,0,287.50,,
85834,973,0,0,0,29.99,,
85836,32809,14,8,6,36.99,,
85838,B744V-9N,0,0,0,631.53,,
85841,760037-1,2,0,2,28.02,,
85844,CYR010230010,2,0,2,97.84,,120.70
85847,VE-60-E1YN,0,0,0,16141.18,23200.00,
85856,12725,8,3,5,97.50,,
85858,SHC-20,12,3,9,21.18,,
85859,SCS-1000,0,0,0,349.30,,
85862,60-YP-MC-120-K6,2,0,2,819.08,1003.00,
85863,MRCP9685A,8,6,2,228.31,329.99,
85868,IRID-ANT-RST210,1,1,0,191.49,,
85869,A503-51AAG-HE,0,0,0,128.05,,
85870,P1101Z-51AAH,0,0,0,89.63,,
85871,TYN-05WSP,3,0,3,3.99,,
85872,CL730XXS,0,0,0,23.02,35.66,
85873,CL730XS,3,3,0,23.02,35.66,
85874,CL730S,7,4,3,23.02,35.66,
85875,CL730M,10,6,4,23.02,35.66,
85876,CL730L,27,24,3,23.02,35.66,
85877,CL730XL,3,3,0,23.02,35.66,
85878,CL730XXL,3,3,0,23.02,35.66,
85880,CL740XXS,0,0,0,24.67,38.21,
85881,CL740XS,4,4,0,24.98,38.21,
85882,CL740S,9,6,3,24.98,38.21,
85883,CL740M,14,10,4,24.98,38.21,
85884,CL740L,9,5,4,24.98,38.21,
85885,CL740XL,4,3,1,24.98,38.21,
85886,CL740XXL,0,0,0,24.98,38.21,
85887,A2C3832920030,0,0,0,162.57,,
85890,ASS030530310,7,7,0,16.54,,20.40
85893,A2C3833130030,10,6,4,81.71,,
85894,A2C3833140030,0,0,0,81.71,,
85898,A2C3833340030,3,2,1,81.72,,
85909,A2C3833300030,0,0,0,81.72,,
85924,A2C3832780030,2,0,2,81.79,,
85926,UD-ME770LED,10,10,0,32.99,,
85927,A2C3832900030,2,1,1,162.63,,
85929,A2C3833240030,0,0,0,81.60,,
85930,A2C3833010030,0,0,0,162.57,,
85931,A2C3832990030,6,3,3,162.57,,
85932,A2C3833070030,0,0,0,87.73,,
85935,DE1026F,0,0,0,7.21,,
85936,DE1027F,0,0,0,9.31,,
85937,010-11425-01,29,9,20,27.99,,
85938,32-0417-0100,0,0,0,74.25,,
85939,S32-0987-50,0,0,0,41.25,,
85942,S32-0819-50,1,1,0,57.99,,
85944,A2C3833060030,0,0,0,87.75,,
85945,A2C3833090030,0,0,0,87.73,,
85946,A2C3833080030,0,0,0,87.85,,
85947,A2C3833550030,1,1,0,72.99,,
85948,A2C3832750030,1,0,1,81.71,,
85949,A2C3833100030,0,0,0,81.71,,
85950,1041419,4,1,3,211.27,,
85951,1041483,0,0,0,211.27,,
85952,1041519,0,0,0,209.17,,
85953,1041583,1,0,1,179.99,,
85954,1041606-1,0,0,0,218.83,,
85955,1041631-1,5,4,1,218.83,,
85956,1041634-1,0,0,0,218.83,,
85957,1041684-1,5,3,2,218.83,,
85958,1041636,0,0,0,201.14,,
85959,1041733,0,0,0,201.14,,
85960,1061063-B,0,0,0,190.31,,
85961,1061069-B,0,0,0,190.40,,
85962,1061077-1,0,0,0,171.79,,
85963,1061079-1,0,0,0,171.79,,
85964,1061057,0,0,0,98.49,,
85966,1061017,2,2,0,98.49,,
85967,1061021,2,0,2,102.46,,
85968,1062583,2,0,2,255.90,,
85969,1040665,0,0,0,82.94,,
85970,1040663,3,3,0,99.07,,
85971,1040661,5,3,2,99.07,,
85972,1040643,0,0,0,81.23,,
85973,1040649,5,0,5,81.23,,
85974,1040646,0,0,0,107.47,,
85975,1040655,4,4,0,81.17,,
85976,1040621,0,0,0,62.59,,
85977,1040622,6,2,4,77.47,,
85978,1040623,0,0,0,62.59,,
85979,1040624,0,0,0,62.59,,
85980,1040625,0,0,0,62.59,,
85981,1040628,0,0,0,62.59,,
85982,1040629,4,0,4,62.59,,
85983,1040626,4,2,2,97.40,,
85984,1040627,2,1,1,83.46,,
85985,1040691,2,2,0,156.47,,
85986,1040693,0,0,0,156.47,,
85987,1040697,3,2,1,164.99,,
85988,1040211,5,3,2,35.31,,
85989,1040212,0,0,0,35.31,,
85990,1040213,3,2,1,35.31,,
85991,1040214,2,2,0,35.31,,
85993,1040217,8,2,6,36.93,,
85994,1040216,2,0,2,35.31,,
85999,ASS030530203,6,4,2,11.02,,13.60
86003,FW-40PROA-BK,0,0,0,175.50,,
86008,1615431-1,6,4,2,60.61,,
86009,1615433-1,6,4,2,61.09,,
86010,1630401-1,4,1,3,63.21,,
86011,1612402-A,2,1,1,96.50,,
86012,1632013-A,0,0,0,99.19,,
86013,1612401-A,6,2,4,91.23,,
86014,1632012-A,4,0,4,92.37,,
86015,1611433,3,2,1,150.10,,
86016,1631037,3,1,2,149.24,,
86017,MJUFOXMMB,0,0,0,25.52,,
86018,010-01870-30,0,0,0,279.98,,
86020,010-02334-20,0,0,0,1519.99,,
86022,010-12676-45,0,0,0,26.24,,
86025,010-12676-15,55,21,34,22.49,,
86026,2000033052,0,0,0,278.62,319.99,
86027,27281,4,2,2,66.32,,
86031,010-13069-00,0,0,0,59.99,,
86032,SM-ACC3-GPSA,4,2,2,40.55,,49.91
86033,1100007,8,4,4,12.64,,
86034,1100009,4,4,0,40.03,,
86035,1104010,6,6,0,39.21,,
86036,1100012,17,13,4,32.59,,
86037,1614201-PP,7,4,3,54.61,,
86038,1615201-EC,21,3,18,14.77,,
86039,1615204-EC,12,6,6,13.86,,
86040,1600003,0,0,0,28.56,,
86041,1600005,10,6,4,28.96,,
86043,1600010,2,2,0,43.64,,
86044,1620004,19,10,9,36.59,,
86045,1620005,3,0,3,32.27,,
86046,1100015,6,4,2,14.19,,
86047,1100115,13,7,6,23.50,,
86048,1620001,10,5,5,35.76,,
86049,1620003,0,0,0,36.33,,
86050,1100031-1,4,0,4,34.17,,
86051,1100031-L1,7,3,4,38.76,,
86052,1100300,0,0,0,69.03,,
86053,1840220,44,15,29,62.69,,
86054,1440248,2,1,1,69.60,,
86055,1561105,1,1,0,18.20,,
86056,1561106,2,1,1,21.83,,
86057,1100018,15,0,15,25.36,,
86058,1300750-1,0,0,0,30.89,,
86059,1300751-1,6,1,5,40.99,,
86060,1300901,0,0,0,125.01,,
86061,1300902,0,0,0,127.37,,
86062,1642008,0,0,0,129.49,,
86063,1642005,15,0,15,113.79,,
86064,1603824,6,3,3,79.14,,
86065,1603825,6,4,2,70.34,,
86066,1601002-L,1,1,0,122.11,,
86067,2171004,35,10,25,16.69,,
86068,2171032,37,0,37,10.39,,
86074,134300-701-004-21,1,1,0,263.50,,
86075,132800-500-004-21,12,6,6,201.33,,
86076,132200-701-004-21,4,2,2,153.95,,
86077,132200-100-004-20,7,2,5,153.95,,
86078,122400-100-020-21,8,7,1,49.99,,
86079,122400-100-040-21,3,1,2,34.99,,
86080,122400-100-060-21,2,0,2,60.00,,
86081,121900-505-002-21,6,3,3,28.99,,
86082,121900-500-002-21,0,0,0,33.57,,
86083,121000-200-001-21,0,0,0,33.57,,
86084,121000-600-001-21,0,0,0,33.57,,
86085,121000-400-002-21,0,0,0,29.38,,
86086,121000-500-002-21,0,0,0,33.57,,
86087,120000-200-030-21,0,0,0,33.57,,
86088,120000-200-050-21,1,0,1,23.99,,
86089,120000-200-070-21,0,0,0,33.57,,
86092,DB412,5,3,2,211.21,,
86095,A2C3833110030,0,0,0,81.71,,
86096,A2C3833150030,0,0,0,81.71,,
86097,A2C3916300030,0,0,0,81.79,,
86098,A2C3833440030,0,0,0,81.60,,
86099,A2C3833450030,0,0,0,81.60,,
86100,A2C3833480030,0,0,0,81.60,,
86101,A2C3832710030,0,0,0,81.68,,
86102,A2C3832730030,0,0,0,81.68,,
86103,A2C3833460030,0,0,0,81.60,,
86104,A2C3832720030,0,0,0,81.68,,
86105,A2C3832740030,1,1,0,69.99,,
86106,A2C3833170030,0,0,0,81.72,,
86107,A2C3832690030,0,0,0,81.80,,
86108,A2C3832700030,0,0,0,81.80,,
86109,A2C3833160030,0,0,0,81.72,,
86110,A2C3833230030,0,0,0,81.72,,
86111,A2C3833490030,0,0,0,81.60,,
86112,A2C3833040030,0,0,0,87.73,,
86113,A2C3833050030,0,0,0,87.85,,
86114,A2C3833520030,0,0,0,81.60,,
86115,A2C3833510030,0,0,0,81.60,,
86116,A2C3916310030,0,0,0,81.60,,
86117,A2C3833380030,0,0,0,81.60,,
86118,A2C3833410030,3,2,1,81.60,,
86119,A2C3833320030,1,0,1,72.99,,
86120,ST9ATP,2,2,0,996.68,,
86121,A2C3833330030,2,0,2,69.99,,
86122,A2C3833530030,0,0,0,81.60,,
86123,A2C3833470030,0,0,0,81.60,,
86124,A2C3833390030,0,0,0,81.60,,
86125,A2C3832910030,0,0,0,162.57,,
86126,136300-701-999-19,12,0,12,19.33,,
86127,135700-701-999-19,0,0,0,16.88,,
86128,A2C3832930030,0,0,0,162.63,,
86129,A2C3832940030,0,0,0,162.57,,
86130,A2C3832950030,0,0,0,162.57,,
86131,A2C3832880030,0,0,0,162.63,,
86132,A2C3832890030,0,0,0,162.83,,
86133,A2C3832960030,0,0,0,162.57,,
86134,A2C3832970030,0,0,0,162.57,,
86137,A2C3833000030,0,0,0,162.57,,
86138,A2C3833020030,2,2,0,162.57,,
86140,A2C3832860030,0,0,0,167.77,,
86141,A2C3832850030,0,0,0,167.77,,
86142,A2C3832840030,0,0,0,167.77,,
86143,A2C3832830030,0,0,0,167.77,,
86144,A2C3832870030,1,1,0,167.77,,
86145,A2C3832820030,0,0,0,167.77,,
86146,A2C3832810030,1,0,1,167.77,,
86147,A2C3832800030,0,0,0,167.77,,
86148,A2C3832790030,0,0,0,167.77,,
86149,A2C1800340030,0,0,0,81.91,,
86150,ITR050362041,4,2,2,511.93,,631.55
86154,CS2661701,6,2,4,33.66,,
86159,HW-ASSY-2.0SPKR,2,1,1,82.59,,
86165,80-600-0027-00,0,0,0,383.23,,
86166,PMP123021010,2,0,2,1150.63,,1419.50
86167,MOFCKIT4,0,0,0,103.13,,
86168,MOFCKIT8,1,1,0,56.73,,
86169,A2C59514230,0,0,0,38.83,54.89,
86170,000-15593-001,2,2,0,859.14,,999.00
86177,A10-228,0,0,0,28.13,,
86178,A10-224,0,0,0,28.13,,
86179,10-960-R,2,2,0,18.56,,
86180,HG1000G,2,0,2,147.88,256.45,
86197,010-13009-00,0,0,0,37.49,,
86198,010-13009-01,0,0,0,37.49,,
86199,010-13009-07,0,0,0,37.49,,
86200,010-13009-02,0,0,0,18.74,,
86201,010-13009-03,3,3,0,18.74,,
86202,010-13009-04,0,0,0,37.49,,
86203,010-13009-05,0,0,0,22.49,,
86204,010-13009-06,0,0,0,37.49,,
86206,010-11051-20,10,8,2,314.99,,
86208,010-01248-90,2,0,2,974.99,,
86209,010-01248-70,0,0,0,1087.49,,
86211,51300,59,25,34,7.98,,
86212,51310,25,11,14,7.98,,
86216,010-12530-01,0,0,0,19.99,,
86217,HG500,2,0,2,98.60,170.95,
86234,ZDIGNAVDOC,4,2,2,337.50,,
86236,FAP3011,0,0,0,760.00,,
86244,G200924,0,0,0,11.90,,
86245,A06073,0,0,0,21.30,,
86249,SC-CW-07E,1,1,0,42.33,,
86259,18500000,2,0,2,123.59,,
86260,010-10925-00,0,0,0,25.20,,
86262,600-881,0,0,0,6.94,,
86272,RF4012,0,0,0,24.67,33.96,
86273,RF4013,2,0,2,61.11,84.15,
86274,RF4014,0,0,0,73.46,101.15,
86275,RF4015,0,0,0,73.46,101.15,
86276,PUMPOCT16-12,0,0,0,400.00,,
86279,9283.4,0,0,0,419.18,,
86289,2920,0,0,0,274.13,,
86290,65F3B,0,0,0,277.78,,
86293,FGBT11025120T00,0,0,0,1139.83,,
86294,FGBT12530120T00,0,0,0,1310.43,,
86295,FGBT12540120T00,0,0,0,1437.48,,
86296,FGBT14030120T00,0,0,0,1546.39,,
86297,FGBT14040120T00,0,0,0,1614.63,,
86298,FGBT18055120T00,0,0,0,1814.28,,
86308,510R,4,2,2,10.65,,
86314,303303050WH-1,0,0,0,1.94,,
86315,303304050-1,3,3,0,3.08,,
86316,303305050-1,0,0,0,3.94,,
86320,03-212-312,0,0,0,642.50,822.40,
86323,SCM-10-EXT-CC-20,5,4,1,499.00,,699.00
86331,CLPX2T3/BK,6,1,5,45.64,,76.95
86332,CLPX2T3/WH,0,0,0,45.64,,76.95
86335,TMBRX/WH,0,0,0,22.95,,37.95
86336,TMBRX/BK,0,0,0,22.95,,37.95
86337,FLMBX/WH,0,0,0,39.46,,64.95
86338,FLMBX/BK,0,0,0,39.46,,64.95
86341,T5H591,2,2,0,32.68,,
86342,T5K822,1,1,0,34.40,,
86343,TW4B14200,0,0,0,35.55,,
86361,A80674,7,6,1,38.34,,
86362,A80675,6,0,6,38.34,,
86376,MIUL10WHT,1,0,1,74.99,,
86383,MIUS5WHT,2,0,2,34.99,,
86397,SIL16,2,0,2,69.99,,
86400,"ALPHA 6",1,0,1,59.99,,
86401,MIU60WHT,2,0,2,819.99,,
86412,HG250,2,0,2,71.41,83.60,
86416,0289,6,6,0,20.21,,
86417,0290,10,1,9,21.63,,
86420,93806YUS7,4,1,3,38.45,,
86422,000-15793-001,0,0,0,1547.14,,1799.00
86429,KPB30A,1,0,1,133.93,,
86430,KPB30B,0,0,0,133.93,,
86431,KPB30C,0,0,0,159.07,,
86432,KPB60A,1,1,0,159.07,,
86433,KPB60B,1,0,1,159.07,,
86434,KPBQCKA,0,0,0,66.96,,
86435,KPBQCKB,0,0,0,66.96,,
86437,KPPC,4,2,2,8.64,,
86438,KPP100B,0,0,0,83.69,,
86439,KPP100W,6,5,1,83.69,,
86440,KPP120B,1,0,1,93.75,,
86441,KPP120W,7,4,3,93.75,,
86444,FS800IR,1,1,0,310.00,,379.95
86445,KPP802B,2,1,1,75.33,,
86446,KPP802W,4,2,2,75.33,,
86449,KPS25B,2,1,1,117.20,,
86451,KPS50A,1,0,1,125.57,,
86452,KPS50B,0,0,0,125.57,,
86464,M5-7A-4342-8,17,11,6,68.40,,
86467,85-B203STN,3,3,0,476.41,,
86468,85-B203MAR,2,2,0,48.69,,
86469,75-7060B,6,0,6,38.90,,
86470,75-7061,0,0,0,15.73,,
86471,55-9200,5,0,5,30.00,,
86472,55-9300,5,5,0,41.21,,
86473,55-9400,4,4,0,45.91,,
86474,55-9500,4,4,0,18.49,,
86475,55-9600,3,3,0,35.23,,
86476,165T/275LHW-12P,4,4,0,3288.89,,
86477,1245SC,8,4,4,38.46,,
86490,FI5001/30M,1,0,1,573.33,,
86499,63106,4,2,2,9.98,,
86504,INFR3000,22,7,15,152.00,269.95,
86518,C30253W,0,0,0,202.18,282.20,
86519,C30503W,1,1,0,273.44,381.65,
86532,010-02551-04,0,0,0,359.99,,
86543,M5-7A-4261-8,17,0,17,52.99,,
86544,KG-1BL-PR,8,4,4,37.33,47.60,
86546,W744,1,1,0,48.49,,
86551,69390,2,2,0,107.13,,
86552,53083,0,0,0,8.85,,
86553,53086,15,2,13,8.23,,
86554,53092,0,0,0,8.85,,
86555,53093,5,2,3,8.23,,
86556,51904,5,4,1,10.25,,
86557,51905,0,0,0,10.91,,
86558,41980,9,6,3,45.73,,
86559,41982,9,0,9,47.99,,
86560,41983,5,1,4,25.90,,
86561,41985,0,0,0,41.95,,
86562,41986,20,4,16,7.50,,
86563,41987,7,6,1,13.96,,
86565,YBP-0306,0,0,0,26.36,,37.98
86566,69004,1,1,0,189.86,,
86567,69005,3,1,2,213.61,,
86568,69002,3,2,1,143.17,,
86569,69003,9,6,3,165.76,,
86570,69341,0,0,0,19.09,,
86571,69300,0,0,0,13.71,,
86572,69301,3,3,0,19.23,,
86573,69310,12,6,6,29.50,,
86574,69311,7,6,1,35.04,,
86576,A-4-GREY,12,3,9,100.09,,
86577,A-5-GREY,3,3,0,211.54,,
86582,A-2-GREY,0,0,0,53.07,,
86583,A-3-GREY,11,9,2,71.04,,
86585,32305-5012-3A,8,5,3,112.89,,
86586,Q401J-118N-3A,11,7,4,138.38,,
86587,Q401J-118N-4A,10,7,3,160.22,,
86588,P501J-119N-3A,10,3,7,174.80,,
86589,P601J-219N-3A,14,11,3,193.01,,
86590,P601J-219N-4A,13,5,8,214.85,,
86591,Q402J-118N-3A,4,1,3,160.22,,
86593,P602J-219N-3A,3,1,2,214.85,,
86594,6220,2,0,2,41.21,60.15,
86595,6221,2,0,2,72.10,105.25,
86596,6280,0,0,0,220.34,321.70,
86597,6277,0,0,0,144.25,210.60,
86610,42630-3512-3C,5,3,2,72.83,,
86611,31295-3512-3A,9,2,7,91.04,,
86612,31395-2512-3A,7,4,3,98.32,,
86614,31395-4012-3A,16,12,4,98.32,,
86616,SKI024080002,0,0,0,1090.00,,1344.70
86620,Q301J-115S-3A,12,11,1,120.17,,
86621,Q301J-118S-3A,4,2,2,120.17,,
86622,Q401J-115S-3A,21,12,9,142.02,,
86623,Q401J-118S-3A,15,6,9,142.02,,
86624,P501J-115S-3A,10,4,6,174.80,,
86625,P501J-118S-3A,7,4,3,174.80,,
86626,P601J-215S-3A,2,2,0,189.36,,
86627,P601J-218S-3A,7,2,5,189.36,,
86628,31295-3524-3A,12,7,5,112.89,,
86629,31395-2524-3A,6,6,0,120.17,,
86630,31395-4024-3A,17,13,4,120.17,,
86632,010-02316-10,30,12,18,236.24,,
86634,010-02316-00,0,0,0,236.24,,
86636,Q402J-115S-3A,6,2,4,163.88,,
86653,Q402J-118S-3A,5,2,3,163.88,,
86654,P602J-215S-3A,9,5,4,211.21,,
86655,P602J-218S-3A,8,1,7,208.63,,
86659,03-114-200,0,0,0,306.88,392.80,
86660,03-114-214,0,0,0,306.88,392.80,
86662,03-114-212,0,0,0,306.88,392.80,
86663,03-112-214,0,0,0,401.25,513.60,
86664,03-112-212,0,0,0,401.25,513.60,
86665,03-134-300,0,0,0,455.00,582.40,
86666,03-134-312,0,0,0,455.00,582.40,
86667,03-200-300,0,0,0,523.75,670.40,
86668,03-200-312,0,0,0,523.75,670.40,
86669,03-214-312,0,0,0,642.50,822.40,
86670,03-214-400,0,0,0,642.50,822.40,
86671,03-212-400,0,0,0,642.50,822.40,
86672,03-300-412,0,0,0,884.38,1132.00,
86673,03-312-500,0,0,0,1440.63,1844.00,
86686,6500-WB,0,0,0,190.69,,
86708,50180,13,11,2,192.55,,
86713,50182,5,3,2,255.75,,
86714,50184,0,0,0,277.50,,
86715,50186,1,0,1,383.73,,
86716,SA-340-BL,3,3,0,43.69,,
86717,SA-340-WT,0,0,0,43.69,,
86753,22911,5,1,4,98.50,,
86799,FWGB-100-RB,1,1,0,95.63,,
86819,TSP-1-DP,3,3,0,22.01,,
86820,TSP-2-DP,20,5,15,18.29,,
86821,1377605,3,3,0,556.88,,
86853,96604,0,0,0,9.08,12.16,
86854,96607,2,0,2,5.69,7.62,
86864,PIN123020000,2,0,2,774.44,,955.40
86868,1544,0,0,0,183.23,261.95,
86870,1540,0,0,0,96.07,136.95,
86871,1542,0,0,0,128.53,183.95,
86872,010-13072-00,0,0,0,314.99,,
86873,010-13073-00,43,17,26,356.24,,
86876,1902340X2/COVERS,6,4,2,2846.63,,
86877,1902335X2/COVERS,6,3,3,2545.49,,
86878,010-12989-00,0,0,0,14.99,,
86879,010-12989-01,4,1,3,18.74,,
86880,010-12989-02,0,0,0,18.74,,
86881,010-12990-00,0,0,0,14.99,,
86882,010-12992-00,0,0,0,22.49,,
86883,010-12993-00,0,0,0,22.49,,
86884,010-12990-01,0,0,0,18.74,,
86885,010-12992-01,0,0,0,26.24,,
86886,010-12993-01,1,0,1,22.49,,
86887,010-12990-02,0,0,0,18.74,,
86888,010-12992-02,2,2,0,29.98,,
86889,010-12993-02,3,0,3,29.98,,
86890,010-02246-02,0,0,0,143.99,,
86891,010-02246-00,0,0,0,103.99,,
86894,AT-85810,1,0,1,8.99,,
86895,AT-388,0,0,0,74.32,,
86896,88100,0,0,0,125.29,,
86898,37161,3,3,0,110.37,,
86901,RMC-101FMK-DP,0,0,0,92.32,,
86902,RMC-101MG-DP,1,1,0,123.71,,
86903,RMC-101MK-DP,2,2,0,92.32,,
86904,RMC-104FMK-DP,2,1,1,92.32,,
86905,RMC-105FMK-DP,2,0,2,92.32,,
86906,RMC-109-DP,5,3,2,115.46,,
86907,RMC-108-DP,5,2,3,108.81,,
86908,MNC-1200,0,0,0,956.82,,
86909,MNC-1250,0,0,0,1326.14,,
86960,150800-200-070-20,0,0,0,57.60,,
86971,101037,13,2,11,90.71,,
86976,CEC34,3,3,0,32.61,,
86977,CEC10,36,12,24,8.07,,
86978,ZDIGDST810,3,1,2,374.96,,
86979,CEC15,9,4,5,18.91,,
86980,CEC25,0,0,0,25.59,,
86981,CEC50,0,0,0,46.84,,
86982,CEC75,0,0,0,61.73,,
86983,31300006,88,30,58,12.61,15.99,
86984,BPC123048102,4,4,0,166.74,,205.70
86986,010-12225-10,0,0,0,29.98,,
86987,010-13071-00,5,2,3,18.74,,
86988,010-13070-00,0,0,0,22.49,,
86989,22610-9427,4,2,2,297.59,,
86990,100-298-436-10,0,0,0,13.64,,
86992,010-12100-11,0,0,0,8.00,,
86993,010-12100-12,0,0,0,8.00,,
86994,010-12100-13,0,0,0,8.00,,
86997,S-0627C,3,1,2,89.86,,
86998,S-0628C,0,0,0,89.86,,
86999,S-0629C,0,0,0,89.86,,
87002,301-011KLST-B,0,0,0,1618.64,,2063.77
87010,CX4A,3,2,1,127.50,,
87011,E179F,2,1,1,45.00,,
87012,ZDIGCLA2000/BUNDLE,1,0,1,2062.46,,
87013,83012031,0,0,0,184.73,,
87017,OCTAFG2012,0,0,0,645.50,,
87018,OCTAFG2024,1,1,0,645.50,,
87029,B00042501,1,0,1,185.45,214.19,
87030,B00043901,1,1,0,92.73,107.09,
87031,010-12097-00,0,0,0,37.49,,
87033,G-GATE-G,0,0,0,951.67,,
87044,SCC110020160R,0,0,0,72.34,,89.25
87055,LLB-70SL-01-00,0,0,0,6.92,,
87056,LLB-63CT-01-00,0,0,0,65.85,,
87057,LLB-63AU-01-00,0,0,0,25.24,,
87058,209FDP,3,2,1,154.01,,
87061,010-13014-00,3,1,2,94.99,,
87062,MC-618-H,0,0,0,267.82,328.00,
87063,SG205,3,0,3,155.46,183.00,
87064,SG210,3,0,3,233.59,275.00,
87065,TP1003,1,1,0,6.99,,
87069,VTC300-32-12,0,0,0,499.38,,
87070,BCA1000V-110-32,0,0,0,1248.86,,
87071,BCA1550-12,2,0,2,1604.74,,
87072,BCA1550-24,0,0,0,1604.74,,
87097,29295-1000,1,0,1,16.90,,
87098,29295-1010,9,4,5,16.90,,
87105,23610-3003,2,0,2,355.17,,
87110,RM12,2,1,1,66.65,,
87174,944113,2,2,0,125.00,199.99,
87177,701513,0,0,0,143.74,229.99,
87249,DST-810MSF,0,0,0,377.78,,
87257,MRX-EXT20,0,0,0,14.56,,26.95
87285,C1000CH,0,0,0,31.51,,
87286,LED1000,0,0,0,15.41,,
87287,FP36,0,0,0,41.10,54.99,
87288,FP36USA,3,0,3,43.84,60.99,
87289,FP36DIVE,0,0,0,43.84,60.99,
87290,FP72,0,0,0,43.84,57.99,
87291,FP72USA,0,0,0,46.58,62.99,
87292,FP72DIVE,0,0,0,46.58,62.99,
87294,240-864,0,0,0,3.29,,
87321,BOWA0571,1,0,1,3121.88,4163.00,
87322,331-546,3,3,0,27.84,,
87348,260-15270,0,0,0,38.05,,
87349,260-15271,0,0,0,38.05,,
87350,301-15278,0,0,0,16.19,,
87351,A2C1767000001,0,0,0,462.86,534.59,
87352,UPLI30BB,1,1,0,726.00,,849.95
87354,A2C1824820001,0,0,0,278.18,321.29,
87355,310-15277,0,0,0,16.19,,
87356,332-15282,0,0,0,16.19,,
87357,333-11915,0,0,0,56.20,,
87358,333-15273,0,0,0,56.20,,
87359,333-15272,0,0,0,56.20,,
87360,333-15274,0,0,0,56.20,,
87361,333-15275,0,0,0,56.20,,
87362,350-15276,0,0,0,16.19,,
87363,382-11805,0,0,0,43.08,,
87364,382-15279,0,0,0,16.19,,
87365,382-15280,0,0,0,16.19,,
87366,382-15281,0,0,0,43.08,,
87367,150-15283,0,0,0,26.67,,
87368,TBB-100,0,0,0,134.48,,
87369,FMX3000,0,0,0,470.00,,560.95
87370,GPX28PV,0,0,0,568.00,,669.95
87372,V-100L,6,6,0,60.00,,
87373,V-120L,0,0,0,86.25,,
87374,APL17290S1,10,5,5,25.99,,
87375,APL20458,11,6,5,33.99,,
87377,APL19977,0,0,0,33.99,,
87378,301-011KL-B,0,0,0,1078.09,,1374.56
87379,APL16997P2,9,3,6,61.99,,
87380,APL17014S2,6,3,3,47.99,,
87381,APL17011S2,6,5,1,66.99,,
87382,APL17013S2,1,0,1,104.99,,
87388,AQX20389,7,5,2,11.61,,
87389,AQX19075P3,4,1,3,26.39,,
87392,DPX5976S1L,4,2,2,29.99,,
87393,DPX18230S3M,5,3,2,34.99,,
87394,DPX18230S4L,0,0,0,52.78,,
87395,APL20415,11,5,6,54.99,,
87396,APL19981,13,10,3,74.99,,
87397,APL20416,10,8,2,104.99,,
87399,APL20125,24,12,12,94.99,,
87400,APL19980,1,0,1,139.99,,
87401,B00042201,5,3,2,92.73,107.09,
87402,B00042301,0,0,0,250.91,289.79,
87404,B00070401,0,0,0,278.18,321.29,
87405,B00042401,2,2,0,111.43,128.69,
87408,PST13365S1,15,15,0,8.99,,
87409,PST13365S2,3,0,3,10.99,,
87488,710304-1,23,18,5,1266.71,,1499.99
87497,OT-4200CF-HD,2,2,0,2689.62,,
87500,PLABW150,0,0,0,11.21,,
87501,PLABW160,4,4,0,16.49,,
87502,PLABW170,4,4,0,21.77,,
87503,PLABW250,4,4,0,17.81,,
87504,PLABW260,0,0,0,23.09,,
87505,PLABW270,3,3,0,28.37,,
87506,PLABW350,3,3,0,23.09,,
87507,PLABW360,2,2,0,26.39,,
87508,PLABW370,0,0,0,32.99,,
87509,PLABW460,0,0,0,39.59,,
87510,PLABW470,0,0,0,52.79,,
87511,PLABZ100,2,0,2,21.59,,
87512,PLABZ360,0,0,0,57.59,,
87513,PLABZ370,0,0,0,71.99,,
87514,PLABZ400,0,0,0,86.39,,
87515,PLABZ500,1,1,0,86.39,,
87516,PLASE350,0,0,0,15.00,,
87517,PLASE300,12,0,12,30.00,,
87518,PLASE366,0,0,0,27.00,,
87519,PLASE377,2,2,0,33.00,,
87520,PLASM364,0,0,0,16.80,,
87521,PLASW374,1,1,0,21.83,,
87544,B00043501,6,1,5,94.03,114.29,
87552,101647,9,4,5,120.91,,
87553,101648,4,2,2,195.26,,
87554,101649,2,2,0,266.91,,
87555,101650,2,2,0,321.13,,
87556,101680,0,0,0,1317.02,,
87565,AQL11310SSP,6,2,4,23.75,,
87578,"P13228-202 PCWT",1,1,0,32.99,,
87579,"P13228-204 PCWT",3,1,2,19.99,,
87582,P12848-100,1,0,1,274.99,,
87583,"P12848-100 GR",0,0,0,322.40,,
87584,P12848-200,4,2,2,161.19,,
87585,P12848-300,0,0,0,80.57,,
87586,P13005-100,3,2,1,80.57,,
87587,P13371-300TEBCL,0,0,0,201.49,,
87588,P13371-300TEBBK,2,1,1,201.49,,
87589,P13371-300TEBGR,1,0,1,184.99,,
87590,P13371-320TEBCL,0,0,0,201.49,,
87591,P13371-320TEBBK,0,0,0,201.49,,
87592,P13371-360TEBBK,0,0,0,201.49,,
87593,P13371-360TEBGR,0,0,0,201.49,,
87594,P12848-250,0,0,0,242.53,,
87595,P12848-350,10,6,4,161.15,,
87596,P13020-100,2,2,0,54.99,,
87597,"P13020-100 BK",0,0,0,92.97,,
87598,P12902-100,3,2,1,49.99,,
87599,"P12902-100 BK",0,0,0,83.66,,
87600,MS-140,1,1,0,40.27,,
87601,MS-100,3,1,2,32.21,,
87602,P12848-13,0,0,0,46.46,,
87603,P13228-02,2,2,0,12.99,,
87604,P12848-33,0,0,0,37.17,,
87605,"P12848-36 BK",0,0,0,4.62,,
87606,P12682-58,0,0,0,11.12,,
87607,"P12682-58 BK",0,0,0,11.12,,
87608,"P12682-58 GR",0,0,0,11.12,,
87609,P13157-105,0,0,0,27.86,,
87610,"P13157-105 BK",0,0,0,27.86,,
87611,B00001201,0,0,0,25.71,29.69,
87612,A2C17593300,0,0,0,8.31,9.53,
87615,B00067401,2,1,1,167.40,203.39,
87622,101672,18,0,18,114.63,,
87623,101673,0,0,0,114.63,,
87624,101670,3,3,0,114.63,,
87625,101671,0,0,0,114.63,,
87627,MC-TS-A80,0,0,0,33.16,40.99,
87628,01-92-083,4,2,2,14.63,,
87629,01-92-084,4,2,2,21.95,,
87630,01-92-086,4,2,2,23.87,,
87631,09-01-035,0,0,0,388.80,,
87633,5505-7,15,8,7,44.14,,
87634,5508-7,11,3,8,68.11,,
87635,5509-7,4,1,3,71.98,,
87636,5512-7,21,11,10,79.96,,
87637,5513-7,8,4,4,83.85,,
87638,SCC115070211,6,4,2,310.05,,382.50
87641,JBLR3500,0,0,0,188.55,269.95,
87660,LHRF30ASSY,4,4,0,73.08,102.00,
87663,UBB2,4,0,4,72.95,89.99,
87664,MC-TS-B30,3,0,3,43.71,53.99,
87665,SG2-0403,0,0,0,48.22,54.99,
87666,SG2-0404,0,0,0,28.40,32.99,
87668,202213BLK,0,0,0,148.06,236.89,
87669,HT471TG,0,0,0,98.75,,
87672,930314,0,0,0,579.37,926.99,
87674,LLB-26LC-61-00,0,0,0,10.75,,
87682,15-TSS,0,0,0,65.71,80.99,
87683,C1-70-A00S,0,0,0,5607.78,7196.00,
87684,C1-70-A00R,0,0,0,5880.00,7596.00,
87688,24104,0,0,0,53.89,,
87689,25104,1,1,0,44.43,,
87690,24105,2,2,0,53.30,,
87691,25105,0,0,0,57.75,,
87692,36211201,0,0,0,657.60,,822.00
87693,45513040,0,0,0,347.33,,
87695,35511500,2,2,0,900.80,,1126.00
87696,35513500,3,3,0,1541.70,,
87697,35523500,4,2,2,1699.83,,
87699,TC861,6,6,0,7.41,,
87700,TC862,0,0,0,7.41,,
87701,TK860,6,5,1,19.65,,
87702,710010,0,0,0,24.25,,
87703,710020,0,0,0,20.78,,
87704,710030,0,0,0,24.25,,
87705,710040,0,0,0,22.87,,
87706,711000,0,0,0,34.64,,
87707,703041,0,0,0,22.67,,
87708,703042,0,0,0,25.48,,
87709,262245,7,5,2,3.49,,
87710,262255,17,3,14,4.06,,
87711,262265,8,5,3,4.64,,
87712,262275,4,2,2,5.20,,
87713,262285,2,0,2,5.78,,
87714,A2C59512947,0,0,0,11.69,13.49,
87715,262295,7,4,3,6.35,,
87716,262715,6,4,2,7.79,,
87717,262725,3,0,3,9.50,,
87718,262246,6,3,3,3.49,,
87719,262256,7,4,3,4.06,,
87720,262266,7,5,2,4.64,,
87721,262276,6,4,2,5.20,,
87722,262286,4,2,2,5.78,,
87723,262296,2,2,0,6.35,,
87724,262716,7,2,5,7.79,,
87725,262726,9,7,2,9.50,,
87728,242130,3,2,1,20.99,,
87729,242140,0,0,0,30.60,,
87730,242150,2,0,2,35.99,,
87731,242160,0,0,0,51.15,,
87732,242170,0,0,0,51.15,,
87735,242180,0,0,0,66.96,,
87737,SEA3000,5,3,2,177.61,,
87738,AIR129,0,0,0,466.44,,
87739,"CANBUS W SYS",1,1,0,304.77,,
87740,129OBI,3,2,1,702.84,,
87741,189OBI,1,1,0,785.28,,
87742,249OBI,2,0,2,764.89,,
87743,309OBI,0,0,0,835.00,,
87744,1212OBI,3,2,1,744.68,,
87745,1812OBI,2,1,1,773.03,,
87746,2412OBI,2,1,1,828.72,,
87747,3012OBI,0,0,0,855.56,,
87748,M80OBI,4,2,2,699.95,,
87749,M120OBI,1,0,1,823.94,,
87750,ST9OBI,5,3,2,830.36,,
87751,ST12OBI,2,0,2,1016.11,,
87752,ST16OBI,2,1,1,1142.06,,
87756,LHRF50ASSY,0,0,0,92.56,129.20,
87757,RF30,2,1,1,54.21,75.65,
87758,RF50,1,1,0,73.08,102.00,
87761,CM30253,3,3,0,292.31,408.00,
87762,CM30503,0,0,0,351.99,491.30,
87763,CM50254,0,0,0,589.49,822.80,
87764,CM50504,0,0,0,686.92,958.80,
87767,RDPWL,3,3,0,37.15,51.85,
87768,RDPWP,2,2,0,37.15,51.85,
87770,USB-1,14,12,2,24.98,,
87780,B00034901,0,0,0,124.42,151.19,
87781,B00041601,2,0,2,79.99,124.19,
87782,B00041701,0,0,0,181.43,220.49,
87790,BOS12V4,0,0,0,305.37,,
87792,3000P-10,0,0,0,146.55,,
87793,3001P-10,0,0,0,156.18,,
87794,3002P-10,0,0,0,174.69,,
87795,3005P-10,0,0,0,139.31,,
87796,3006P-10,0,0,0,162.63,,
87797,3008P-10,0,0,0,184.31,,
87798,3009P-10,0,0,0,157.49,,
87799,3010P-10,0,0,0,159.03,,
87804,1001P-10,0,0,0,88.24,,
87805,1002P-10,0,0,0,91.36,,
87806,1003P-10,0,0,0,94.53,,
87815,V11-9990GRD80-2,2,0,2,641.49,,
87818,MSK-10A,0,0,0,36.36,52.50,
87819,NTX-1000-12,0,0,0,266.14,384.10,
87820,NTX-1500-12,3,3,0,324.89,468.90,
87821,NTX-2000-12,2,2,0,389.43,562.10,
87822,NTX-3000-12,1,1,0,544.09,785.20,
87823,NTX-RC,2,2,0,33.18,47.80,
87825,010-10962-10,0,0,0,47.99,,
87826,010-12825-00,0,0,0,39.99,,
87827,010-12825-02,0,0,0,79.98,,
87828,010-12941-01,0,0,0,15.99,,
87829,010-11828-03,0,0,0,38.99,,
87830,010-11828-40,0,0,0,27.99,,
87831,010-11864-00,0,0,0,27.99,,
87832,010-11925-00,0,0,0,31.99,,
87833,010-12881-05,0,0,0,79.98,,
87864,323-421,0,0,0,11.08,,
87868,60-YP-MC-100-SV,1,0,1,755.69,925.00,
87869,60-YP-MC-100-J10,2,0,2,755.69,925.00,
87876,GP1900-15,0,0,0,318.06,,
87877,RC108CAP12V,0,0,0,1892.65,2681.00,
87880,SKY012070000,4,2,2,615.28,,759.05
87881,SKY012070100,1,1,0,677.98,,836.40
87882,SKY024035000,4,2,2,615.28,,759.05
87883,SKY024035100,3,1,2,677.98,,836.40
87885,PP5920-03,0,0,0,414.53,,
87886,REC000300010R,3,1,2,106.11,,130.90
87887,ASS030543020,4,1,3,175.69,,216.75
87892,BPC122547106,7,4,3,144.00,,177.65
87893,010-12881-08,0,0,0,79.98,,
87894,010-12881-03,0,0,0,119.99,,
87895,010-12881-01,0,0,0,39.99,,
87907,GP1392,20,15,5,32.60,,
87908,A3000/CVR-INF,0,0,0,20.05,,
87909,A3000/CVR-JBL,0,0,0,20.05,,
87916,SM-ACC-ACRE-120,2,0,2,56.61,,69.67
87923,A2K-KIT-3,0,0,0,153.80,,
87926,DDC,1,0,1,52.50,,
87932,DB1-20,0,0,0,103.52,,
87938,25000,10,5,5,35.30,,
87939,25001,7,1,6,35.30,,
87940,25002,11,5,6,35.30,,
87941,25003,6,5,1,35.30,,
87942,25004,5,5,0,49.99,,
87943,25005,0,0,0,37.03,,
87944,25006,3,3,0,49.14,,
87945,25007,1,1,0,32.99,,
87946,25008,0,0,0,68.13,,
87947,25009,10,5,5,35.30,,
87948,25010,0,0,0,52.39,,
87949,25011,0,0,0,41.39,,
87950,45000,0,0,0,170.39,,
87951,45001,0,0,0,206.04,,
87952,45002,0,0,0,82.99,,
87953,45003,0,0,0,82.99,,
87954,45004,4,2,2,123.54,,
87955,45005,0,0,0,123.54,,
87956,45006,0,0,0,143.31,,
87957,45007,1,1,0,130.45,,
87958,45008,4,4,0,56.68,,
87959,45009,0,0,0,84.00,,
87960,45010,3,0,3,56.43,,
87962,45012,4,0,4,105.64,,
87963,45013,0,0,0,130.46,,
87964,KTF0200,1,1,0,284.84,,
87965,KTF0201,3,1,2,174.99,,
87967,FSC190,0,0,0,103.45,,
87968,KTF052,5,5,0,7.99,,
87969,KTF053,17,17,0,10.99,,
87970,940700270,2,1,1,741.27,,
87971,940700280,0,0,0,1160.99,,1349.99
87974,810074,36,24,12,22.67,47.97,
87975,890164,34,29,5,28.90,43.97,
87978,9108849515,0,0,0,89.64,,
87985,784-0110S,2,2,0,328.42,,
87986,784-0220,0,0,0,734.12,,
87987,784-0330,0,0,0,1102.35,,
87988,708-0150,2,1,1,96.05,,
87989,818-2015,4,4,0,1075.17,,
87990,818-3015,16,6,10,1325.03,,
87991,820-4080-41,0,0,0,2357.20,,
87992,9108836052,1,0,1,448.20,,
88006,9600005997,0,0,0,201.92,,
88041,709-3024-01,0,0,0,114.14,,
88042,710-3024-01,2,1,1,224.12,,
88043,710-0010,0,0,0,57.07,,
88048,GS-500XL,1,1,0,3169.23,,
88050,A80691,1,1,0,149.99,,
88052,A80585,0,0,0,116.66,,
88053,A80630,0,0,0,119.31,,
88055,001-512-600-00,0,0,0,127.27,,
88058,MK4,0,0,0,30.03,,
88060,TCK4,0,0,0,22.11,,
88064,APX21-BK/DK,11,8,3,68.18,92.99,
88068,BHCR10BO-BL,0,0,0,11.12,,
88074,683-150,5,5,0,54.00,,
88075,683-100,1,1,0,52.45,,
88076,682-080,0,0,0,115.30,,
88077,683-080,2,2,0,38.44,,
88078,683-060,3,3,0,28.28,,
88079,3000S-02,1,1,0,104.99,,
88080,FMS-1-0-DP,0,0,0,11.81,,
88081,682-060,0,0,0,84.77,,
88082,683-050,9,9,0,24.20,,
88083,682-050,3,3,0,72.65,,
88085,3001S-02,0,0,0,170.45,,
88086,3002S-02,0,0,0,190.65,,
88087,3005S-02,0,0,0,152.04,,
88088,3006S-02,0,0,0,177.50,,
88090,3008S-02,0,0,0,201.19,,
88092,3009S-02,0,0,0,171.89,,
88093,3010S-02,0,0,0,173.59,,
88094,2000S-02,0,0,0,109.16,,
88095,2001S-02,0,0,0,118.46,,
88096,2002S-02,0,0,0,146.34,,
88099,RLFP122202A,5,3,2,70.38,,
88101,1000S-02,1,1,0,72.99,,
88102,R3526144D,38,28,10,76.48,,
88103,1001S-02,0,0,0,101.96,,
88104,R3526344D,1,1,0,99.78,,
88106,1002S-02,0,0,0,105.61,,
88107,SSRS#1VP,6,6,0,8.34,,
88108,Q301V-117S-3A,6,3,3,109.25,,
88109,1003S-02,0,0,0,109.26,,
88110,1004S-02,0,0,0,120.20,,
88111,SSRS#2VP,6,6,0,8.34,,
88112,Q401V-117S-3A,8,5,3,142.02,,
88113,SSRS#3VP,0,0,0,8.34,,
88115,9000S-02,2,2,0,39.99,,
88116,Q402V-117S-3A,3,2,1,163.88,,
88117,9001S-02,4,4,0,39.99,,
88118,9002S-02,2,2,0,59.99,,
88119,9003S-02,1,1,0,49.99,,
88120,SSRS#4VP,0,0,0,8.34,,
88121,SSRS#5VP,0,0,0,8.34,,
88122,9004S-02,1,1,0,49.99,,
88123,SSRS#6VP,0,0,0,8.34,,
88124,9005S-02,2,2,0,49.99,,
88125,SSRS#8VP,5,5,0,8.34,,
88126,SSRS#10VP,3,3,0,8.34,,
88129,JL-655-50-BLK,2,2,0,19.25,,
88130,BSHBTSS#6,15,15,0,7.65,,
88131,BSHBTSS#5,11,11,0,7.65,,
88132,BSHBTSS#4,0,0,0,7.65,,
88133,BSHBTSS#3,0,0,0,7.65,,
88134,BSHBTSS#2,1,1,0,7.65,,
88135,BSHBSWR#5,0,0,0,6.39,,
88136,BSHBSWR#4,0,0,0,6.39,,
88137,BSHBSWR#3,0,0,0,6.39,,
88138,BSHBSWR#2,0,0,0,6.39,,
88139,BSHBSWR#1,0,0,0,6.39,,
88140,9108824491,0,0,0,430.96,,
88141,9108834578,0,0,0,441.35,,
88142,9108832318,0,0,0,430.96,,
88143,385311997,0,0,0,39.34,,
88146,9108824451,1,0,1,415.38,,
88147,9108834576,0,0,0,425.77,,
88172,9600012036,0,0,0,1375.99,,
88175,9107100001,0,0,0,367.73,,
88184,3100205-M,8,6,2,70.66,,
88185,APT-150-02,4,2,2,255.94,,
88186,102440,0,0,0,46.89,,
88193,385320005,4,0,4,29.32,,
88197,9108554553,0,0,0,225.17,,
88200,9108554489,0,0,0,100.97,,
88201,010-12982-02,1,0,1,111.99,,
88202,010-12982-05,0,0,0,19.99,,
88203,385310018,2,2,0,27.85,,
88204,385310239,0,0,0,35.19,,
88206,RESP7,2,2,0,63.11,,
88207,RLWRS,11,11,0,8.47,,
88208,RLWRM,6,6,0,8.91,,
88209,RLWRL,2,2,0,9.16,,
88210,SRHO9,4,4,0,13.42,,
88211,RFMT,0,0,0,18.45,,
88214,010-13007-00,0,0,0,202.49,,
88219,2000037883,0,0,0,65.59,,
88220,2000038018,0,0,0,104.26,,
88221,2000038017,0,0,0,20.00,,
88223,SCM-SLF-GW-WH,2,1,1,110.11,,172.00
88224,SCM-SLF-WBR-WH,3,2,1,138.41,,189.00
88225,SCM-SLF-CC-WH,3,1,2,147.76,,199.00
88227,SCM-SLB-GW-WH,3,1,2,135.00,,194.00
88228,SCM-SLB-WBR-WH,0,0,0,148.28,,208.00
88229,SCM-SLB-CC-WH,4,2,2,157.62,,218.00
88230,SCM-SLB-CC-BK,1,1,0,139.33,,218.00
88231,SCM-AL-TRACK-1M,21,11,10,3.20,,4.00
88240,PCH012030001,4,2,2,377.57,,465.80
88241,MA112,2,1,1,187.50,,
88242,901801,0,0,0,505.62,808.99,
88243,901802,2,0,2,528.75,845.99,
88244,46598,1,1,0,45.08,78.99,
88245,46599,0,0,0,75.62,120.99,
88246,20925000A,38,16,22,6.70,,
88247,SCM-MFD-LC-KIT,2,2,0,498.89,,649.00
88248,IN6707.HL,9,0,9,73.11,,
88249,2707.2M,10,0,10,83.22,125.95,
88252,SCM-DLX-CC-WH,0,0,0,83.26,,116.00
88253,SCM-DLX-CC-BK,4,2,2,83.26,,116.00
88255,SCM-DLX-WBR-WH,4,2,2,79.00,,109.00
88256,SCM-DLX-GW-WH,4,2,2,71.20,,98.00
88257,SCM-SWITCH-O/O/M,2,2,0,19.80,,28.99
88258,4758-172-A80,7,3,4,329.39,,
88294,JL-10-100-BLK,1,0,1,45.99,,
88304,IF-KS-650-25-WHT,1,0,1,19.99,,
88309,IF-KS-650-25-BLK,2,0,2,19.99,,
88313,IF-KS-650-75-BLK,2,0,2,22.50,,
88326,IF-RS-650-100-WHT,1,0,1,34.65,,
88328,IF-RS-650-50-BLK,2,0,2,21.00,,
88330,IF-RS-650-100-BLK,1,1,0,34.65,,
88334,IF-RS-800-100-WHT,2,0,2,40.15,,
88336,IF-RS-800-50-BLK,2,0,2,25.50,,
88338,IF-RS-800-100-BLK,2,0,2,40.15,,
88340,ORI241270020,9,4,5,100.59,,124.10
88341,ARG200201020,17,5,12,97.15,,119.85
88342,954000,0,0,0,63.47,,
88343,954200,2,0,2,79.72,,
88344,954400,1,1,0,71.60,,
88345,131822000,4,2,2,50.61,,
88347,IF-KS-800-25-WHT,1,0,1,30.99,,
88348,IF-KS-800-50-WHT,1,0,1,35.00,,
88350,IF-KS-800-100-WHT,1,0,1,46.20,,
88351,IF-KS-800-25-BLK,2,0,2,31.99,,
88353,IF-KS-800-75-BLK,2,0,2,37.95,,
88355,WS-REV6-25-WHT,3,1,2,16.99,,
88359,WS-REV6-25-BLK,2,0,2,16.99,,
88366,WS-REV8-100-WHT,2,2,0,41.25,,
88367,WS-REV8-25-BLK,1,0,1,25.50,,
88369,WS-REV8-75-BLK,4,0,4,28.99,,
88379,WS-RECO6-25-WHT,2,0,2,16.99,,
88380,WS-RECO6-50-WHT,2,2,0,17.99,,
88383,WS-RECO6-25-BLK,1,0,1,16.99,,
88390,WS-RECO5-100-WHT,2,1,1,28.00,,
88400,WS-RECO8-50-BLK,2,0,2,26.99,,
88401,WS-RECO8-75-BLK,1,0,1,28.00,,
88403,WS-REV8-FAS4-25-WHT,2,0,2,25.00,,
88406,WS-REV8-FAS4-100-WHT,1,0,1,43.00,,
88407,WS-REV8-FAS4-25-BLK,2,0,2,25.00,,
88409,WS-REV8-FAS4-75-BLK,2,0,2,37.00,,
88420,WS-REV12-FAHP-50-WHT,6,0,6,39.69,,
88424,WS-REV12-FAHP-50-BLK,1,0,1,39.69,,
88431,7TX-01-F010,1,1,0,242.99,,
88432,7GX-03-F010,0,0,0,171.64,,
88433,GP1040-17,0,0,0,334.53,,
88434,E70481-00-102,0,0,0,1719.99,,
88437,E70371-00-102,0,0,0,1959.99,,
88439,E70373-00-102,0,0,0,4439.99,,
88440,E70531-00-102,0,0,0,398.93,,
88441,E70532-00-102,0,0,0,479.99,,
88442,E70532-05-102,0,0,0,559.99,,
88443,FS-MS-SW10-10-25-WHT,3,2,1,33.45,,
88447,FS-MS-SW10-10-25-BLK,1,0,1,33.45,,
88452,FS-FR7022-700-50-WHT,3,2,1,24.38,,
88456,FS-FR7022-700-50-BLK,3,1,2,24.38,,
88463,FS-SG-F652W-650-25-BLK,1,0,1,22.68,,
88470,"FS- FR6022-600-100-WHT",1,1,0,30.05,,
88471,"FS- FR6022-600-25-BLK",1,0,1,18.71,,
88472,"FS- FR6022-600-50-BLK",1,1,0,19.85,,
88473,"FS- FR6022-600-75-BLK",1,0,1,21.55,,
88474,"FS- FR6022-600-100-BLK",1,1,0,30.05,,
88475,M5-7A-4361-8,0,0,0,116.55,,
88476,M5-7A-6362-8,0,0,0,138.51,,
88483,BPC121545102,22,6,16,102.66,,126.65
88484,BPC121546102,13,11,2,118.51,,146.20
88485,BPC122045102,17,6,11,123.33,,152.15
88486,BPC122046102,21,9,12,138.49,,170.85
88487,BPC123047102,5,0,5,148.13,,182.75
88489,ORI303050000,3,3,0,545.69,,673.20
88491,BAW4010,0,0,0,26.78,,
88493,001-588-890-00,0,0,0,50.00,,
88502,MC-612-DUAL-H,0,0,0,322.96,396.00,
88503,VLB5,0,0,0,70.00,,
88506,SCC010020060,3,0,3,45.47,,56.10
88507,MMC-9N-L,0,0,0,95.00,,
88508,996476531,0,0,0,153.66,,
88519,100-330-843-10,0,0,0,24.55,,
88540,FS-SG-FL772-770-25-WHT,4,1,3,22.68,,
88542,FS-SG-FL772-770-75-WHT,1,1,0,25.52,,
88543,FS-SG-FL772-770-100-WHT,1,1,0,35.72,,
88545,FS-SG-FL772-770-50-BLK,1,1,0,24.38,,
88553,FS-SG-F772W-770-50-BLK,2,2,0,28.35,,
88567,FS-SG-FL882S-880-100-WHT,2,0,2,41.39,,
88569,FS-SG-FL882S-880-50-BLK,1,1,0,28.35,,
88577,FS-SG-F882W-880-50-BLK,2,1,1,36.29,,
88585,FS-SG-SL102S-10-50-BLK,1,0,1,36.29,,
88589,SSM-21A,44,15,29,53.33,,
88591,000-15128-001,0,0,0,7999.20,,9999.00
88594,HE-FLPUS,0,0,0,39.57,,
88596,S00-01195-10,0,0,0,5.10,,
88597,F91401,0,0,0,5.90,,
88598,F91402,3,0,3,7.90,,
88599,F91403,0,0,0,9.90,,
88600,F91404,6,2,4,5.90,,
88601,F91405,4,1,3,7.90,,
88602,F91406,9,5,4,9.90,,
88605,46700,0,0,0,91.28,129.99,
88606,46701,0,0,0,97.45,134.99,
88607,46702,0,0,0,113.20,149.99,
88608,150PHW,5,3,2,8.59,,
88609,GP2170-16,0,0,0,385.44,,
88611,F91401-3,0,0,0,14.75,,
88612,F91404-3,1,0,1,14.75,,
88613,F91402-3,1,0,1,19.75,,
88614,F91405-3,1,0,1,19.75,,
88634,13012,2,0,2,52.84,,
88638,DB3901,0,0,0,191.67,,
88639,KF5000WH,0,0,0,111.54,,
88641,WS2-C10,0,0,0,95.56,,
88642,WS2-C30,1,0,1,210.24,,
88653,101684,7,3,4,139.02,,
88659,K12-1100,2,1,1,69.44,,
88662,8M4004175,5,3,2,41.65,,
88666,M-476-BP,0,0,0,27.31,,
88667,PCK-175,17,16,1,88.15,139.00,
88668,PCK-250,25,10,15,126.19,199.00,
88669,PCK-625,17,0,17,189.60,299.00,
88670,PCK-1250,32,15,17,253.01,399.00,
88682,602014-1,16,0,16,194.81,,299.99
88686,2304A,0,0,0,151.49,,
88698,APT-F-150-02,2,0,2,255.94,,
88699,B175HW/12,1,1,0,1244.44,,
88702,150800-200-050-20,0,0,0,57.60,,
88723,A2C3931270001,0,0,0,462.86,534.59,
88733,1232,0,0,0,215.46,,
88734,T70347,1,0,1,1736.83,,
88735,LLB-70RB-E0-00,2,2,0,26.99,,
88737,LLB-63RB-E0-K1,2,1,1,104.27,,
88738,LLB-63BB-F0-K2,0,0,0,104.27,,
88740,AIR-040-406-10,0,0,0,136.36,,
88754,83224100,0,0,0,142.80,,
88755,83220100,0,0,0,140.07,,
88756,83216100,0,0,0,129.62,,
88765,HSB380,0,0,0,136.64,,
88766,2631,0,0,0,135.77,204.95,
88770,01-0432-01,2,0,2,7829.99,,
88771,000-15687-001,0,0,0,76.62,,
88779,M-597-BP,7,4,3,30.13,,
88783,621-VUP-MC-120-K6,2,0,2,819.08,1003.00,
88785,150PHB,10,6,4,8.59,,
88786,550416,0,0,0,272.79,,
88789,60031,4,2,2,16.01,,20.95
88790,60030,6,3,3,16.01,,20.95
88791,770065,11,0,11,9.67,,
88792,770066,5,0,5,11.95,,
88809,36200-0000,17,8,9,20.25,,
88810,18911-7020,1,0,1,42.10,,
88811,18911-1030,3,1,2,17.99,,
88816,IS2412,1,0,1,270.12,,
88818,171202,0,0,0,942.07,,
88819,779-LB-2-B5,29,17,12,20.32,,
88821,9608,0,0,0,77.45,,
88823,3124,17,16,1,2.66,,
88824,41178,16,8,8,7.84,,
88825,41189,1,1,0,10.98,,
88828,600-804,0,0,0,4.94,,
88830,RF55171,0,0,0,37.78,57.80,
88831,600-864,0,0,0,6.18,,
88832,600-861,0,0,0,7.26,,
88833,600-862,0,0,0,7.26,,
88834,600-860,0,0,0,6.18,,
88835,600-859,3,2,1,3.94,,
88837,600-819,6,3,3,14.10,,
88838,600-823,0,0,0,6.48,,
88839,600-844,0,0,0,13.18,,
88840,600-844-LED,0,0,0,10.44,,
88841,600-845,0,0,0,17.70,,
88842,600-846,0,0,0,13.18,,
88843,992-MW-S,1,1,0,315.29,,
88844,MTCP1212LPJ,0,0,0,947.47,,
88862,T10-3000-9,5,2,3,265.36,,
88868,01-0380-06,0,0,0,882.67,,
88870,APT-F-250-02,3,1,2,261.56,,
88871,150800-200-060-20,0,0,0,57.60,,
88873,PM275C-LHW-MM,0,0,0,1581.53,,
88876,880062-BP,6,4,2,26.77,,
88877,24213-BP,12,6,6,64.41,,
88878,2484-BP,2,2,0,34.27,,
88879,24450-BP,11,5,6,84.28,,
88880,956-3126-BP,0,0,0,28.00,,
88881,5582-10-BP,0,0,0,13.99,,
88883,10-963,0,0,0,24.06,,
88884,10-957,0,0,0,19.94,,
88886,SKI024100002,0,0,0,1323.57,,1632.85
88887,240603,3,1,2,580.07,1016.49,
88888,DT812PV-235-N2,1,0,1,284.90,,
88891,3274,2,0,2,29.39,35.95,
88894,600-844-B-LED,1,0,1,6.99,,
88895,600-845-LED,0,0,0,11.16,,
88897,600-846-LED,0,0,0,10.44,,
88900,RF55210,0,0,0,63.33,96.90,
88907,167115,10,10,0,12.06,19.97,
88911,TZ3-190-BKT,0,0,0,268.18,,
88913,100-430-901-10,0,0,0,70.91,,
88914,S-0918LED,2,2,0,80.56,,
88926,UPMD,0,0,0,1580.16,,
88933,V11-2423BKA50-1,1,1,0,307.72,,
88938,010-13126-00,13,13,0,11.24,,
88939,010-13127-00,0,0,0,11.24,,
88941,010-13129-00,40,37,3,11.24,,
88942,010-13130-00,2,0,2,14.99,,
88943,010-13131-00,19,19,0,14.99,,
88944,010-13132-00,18,15,3,14.99,,
88946,010-12953-00,0,0,0,15.99,,
88947,010-12953-02,0,0,0,19.99,,
88949,301096202,0,0,0,72.49,,
88951,301096602,2,2,0,101.49,,
88952,301096606,0,0,0,101.49,,
88953,2990,3,2,1,37.63,,
88954,2989,4,3,1,37.57,,
88956,ORI241220260,13,2,11,36.52,,45.05
88957,V12-0307CP80,2,1,1,170.09,,
88959,RAERTR-C,2,2,0,11.07,,
88960,MTH2,17,17,0,13.67,,
88961,MTH3,4,4,0,18.07,,
88962,MTHK-2,9,9,0,32.64,,
88963,300416,1,1,0,401.16,702.99,
88964,300417,1,0,1,439.37,702.99,
88965,300418,0,0,0,20.62,32.99,
88966,300419,0,0,0,20.62,32.99,
88967,300420,0,0,0,10.62,19.99,
88968,300421,0,0,0,12.50,19.99,
88969,300422,0,0,0,51.25,81.99,
88970,300427,1,1,0,8.55,14.99,
88971,300428,0,0,0,38.62,59.99,
88972,300429,0,0,0,51.50,79.99,
88973,GP1800-14,0,0,0,312.72,,
88979,VL-45-E1YN,0,0,0,12105.88,14400.00,
88980,T72FC,0,0,0,92.05,,
88984,M20-1013A,2,2,0,327.40,,
88988,621-VUP-MC-100-SV,2,0,2,755.69,925.00,
88991,118010,0,0,0,544.44,,
88992,1180-FT,11,11,0,9.28,,
88993,118005,0,0,0,271.16,,
88996,E-4209-20,0,0,0,103.75,,
88998,HE-H10LED,0,0,0,60.52,,
89004,300414,0,0,0,306.25,489.99,
89005,300415,4,1,3,493.75,789.99,
89006,300423,0,0,0,11.75,19.99,
89007,300424,0,0,0,13.13,19.99,
89008,300425,0,0,0,11.15,19.99,
89012,TEU001B,0,0,0,400.00,,
89013,TEU001S,0,0,0,400.00,,
89014,8M4004174,0,0,0,41.65,,
89015,8M4004176,6,2,4,14.99,,
89016,8M4004177,1,1,0,41.65,,
89017,8M4004178,9,3,6,41.65,,
89018,8M4004179,11,5,6,14.99,,
89019,8M4004180,12,6,6,14.99,,
89023,4700CR,6,4,2,56.13,,
89024,4721CR,2,0,2,13.24,,
89025,4731CR,0,0,0,22.06,,
89026,101699,15,5,10,231.37,,
89038,AXRC21-BK/DK,9,5,4,47.46,65.99,
89044,60020,5,2,3,14.21,,18.95
89045,60021,4,1,3,23.81,,31.15
89046,60040,7,4,3,70.89,,81.94
89059,818440,0,0,0,26.37,,
89060,238613L1,26,24,2,30.63,,
89062,200-012G2,4,2,2,359.99,,
89065,200-012G2-B,4,2,2,359.99,,
89074,201-007G2S,4,3,1,699.99,,
89078,201-007G2SW-30M,1,1,0,999.99,,
89081,201-011-15M,0,0,0,614.17,,783.07
89082,201-011DLX-15M,0,0,0,870.09,,1109.36
89083,201-011DLX-B-15M,0,0,0,870.09,,1109.36
89084,301-001-B-6M,0,0,0,278.57,,355.18
89085,2021026399,1,0,1,1263.98,1769.00,
89086,2021026400,2,0,2,1263.98,,
89087,2021026251,0,0,0,1432.51,1769.00,
89088,2021026252,1,0,1,1263.98,,
89089,2021026253,2,0,2,1263.98,1769.00,
89090,2021026254,1,0,1,1263.98,1769.00,
89091,2021026255,1,0,1,1263.98,,
89092,2021026256,1,0,1,1263.98,1769.00,
89093,2021026257,1,0,1,1263.98,,
89094,2021026258,2,0,2,1263.98,,
89095,301-002-B-6M,0,0,0,278.57,,355.18
89096,2021026259,2,0,2,1263.98,1769.00,
89097,2021026260,0,0,0,1432.51,1769.00,
89098,2021026261,2,0,2,1263.98,1769.00,
89099,2021026262,2,0,2,1263.98,,
89100,2021026263,1,0,1,1149.99,1769.00,
89101,2021026264,2,0,2,1263.98,1769.00,
89102,301-006-6M,0,0,0,351.80,,448.55
89103,301-006-B-6M,0,0,0,351.47,,448.12
89104,301-006DLX,0,0,0,669.53,,853.65
89105,201-011ST,0,0,0,807.13,,1029.10
89106,201-011ST-B,0,0,0,807.13,,1029.10
89118,200-016G2,4,2,2,246.49,,314.27
89119,200-016G2-B,0,0,0,246.49,,314.27
89120,200-016G2ST,0,0,0,486.84,,620.72
89121,200-016G2ST-B,0,0,0,486.84,,620.72
89122,200-018G2,1,0,1,246.49,,314.27
89123,200-018G2-B,0,0,0,246.49,,314.27
89124,200-018G2ST,0,0,0,486.84,,620.72
89125,200-018G2ST-B,0,0,0,486.84,,620.72
89126,200-024G2,2,0,2,246.49,,314.27
89127,200-024G2-B,0,0,0,246.49,,314.27
89128,200-024G2ST,0,0,0,486.84,,620.72
89129,200-024G2ST-B,0,0,0,486.84,,620.72
89130,301-011KL,2,0,2,1078.09,,1374.56
89131,301-011,0,0,0,1078.09,,1374.56
89132,301-011-B,0,0,0,1078.09,,1374.56
89133,301-011DLX-15M,0,0,0,1488.01,,1897.21
89134,301-011DLX-B-15M,0,0,0,1488.44,,1897.76
89135,301-011ST,0,0,0,1618.64,,2063.77
89136,301-011ST-B,0,0,0,1618.64,,2063.77
89145,PMP122305100,21,2,19,970.11,,1196.80
89147,SC80,0,0,0,852.19,,
89148,G-3110C,2,0,2,12.33,,
89149,G-8010C,3,1,2,12.33,,
89161,90404,3,3,0,22.65,,
89162,001-440-260-00,0,0,0,45.45,,
89166,E-4209-30,0,0,0,142.50,,
89167,ORI242440120,4,2,2,197.74,,243.95
89171,109-516811,12,8,4,85.46,100.99,
89172,109-516804,10,0,10,59.99,102.99,
89173,109-118176,0,0,0,255.61,300.99,
89174,117-117308,0,0,0,88.19,114.99,
89176,BFGRLITH,0,0,0,153.49,,
89177,58295,4,4,0,46.14,,
89183,62-070-BW,0,0,0,68.60,,
89187,172012,0,0,0,1111.11,,
89188,959950111,0,0,0,127.85,,
89197,010-02407-00,8,4,4,824.99,,
89198,010-11082-10,0,0,0,44.99,,
89200,08-03-030,0,0,0,389.73,,
89202,60018,0,0,0,631.68,,
89203,60039,0,0,0,364.18,,
89204,60040,0,0,0,274.59,,
89205,60041,0,0,0,318.79,,
89206,60044,3,3,0,318.79,,
89207,60045,0,0,0,449.11,,
89208,60048,0,0,0,449.11,,
89209,60051,0,0,0,1028.30,,
89210,60052,0,0,0,804.01,,
89211,60053,0,0,0,270.83,,
89212,60054,0,0,0,224.59,,
89213,60058,0,0,0,624.18,,
89214,60063,0,0,0,1254.71,,
89215,60064,0,0,0,1097.49,,
89216,60065,0,0,0,641.99,,
89217,60070,0,0,0,1009.26,,
89218,60071,0,0,0,517.78,,
89219,60072,0,0,0,163.95,,
89220,60073,0,0,0,370.26,,
89221,60074,0,0,0,114.55,,
89222,60075,0,0,0,5071.96,,
89223,60088,0,0,0,313.68,,
89224,60089,0,0,0,677.06,,
89225,60090,0,0,0,423.98,,
89226,60092,0,0,0,169.60,,
89227,MGV520B,0,0,0,160.65,,
89229,90403,0,0,0,13.23,,
89230,90412,3,3,0,14.99,,
89231,90511,0,0,0,38.20,,
89232,91001,0,0,0,46.58,,
89234,60094,0,0,0,1413.78,,
89235,60097,0,0,0,964.20,,
89236,60400,0,0,0,7.86,,
89237,60401,0,0,0,8.96,,
89238,60402,5,0,5,11.59,,
89239,60404,3,3,0,15.27,,
89240,60406,8,5,3,20.53,,
89241,61040,2,0,2,299.99,,
89242,61041,0,0,0,380.40,,
89243,61042,2,0,2,380.40,,
89244,61043,0,0,0,380.40,,
89245,61044,0,0,0,361.96,,
89246,61050,0,0,0,475.18,,
89247,61051,0,0,0,475.86,,
89248,61052,0,0,0,475.86,,
89249,61053,0,0,0,475.86,,
89250,61054,0,0,0,460.53,,
89251,RC121012VEDC,0,0,0,2821.24,3997.00,
89254,62318,0,0,0,12.39,,
89255,63034,0,0,0,626.00,,
89256,63037,0,0,0,840.24,,
89257,63056,0,0,0,686.15,,
89258,63057,0,0,0,625.09,,
89259,63058,0,0,0,286.21,,
89260,63059,0,0,0,235.25,,
89261,63060,0,0,0,904.73,,
89262,63061,0,0,0,527.04,,
89263,63070,0,0,0,573.39,,
89264,63071,0,0,0,497.23,,
89265,63075,0,0,0,332.79,,
89266,63100,0,0,0,111.36,,
89267,63102,0,0,0,67.60,,
89268,63104,0,0,0,355.18,,
89269,63106,0,0,0,204.25,,
89270,63108,1,1,0,128.24,,
89271,63109,0,0,0,322.15,,
89272,63110,0,0,0,191.93,,
89273,63111,0,0,0,21.85,,
89274,63112,0,0,0,27.30,,
89275,63201,0,0,0,62.85,,
89276,63202,2,0,2,43.36,,
89277,63203,0,0,0,29.46,,
89278,63204,0,0,0,44.26,,
89279,63205,0,0,0,60.53,,
89280,63206,0,0,0,114.73,,
89281,63207,0,0,0,41.20,,
89282,63404,0,0,0,27.40,,
89283,63405,0,0,0,31.81,,
89284,63406,0,0,0,65.79,,
89285,63515,0,0,0,1025.08,,
89286,63516,0,0,0,838.70,,
89287,63518,0,0,0,530.18,,
89288,60455-TO,0,0,0,157.91,,
89289,60456-TO,0,0,0,223.70,,
89290,60457-TO,0,0,0,319.13,,
89291,TK-71000,0,0,0,11.27,,
89292,TK-81000,0,0,0,7.70,,
89293,TK-91000,0,0,0,7.70,,
89294,FLMBPS/BKV2,0,0,0,48.86,,81.95
89295,FLMBPS/WHV2,0,0,0,48.86,,81.95
89296,87240,0,0,0,130.28,,
89297,87241,0,0,0,130.28,,
89298,87242,0,0,0,130.28,,
89299,87243,0,0,0,130.28,,
89300,87271,0,0,0,139.64,,
89301,97240,0,0,0,134.83,,
89302,2141,0,0,0,184.74,277.95,
89303,97241,0,0,0,134.83,,
89304,97242,0,0,0,134.83,,
89305,97243,0,0,0,134.83,,
89307,97271,0,0,0,144.53,,
89308,6502001030,1,1,0,23.88,,
89309,120-121244,7,7,0,30.27,,
89310,120-578840,0,0,0,4.40,,
89311,120-582182,0,0,0,6.35,,
89312,120-143451,0,0,0,6.35,,
89314,100R,6,4,2,6.03,,
89323,GM-ME300X1C,6,4,2,159.99,,
89334,103-141631,0,0,0,249.92,286.99,
89335,103-141709,0,0,0,443.93,508.99,
89336,105-105213,6,4,2,118.47,167.99,
89337,103-142034,0,0,0,101.94,116.99,
89338,120-577348,3,1,2,6.84,,
89339,120-144090,1,1,0,6.39,,
89340,120-144243,0,0,0,6.35,,
89361,996276471,5,3,2,105.06,,
89362,114-115014,0,0,0,231.82,265.99,
89364,105-105275,0,0,0,89.32,126.99,
89365,120-580805,1,1,0,6.84,,
89366,120-143383,2,1,1,6.84,,
89367,120-141730,0,0,0,6.84,,
89368,120-143376,0,0,0,10.27,,
89369,120-577201,0,0,0,32.71,,
89370,120-141532,1,1,0,44.41,,
89371,120-141754,0,0,0,6.39,,
89372,120-103042,2,1,1,28.80,,
89373,120-142065,0,0,0,30.27,,
89374,120-516620,4,4,0,7.32,,
89375,120-151333,2,2,0,22.45,,
89376,120-143369,0,0,0,6.84,,
89377,120-143512,0,0,0,8.92,,
89378,120-577256,0,0,0,6.84,,
89379,7555-3,5,3,2,10.89,,
89403,PMP482305100,1,0,1,999.74,,1233.35
89404,010-12827-02,0,0,0,56.24,,
89406,APL18904S2,4,2,2,17.41,,
89411,385311520,4,2,2,38.85,,
89412,385311521,1,1,0,38.85,,
89416,2000037884,0,0,0,139.41,,
89417,GP1200-20,0,0,0,363.62,,
89420,000-197-069-10,0,0,0,90.91,,
89422,9636,4,2,2,49.09,,
89424,A2K-SCREWCAP-10-F,0,0,0,15.21,,
89427,DCCIG09,9,5,4,13.45,,
89429,MC-618-VL-01,0,0,0,437.09,535.00,
89430,CS2579402,4,3,1,28.56,,
89433,321913,2,0,2,7.93,18.99,
89434,321933,6,6,0,7.93,18.99,
89436,SP-4000-ADJ-RB,38,22,16,47.43,,
89452,AK3714,5,3,2,41.93,,
89453,BP185G15,0,0,0,213.75,285.00,
89455,77040600,10,4,6,30.94,,
89456,S-0213,4,0,4,7.40,,
89457,010-02667-00,7,6,1,314.99,,
89458,MC-618,3,0,3,252.05,309.00,
89460,SBR-41LI,19,4,15,36.00,,
89468,76-0201,5,0,5,15.29,,
89469,76-0300,0,0,0,12.41,,
89470,76-0600,0,0,0,16.24,,
89471,V-BATT-TML,6,4,2,17.90,,
89473,CN0010-500,2,2,0,99.99,,
89474,049300499D,1,1,0,48.15,,
89475,049300599D,4,4,0,56.08,,
89476,049300799D,3,1,2,80.15,,
89477,049300899D,1,0,1,106.74,,
89478,049300999D,4,3,1,138.74,,
89479,049301099D,4,1,3,153.68,,
89484,VBTPN,10,6,4,20.49,,
89486,31-6257-00,0,0,0,12.74,,
89487,VFDB2,0,0,0,18.63,,
89488,VFDB4,11,8,3,24.06,,
89489,VPNB2,2,1,1,17.41,,
89490,VPNB4,0,0,0,30.03,,
89491,VDB2,1,1,0,16.87,,
89492,VDB4,4,3,1,17.41,,
89509,01-0380-05,2,0,2,1030.40,,
89511,MGA0476B,4,3,1,25.71,,
89520,71082,5,0,5,192.64,,
89523,15001C,0,0,0,54.99,,
89524,15002C,0,0,0,50.51,,
89526,15003C,0,0,0,50.51,,
89528,15004C,0,0,0,48.54,,
89529,"HYCO 1.1",2,2,0,681.42,,
89530,15005C,0,0,0,48.77,,
89531,15006C,1,1,0,29.99,,
89532,15007C,2,2,0,29.99,,
89533,15008,0,0,0,39.03,,
89534,15009,0,0,0,36.04,,
89535,15012,0,0,0,48.66,,
89542,15013,0,0,0,26.74,,
89543,15017C,1,1,0,51.74,,
89544,15021C,1,1,0,57.00,,
89545,15022C,2,1,1,56.01,,
89546,"HYTECH 1.1",0,0,0,694.24,,
89547,15023C,0,0,0,53.89,,
89548,15025,2,2,0,92.50,,
89549,15103C,0,0,0,56.01,,
89550,"PROTECH 1.1",1,1,0,921.24,,
89551,15104C,1,1,0,42.57,,
89552,15105C,0,0,0,42.57,,
89553,15106C,0,0,0,43.69,,
89554,15107C,0,0,0,44.74,,
89555,15108C,0,0,0,43.69,,
89556,15109C,0,0,0,34.86,,
89557,"PROTECH 2.1",2,2,0,944.86,,
89559,15144,0,0,0,208.89,,
89560,15146,0,0,0,219.77,,
89561,15147,1,1,0,149.43,,
89562,15411,0,0,0,40.13,,
89563,15412,1,1,0,55.54,,
89564,ALLOY-X,7,5,2,45.21,61.99,
89565,V12-CBF200,0,0,0,33.31,,
89566,V12-CBF100,0,0,0,33.31,,
89567,V12-CBF180,0,0,0,33.31,,
89568,V12-CBF140,0,0,0,33.31,,
89569,V8-ANL80,0,0,0,3.54,,
89570,V8-ANL100,0,0,0,3.54,,
89571,V8-ANL150,3,0,3,3.54,,
89572,V8-ANL200,8,4,4,3.54,,
89573,V8-ANL250,7,4,3,3.54,,
89574,V8-ANL300,2,2,0,3.87,,
89575,VANL,4,2,2,15.11,,
89576,VMANL,2,2,0,6.99,,
89577,VAGU,0,0,0,6.99,,
89578,VANL1,0,0,0,15.83,,
89579,VMANL1,13,4,9,13.57,,
89580,VDMANL,0,0,0,19.71,,
89581,VR04,0,0,0,9.03,,
89582,VR48,0,0,0,10.14,,
89583,V8-AGU40,1,0,1,4.38,,
89584,V8-AGU60,0,0,0,4.38,,
89585,V8-AGU50,0,0,0,4.07,,
89586,V10-2041,0,0,0,126.75,,
89587,V10-1041,0,0,0,82.99,,
89588,V10-D104K,0,0,0,89.91,,
89589,V10-D108K,0,0,0,59.76,,
89590,12001C,0,0,0,54.99,,
89591,12002C,0,0,0,50.51,,
89592,12003C,0,0,0,50.51,,
89593,12004C,0,0,0,48.77,,
89594,12005C,0,0,0,48.77,,
89595,12006C,0,0,0,47.53,,
89596,12007C,1,0,1,43.04,,
89597,12008,0,0,0,39.03,,
89598,12009,0,0,0,36.04,,
89599,12012,0,0,0,48.66,,
89600,12013,0,0,0,26.74,,
89601,12014,0,0,0,37.87,,
89602,12025,0,0,0,92.50,,
89603,12103C,0,0,0,56.01,,
89604,12104C,1,1,0,42.57,,
89605,12105C,0,0,0,42.57,,
89606,12106C,0,0,0,43.69,,
89607,12107C,0,0,0,44.74,,
89609,12144,0,0,0,208.89,,
89610,12147,0,0,0,149.43,,
89611,RS11,0,0,0,323.86,,
89612,SCC125070221,4,0,4,387.91,,478.55
89613,18001C,0,0,0,54.99,,
89614,18002C,0,0,0,50.51,,
89615,18003C,0,0,0,50.51,,
89616,18004C,0,0,0,48.54,,
89617,1377110,2,2,0,400.38,,
89618,18006C,0,0,0,47.53,,
89620,18007C,0,0,0,43.04,,
89621,18008,0,0,0,42.93,,
89622,18009,0,0,0,36.04,,
89625,18012,0,0,0,48.66,,
89626,18013,0,0,0,26.74,,
89627,18025,0,0,0,92.51,,
89628,18104C,0,0,0,71.37,,
89629,18105C,0,0,0,70.09,,
89630,18106C,0,0,0,58.37,,
89631,18107C,0,0,0,60.31,,
89632,18144,0,0,0,208.89,,
89633,18147,0,0,0,149.43,,
89634,14001C,0,0,0,64.31,,
89635,14002C,0,0,0,64.31,,
89636,14003C,0,0,0,62.37,,
89637,15843,76,40,36,4.83,,
89638,14004C,0,0,0,54.19,,
89639,14006C,0,0,0,43.11,,
89640,14007C,0,0,0,47.07,,
89641,14008,0,0,0,41.34,,
89642,14009,0,0,0,42.56,,
89643,14013,0,0,0,30.20,,
89644,14103C,0,0,0,56.01,,
89645,14104C,0,0,0,42.57,,
89646,14105C,0,0,0,42.57,,
89647,14106C,0,0,0,43.69,,
89648,14107C,0,0,0,44.74,,
89649,14144,0,0,0,243.99,,
89650,14147,0,0,0,167.99,,
89651,14411,0,0,0,40.13,,
89652,14412,0,0,0,55.54,,
89653,24451,10,0,10,4.83,,
89654,19030,0,0,0,92.50,,
89656,PS1AUTO,1,1,0,221.83,,
89657,PS2AUTO,1,1,0,340.98,,
89658,PS3AUTO,1,1,0,494.39,,
89659,PS4AUTO,2,2,0,640.12,,
89662,28104C,0,0,0,58.51,,
89664,28105C,0,0,0,57.74,,
89666,28106C,0,0,0,47.74,,
89668,28107C,0,0,0,49.89,,
89669,V8-MANL30,4,0,4,2.43,,
89670,V8-MANL40,6,3,3,2.43,,
89671,V8-MANL60,0,0,0,2.20,,
89672,V8-MANL80,6,2,4,2.43,,
89673,V8-MANL100,8,2,6,2.43,,
89674,V8-MANL125,0,0,0,2.43,,
89675,SS1AUTO,1,1,0,185.00,,
89676,V8MANL150,0,0,0,2.43,,
89677,SS2AUTO,1,0,1,284.88,,
89678,SS3AUTO,3,1,2,416.95,,
89679,SS4AUTO,1,1,0,554.02,,
89708,V10R1-5,0,0,0,9.32,,
89711,V10R3,5,2,3,9.72,,
89712,V10R6,6,2,4,10.09,,
89713,V10R10,0,0,0,10.77,,
89714,V10R14,1,0,1,11.51,,
89715,V10R17,0,0,0,12.46,,
89716,V10R20,0,0,0,12.92,,
89717,V10RY1,0,0,0,8.00,,
89718,V10RY2,0,0,0,8.00,,
89719,V10R174,0,0,0,21.59,,
89720,V10R176,0,0,0,34.59,,
89721,V10R3V,0,0,0,8.56,,
89722,V10R9V,0,0,0,10.88,,
89723,V10R20V,1,0,1,14.69,,
89725,AS1562,24,14,10,16.90,,
89727,100-397-071-10,2,0,2,33.64,,
89729,"SWM-30 KIT",3,1,2,149.99,192.00,
89740,10104,4,2,2,149.28,,
89742,30101,3,1,2,49.80,,
89743,30102,0,0,0,49.80,,
89746,41218,0,0,0,40.11,,
89747,41220,0,0,0,40.11,,
89748,41224,0,0,0,40.11,,
89750,41262,0,0,0,40.11,,
89751,41263,0,0,0,40.11,,
89752,20001,0,0,0,345.21,,
89753,53102,0,0,0,76.90,,
89754,53103,0,0,0,76.90,,
89757,SLC-11,3,0,3,277.31,357.00,
89759,ORI122421226,12,9,3,221.17,,272.85
89760,F38-6000-G,6,6,0,20.64,,
89761,F38-6000-R,54,13,41,20.64,,
89763,9108821279,3,1,2,2011.76,,
89764,9108844174,4,1,3,1794.12,,
89765,9108850337,0,0,0,1923.53,,
89766,9108732762,2,0,2,1735.29,,
89768,9108732759,2,0,2,1867.65,,
89769,9108732755,1,1,0,1982.35,,
89770,B4-I3SWM30,2,0,2,2778.00,3308.00,
89771,B4-I4SWM30,1,0,1,3511.33,4188.00,
89772,B4-I5SWM30,2,1,1,3978.00,4748.00,
89773,B4-I6SWM30,1,0,1,5044.67,6028.00,
89774,241287812,3,1,2,12.66,,
89785,010-12021-00,0,0,0,6.99,,
89786,9610001102,1,1,0,35.71,,
89787,9610001103,2,0,2,50.00,,
89788,9610001104,0,0,0,50.00,,
89789,9108549658,0,0,0,100.00,,
89790,9108549661,0,0,0,117.86,,
89791,9108732761,0,0,0,940.63,,
89793,9108732758,2,0,2,1056.25,,
89794,9108549923,0,0,0,138.75,,
89795,9108750550,0,0,0,145.00,,
89796,9108549909,0,0,0,180.00,,
89797,9108549910,0,0,0,130.00,,
89798,9108549911,0,0,0,84.67,,
89799,9108549912,2,0,2,95.33,,
89800,9108549913,0,0,0,98.67,,
89801,1300715,10,4,6,29.03,,
89803,XRMAG15BNK,1,1,0,16.29,,
89804,XRMAG15BSRD,1,1,0,16.29,,
89805,XRMAG15BTO,2,2,0,16.29,,
89806,XRMAG15D,0,0,0,16.29,,
89807,XRMAG15FT,0,0,0,16.29,,
89808,XRMAG15GGH,2,2,0,16.29,,
89809,XRMAG15GGM,3,3,0,16.29,,
89810,XRMAG15HH,3,3,0,16.29,,
89811,XRMAG15HPU,1,1,0,16.29,,
89812,XRMAG15LLU,0,0,0,16.29,,
89813,XRMAG15PM,1,1,0,16.29,,
89814,XRMAG15RH,3,3,0,16.29,,
89815,XRMAG15RHU,3,3,0,16.29,,
89816,XRMAG15S,2,2,0,16.29,,
89817,XRMAG15SBM,0,0,0,16.29,,
89818,XRMAG15SFU,0,0,0,16.29,,
89819,XRMAG15SPM,0,0,0,16.29,,
89820,XRMAG15WHU,0,0,0,16.29,,
89821,XRMAG15YFT,0,0,0,16.29,,
89824,GP1600-19,0,0,0,341.81,,
89825,385880068,0,0,0,383.69,,
89826,BFGVLITH,1,0,1,153.49,,
89827,BFGHLITH,1,0,1,153.49,,
89828,BFGDUALCOMBO,0,0,0,190.50,,
89829,BFGDUALLITH,0,0,0,257.57,,
89830,XRMAG20BNK,3,3,0,17.46,,
89831,XRMAG20BSRD,3,3,0,17.46,,
89832,XRMAG20BTO,0,0,0,17.46,,
89833,XRMAG20D,3,3,0,17.46,,
89834,XRMAG20FT,0,0,0,17.46,,
89835,XRMAG20GGH,2,2,0,17.46,,
89836,XRMAG20GGM,1,1,0,17.46,,
89837,XRMAG20HH,2,2,0,17.46,,
89838,XRMAG20HPU,3,3,0,17.46,,
89839,XRMAG20HUU,1,1,0,17.46,,
89840,XRMAG20LLU,0,0,0,17.46,,
89841,XRMAG20PM,0,0,0,17.46,,
89842,XRMAG20RH,0,0,0,17.46,,
89843,XRMAG20RHU,0,0,0,17.46,,
89844,XRMAG20S,0,0,0,17.46,,
89845,XRMAG20SBM,0,0,0,17.46,,
89846,XRMAG20SFU,0,0,0,17.46,,
89847,XRMAG20SPM,0,0,0,17.46,,
89848,XRMAG20WHU,0,0,0,17.46,,
89849,XRMAG20YFT,3,3,0,17.46,,
89850,XRMAG20YFU,0,0,0,17.46,,
89851,XRMAG30BNK,6,6,0,19.39,,
89852,XRMAG30BSRD,0,0,0,19.39,,
89853,XRMAG30BTO,0,0,0,19.39,,
89854,XRMAG30D,0,0,0,19.39,,
89855,XRMAG30FT,0,0,0,19.39,,
89856,XRMAG30GGH,0,0,0,19.39,,
89857,XRMAG30GGM,6,6,0,19.39,,
89858,XRMAG30HH,11,11,0,19.39,,
89859,XRMAG30HPU,4,4,0,19.39,,
89860,XRMAG30HUU,1,1,0,19.39,,
89861,XRMAG30LLU,0,0,0,19.39,,
89862,XRMAG30PM,2,2,0,19.39,,
89863,XRMAG30RH,0,0,0,19.39,,
89864,XRMAG30RHU,3,3,0,19.39,,
89865,XRMAG30S,0,0,0,19.39,,
89866,XRMAG30SBM,2,2,0,19.39,,
89867,XRMAG30SFC,0,0,0,19.39,,
89868,XRMAG30SFU,0,0,0,19.39,,
89869,XRMAG30SPM,0,0,0,19.39,,
89870,XRMAG30WHU,0,0,0,19.39,,
89871,XRMAG30YFT,2,2,0,19.39,,
89872,XRMAG30YFU,3,3,0,19.39,,
89873,2000032007,0,0,0,35.33,44.99,
89874,2000023362,1,0,1,108.53,,
89877,P13157-200TEBCL,4,2,2,229.99,,
89878,P13157-200TEBBK,5,2,3,248.37,,
89879,P13157-200TEBGR,4,2,2,234.99,,
89881,50061,1,1,0,229.99,,
89882,59002,0,0,0,42.79,,
89898,0140-1243,3,3,0,17.12,,
89906,0140-1004,5,0,5,6.80,,
89911,TPA369,0,0,0,142.50,,
89912,P102996,0,0,0,222.00,,
89915,DFW4X-4,0,0,0,51.43,,
89922,BPP920140100,5,2,3,79.92,,98.60
89923,A-5-BLACK,7,5,2,211.54,,
89924,10-758,0,0,0,41.25,,
89926,020-00200-24,0,0,0,101.24,,
89927,020-00200-20,0,0,0,209.99,,
89928,020-00200-21,0,0,0,209.99,,
89929,020-00200-22,0,0,0,412.49,,
89930,020-00200-23,0,0,0,412.49,,
89933,UC128TS-1,7,0,7,484.07,,
89936,1468,4,2,2,13.75,,
89937,"I10VSD 230V",0,0,0,3261.20,,
89938,"I16VSD 230V",1,0,1,3849.37,,
89939,"I21VSD 230V",2,0,2,4022.17,,
89941,411730-1,10,10,0,420.51,,
89942,411740-1,24,24,0,461.00,,
89943,411750-1,32,32,0,708.00,,
89945,411790-1,8,8,0,2224.32,,
89947,740206-1,27,27,0,170.96,,
89948,740202-1,2,2,0,310.62,,
89949,770032-1,8,8,0,113.64,,
89950,770033-1,0,0,0,227.28,,
89951,740204-1,19,19,0,370.10,,
89952,740205-1,17,17,0,370.10,,
89953,700066-1,28,28,0,1530.00,,
89956,FNTCD2022000A00,1,0,1,232.32,,
89957,96634,0,0,0,10.15,13.59,
89964,550105,1,0,1,152.49,,
89968,5289,5,0,5,11.37,,
89986,"PWR 12V",4,1,3,2500.00,,
89987,"PWR 24V",4,2,2,2511.11,,
89988,"G-3A 12V",0,0,0,717.22,,
89989,"G-3A 24V",0,0,0,728.33,,
89990,"G-6A 12V",0,0,0,770.56,,
89991,"G-6A 24V",0,0,0,781.67,,
89992,"G-4A 12V",0,0,0,756.67,,
89993,"G-4A 24V",0,0,0,767.78,,
89995,102450,0,0,0,30.56,,
89997,010-12507-01,0,0,0,9.74,,
89998,010-12504-01,0,0,0,14.99,,
90000,010-12676-05,0,0,0,157.49,,
90001,010-12676-40,10,10,0,41.24,,
90002,010-12531-10,7,7,0,22.49,,
90003,TW4B22900JV,2,2,0,35.55,,
90004,TW4B23100JV,0,0,0,35.55,,
90015,"EFC-03 BLUE",9,0,9,43.79,,
90017,E70364-00-102,0,0,0,522.56,,
90018,E70364-02-102,0,0,0,597.09,,
90019,E70369-00-102,7,0,7,1279.00,,
90022,D180101,0,0,0,69.93,,
90023,M11032,1,0,1,28.99,,
90024,D10701,0,0,0,18.50,,
90025,M20508,12,0,12,10.53,,
90026,1831061,6,4,2,84.49,,
90027,1831101,12,8,4,103.99,,
90028,101692,10,2,8,76.13,,
90029,1832121,6,1,5,142.99,,
90030,101693,11,5,6,82.67,,
90031,1832201,2,2,0,207.99,,
90033,1832302,0,0,0,240.49,,
90034,1833181,9,3,6,194.99,,
90035,1833301,9,5,4,259.99,,
90037,1834401,6,0,6,344.49,,
90038,1834602,304,166,138,350.99,,
90039,1835500,23,0,23,489.99,,
90046,131200,4,3,1,8.47,,
90047,171200,0,0,0,13.43,,
90049,8120,3,1,2,214.74,,
90050,010-12390-45,0,0,0,67.49,,
90051,010-12390-46,0,0,0,74.99,,
90056,WRC,0,0,0,328.50,,
90057,CANVT,1,0,1,37.76,,
90058,BP125G75,0,0,0,98.40,123.00,
90062,SCC115110411,5,2,3,418.91,,516.80
90067,CMD6-MD-BR,0,0,0,100.00,,
90069,CMD6-MB-BR,0,0,0,100.00,,
90071,CMD6-MD-R,0,0,0,100.00,,
90073,CMD6-MB-R,0,0,0,100.00,,
90074,0590DPWCHR,4,0,4,66.35,,
90079,01-0419-01,2,0,2,1179.99,,
90080,411660-1,21,13,8,277.55,,
90081,411680-1,4,4,0,407.66,,
90082,411670-1,34,24,10,320.92,,
90084,411610-1,16,9,7,531.99,,
90086,411630-1,14,0,14,620.17,,699.99
90087,411640-1CHO,7,6,1,620.17,,699.99
90088,411640-1,11,6,5,664.47,,749.99
90089,411650-1,36,28,8,841.67,,949.99
90098,GP1920-00,0,0,0,378.17,,
90099,648-330,0,0,0,124.50,,
90100,33-476-01,0,0,0,67.69,,
90102,RF4056,4,0,4,105.53,161.46,
90103,A2C59512458,3,1,2,38.83,54.89,
90104,A2C59514117,2,0,2,38.83,54.89,
90106,649-089,0,0,0,124.50,,
90107,650-330,0,0,0,124.50,,
90108,651-330,0,0,0,124.50,,
90109,647-600,0,0,0,64.72,,
90110,647-700,0,0,0,64.72,,
90111,647-792,0,0,0,64.72,,
90112,740200-1,8,4,4,49.24,,
90113,740199-1,16,16,0,45.45,,
90114,780044-1,12,7,5,28.56,,
90115,010-12964-00,3,0,3,20.73,,
90116,010-12964-01,10,10,0,14.60,,
90117,010-12964-10,6,6,0,10.95,,
90118,010-12964-11,1,0,1,10.95,,
90119,010-12964-02,1,0,1,14.60,,
90120,010-13097-00,5,3,2,8.88,,
90121,010-12814-01,4,1,3,15.34,,
90122,MMC-12F,1,1,0,95.00,,
90123,010-13192-10,0,0,0,18.26,,
90124,010-13192-20,0,0,0,29.22,,
90125,010-13192-00,2,2,0,14.60,,
90127,164000BR,0,0,0,28.85,,
90129,2020000297,0,0,0,1233.55,1659.00,
90130,2020000298,0,0,0,1233.55,1659.00,
90131,2020000299,2,0,2,1233.55,1659.00,
90132,2020000300,0,0,0,1233.55,1659.00,
90133,2020000301,0,0,0,1233.55,1659.00,
90134,2020000302,0,0,0,1233.55,1659.00,
90135,2020000303,0,0,0,1233.55,1659.00,
90136,2020000304,0,0,0,1233.55,1659.00,
90137,2020000305,1,0,1,1233.55,1659.00,
90138,2020000306,0,0,0,1233.55,1659.00,
90139,2020000307,0,0,0,1233.55,1659.00,
90140,2020000308,0,0,0,1233.55,1659.00,
90141,2020000309,0,0,0,1233.55,1659.00,
90142,2020000310,0,0,0,1233.55,1659.00,
90143,LYN034160200,9,6,3,774.44,,955.40
90146,SPR-1U-AM,0,0,0,172.06,,
90147,SPR-1U-RM,0,0,0,121.24,,
90148,USB-PM2,12,12,0,16.61,,
90150,BPC120531104R,25,10,15,68.90,,85.00
90153,QUA248020010,3,1,2,2698.12,,3328.60
90154,104400-200-001-22,0,0,0,15.44,,
90155,104400-400-001-22,0,0,0,15.44,,
90161,016145-001,0,0,0,113.92,,
90162,016145-011,8,4,4,113.92,,
90163,016146-001,4,4,0,149.37,,
90164,016146-011,4,2,2,126.88,,
90165,016147-001,6,6,0,156.96,,
90166,016147-101,6,4,2,225.32,,
90167,016148-001,10,4,6,192.41,,
90168,016148-101,7,3,4,264.56,,
90173,A2K-4WT,0,0,0,105.68,,
90181,40158,0,0,0,19.87,,
90182,"PROTECH 3.1",0,0,0,944.86,,
90187,001-546-670-00,0,0,0,68.18,,
90196,60-120-J10,0,0,0,625.99,766.00,
90204,PWR-PCK-BLK,3,2,1,39.99,,
90205,STR-PCK-BLK,2,1,1,27.99,,
90206,20255-1W,17,5,12,16.05,,
90213,PLABS370,0,0,0,7.20,,
90214,PLABS360,0,0,0,4.80,,
90215,PLABW670,3,3,0,47.45,,
90216,PLABW560,0,0,0,23.73,,
90217,PLABK360,0,0,0,97.49,,
90219,PLABK136,0,0,0,14.78,,
90220,PLABK135,0,0,0,10.64,,
90221,PLABE900,10,4,6,172.79,,
90222,PLASE801,0,0,0,38.03,,
90223,PLASE501,8,4,4,28.13,,
90224,PLASE341,3,3,0,21.28,,
90225,PLASE342,4,4,0,21.28,,
90226,PLASE601,3,3,0,24.32,,
90227,PLAM1071B,2,0,2,24.74,,
90228,PLAM4520B,0,0,0,20.62,,
90229,PLAM3110B,2,0,2,17.66,,
90230,PLAS7411,0,0,0,13.85,,
90232,109160,0,0,0,77.33,,
90233,1712500,0,0,0,41.24,,
90254,PLA12110,0,0,0,19.27,,
90255,645-330,0,0,0,34.57,,
90256,643-330,0,0,0,34.57,,
90257,648-300,0,0,0,124.50,,
90258,649-081,0,0,0,124.50,,
90259,650-300,0,0,0,124.50,,
90260,651-300,0,0,0,124.50,,
90261,647-599,0,0,0,64.72,,
90262,647-989,0,0,0,64.72,,
90263,647-699,1,1,0,55.90,,
90264,647-791,2,2,0,52.00,,
90265,645-300,0,0,0,34.57,,
90266,646-689,0,0,0,34.57,,
90267,643-300,0,0,0,34.57,,
90268,648-080,0,0,0,124.50,,
90269,649-080,0,0,0,124.50,,
90270,650-180,0,0,0,124.50,,
90271,651-080,0,0,0,124.50,,
90272,647-580,0,0,0,64.72,,
90273,647-980,0,0,0,64.72,,
90274,647-680,1,1,0,58.80,,
90275,647-780,1,1,0,52.50,,
90276,645-180,0,0,0,34.57,,
90277,646-680,0,0,0,34.57,,
90278,644-180,0,0,0,34.57,,
90279,643-180,0,0,0,34.57,,
90280,648-060,0,0,0,124.50,,
90281,649-060,0,0,0,124.50,,
90282,650-160,0,0,0,124.50,,
90283,651-060,0,0,0,124.50,,
90284,647-960,0,0,0,64.72,,
90285,647-660,2,2,0,49.50,,
90286,647-760,1,1,0,49.50,,
90287,645-160,0,0,0,34.57,,
90288,646-660,0,0,0,34.57,,
90289,644-160,0,0,0,34.57,,
90290,643-160,0,0,0,34.57,,
90291,648-050,0,0,0,124.50,,
90292,649-050,0,0,0,124.50,,
90293,650-150,1,1,0,112.00,,
90294,651-050,0,0,0,124.50,,
90295,647-550,1,1,0,55.92,,
90296,647-950,1,1,0,49.50,,
90297,647-650,0,0,0,64.72,,
90298,647-750,1,1,0,49.50,,
90299,645-150,0,0,0,34.57,,
90300,646-650,0,0,0,34.57,,
90301,644-150,0,0,0,34.57,,
90302,643-150,0,0,0,34.57,,
90303,635-150,0,0,0,8.62,,
90304,638-150,0,0,0,8.62,,
90305,636-150,0,0,0,8.62,,
90306,648-040,0,0,0,124.50,,
90307,649-040,0,0,0,124.50,,
90308,650-140,0,0,0,124.50,,
90309,651-040,0,0,0,124.50,,
90310,647-540,2,2,0,52.50,,
90311,647-940,1,1,0,55.92,,
90312,647-640,0,0,0,64.72,,
90313,647-740,0,0,0,64.72,,
90314,645-140,0,0,0,34.57,,
90315,646-640,0,0,0,34.57,,
90316,644-140,0,0,0,34.57,,
90317,643-140,0,0,0,34.57,,
90318,635-140,0,0,0,8.62,,
90319,634-140,0,0,0,8.62,,
90320,638-140,2,2,0,7.83,,
90321,636-140,0,0,0,8.62,,
90322,648-030,0,0,0,124.50,,
90323,649-030,0,0,0,124.50,,
90324,650-130,0,0,0,124.50,,
90325,651-030,0,0,0,124.50,,
90326,647-530,1,1,0,49.50,,
90327,647-930,0,0,0,64.72,,
90328,647-630,0,0,0,64.72,,
90329,647-730,0,0,0,64.72,,
90330,645-130,0,0,0,34.57,,
90331,646-630,0,0,0,34.57,,
90332,644-130,0,0,0,34.57,,
90333,643-130,0,0,0,34.57,,
90334,635-130,0,0,0,8.62,,
90335,634-130,0,0,0,8.62,,
90336,638-130,0,0,0,8.62,,
90337,636-130,0,0,0,8.62,,
90338,648-025,0,0,0,124.50,,
90339,649-025,0,0,0,124.50,,
90340,650-125,0,0,0,124.50,,
90341,651-025,0,0,0,124.50,,
90342,647-525,1,1,0,51.50,,
90343,647-925,2,2,0,51.50,,
90344,647-625,0,0,0,64.72,,
90345,647-725,0,0,0,64.72,,
90346,645-125,0,0,0,34.57,,
90347,646-625,0,0,0,34.57,,
90348,644-125,0,0,0,34.57,,
90349,643-125,0,0,0,34.57,,
90350,635-125,0,0,0,8.62,,
90351,634-125,0,0,0,8.62,,
90352,638-125,0,0,0,8.62,,
90353,636-125,0,0,0,8.62,,
90354,11602100,0,0,0,86.06,,
90355,11800000,5,3,2,54.18,,
90356,11800100,0,0,0,54.18,,
90357,11800500,16,7,9,54.18,,
90358,11800510,2,2,0,56.70,,
90359,648-020,0,0,0,124.50,,
90360,649-020,0,0,0,124.50,,
90361,650-120,0,0,0,124.50,,
90362,651-020,0,0,0,124.50,,
90363,647-520,2,2,0,50.00,,
90364,647-920,1,1,0,53.00,,
90365,647-620,0,0,0,64.72,,
90366,647-720,0,0,0,64.72,,
90367,645-120,0,0,0,34.57,,
90368,646-620,0,0,0,34.57,,
90369,644-120,0,0,0,34.57,,
90370,643-120,0,0,0,34.57,,
90371,635-120,0,0,0,8.62,,
90372,634-120,0,0,0,8.62,,
90373,638-120,0,0,0,8.62,,
90374,636-120,2,2,0,8.62,,
90375,647-515,0,0,0,64.72,,
90376,647-615,1,1,0,64.72,,
90377,647-715,0,0,0,64.72,,
90378,645-115,0,0,0,34.57,,
90379,644-115,0,0,0,34.57,,
90380,643-115,0,0,0,34.57,,
90381,635-115,0,0,0,8.62,,
90382,634-115,0,0,0,8.62,,
90383,638-115,0,0,0,8.62,,
90384,636-115,2,2,0,8.62,,
90385,645-112,0,0,0,34.57,,
90386,644-112,1,1,0,34.57,,
90387,643-112,0,0,0,34.57,,
90388,635-112,0,0,0,8.62,,
90389,634-112,0,0,0,8.62,,
90390,638-112,0,0,0,8.62,,
90391,636-112,0,0,0,8.62,,
90392,645-110,0,0,0,34.57,,
90393,643-110,0,0,0,34.57,,
90394,635-110,0,0,0,8.62,,
90395,634-110,0,0,0,8.62,,
90396,638-110,0,0,0,8.62,,
90397,636-110,2,2,0,8.62,,
90398,635-108,0,0,0,8.62,,
90399,638-108,0,0,0,8.62,,
90400,636-108,1,1,0,8.62,,
90401,635-106,0,0,0,8.62,,
90402,638-106,0,0,0,8.62,,
90403,636-106,0,0,0,8.62,,
90404,7765,2,0,2,131.00,,
90405,010-12236-06,0,0,0,52.49,,
90416,604-120,1,1,0,9.84,,
90417,604-120G,0,0,0,9.84,,
90422,604-117,1,1,0,9.84,,
90423,604-117G,3,3,0,9.84,,
90425,604-1014,0,0,0,22.62,,
90426,604-1014G,0,0,0,22.62,,
90428,604-114,0,0,0,9.84,,
90429,604-114G,0,0,0,9.84,,
90431,604-1012,0,0,0,22.62,,
90432,604-1012G,1,1,0,22.62,,
90434,604-112,0,0,0,9.18,,
90435,604-112G,0,0,0,9.18,,
90437,604-1010,0,0,0,19.47,,
90438,604-1010G,0,0,0,19.47,,
90440,604-110,1,1,0,9.18,,
90441,604-110G,0,0,0,9.18,,
90443,604-1008,1,1,0,19.47,,
90444,604-1008G,0,0,0,17.50,,
90446,604-108,0,0,0,9.18,,
90447,604-108G,0,0,0,9.18,,
90461,010-12548-02,0,0,0,18.74,,
90462,SCC115070411,11,8,3,336.23,,414.80
90464,LLB-70SL-02-00,0,0,0,6.92,,
90471,APR20925,5,1,4,264.99,,
90475,APR20923,2,1,1,330.59,,
90476,APR20924,3,0,3,430.23,,
90477,APL21349,3,0,3,259.99,,
90478,APT21228,0,0,0,147.78,,
90479,APT21226,0,0,0,147.78,,
90480,APX20998,7,5,2,71.70,,
90481,APA20450,4,2,2,14.99,,
90482,APA20451,1,0,1,23.99,,
90483,APA20452,6,0,6,32.99,,
90533,RC91942,0,0,0,51.44,,
90535,BBTH0927001,0,0,0,30.00,,
90536,L10-2005BSA-1,0,0,0,936.68,,
90537,15STA,0,0,0,438.35,579.95,
90538,20STC,0,0,0,563.82,745.95,
90539,20STA,0,0,0,488.12,645.95,
90540,SXG9510-30,0,0,0,97.55,,
90541,SXG9510-40,0,0,0,97.55,,
90542,SXG9510-60,2,0,2,97.55,,
90543,SXG9510-80,6,3,3,97.55,,
90596,4000F-10,0,0,0,90.86,,
90597,4001F-10,0,0,0,97.08,,
90598,4002F-10,0,0,0,106.61,,
90599,4003F-10,0,0,0,113.45,,
90600,4004F-10,0,0,0,123.76,,
90601,4005F-10,0,0,0,137.34,,
90603,4010F-10,0,0,0,59.04,,
90604,4012F-10,0,0,0,67.09,,
90605,4012XF-10,0,0,0,73.78,,
90606,4013F-10,0,0,0,73.78,,
90607,4013XF-10,0,0,0,84.49,,
90608,4014F-10,0,0,0,75.10,,
90609,4014XF-10,0,0,0,87.15,,
90610,5010F-10,0,0,0,89.20,,
90611,5012F-10,0,0,0,107.39,,
90612,5013F-10,0,0,0,120.91,,
90613,5014F-10,0,0,0,136.74,,
90614,6000-04S-11,1,1,0,26.63,,
90615,6000-06S-11,1,1,0,25.99,,
90616,6000-08S-11,2,2,0,28.68,,
90617,6000-10S-11,2,2,0,36.90,,
90621,6010-08S-11,2,2,0,28.68,,
90624,6010-10S-11,1,1,0,29.74,,
90625,6010-12S-11,3,3,0,19.99,,
90713,660-006CA,0,0,0,12.57,,
90714,660-006CC,0,0,0,12.57,,
90715,660-006G,0,0,0,12.57,,
90716,660-006GH,0,0,0,12.57,,
90717,660-006L,0,0,0,12.57,,
90718,660-006Y,0,0,0,12.57,,
90719,660-106CA,0,0,0,23.58,,
90720,660-106CC,2,2,0,23.58,,
90721,660-106G,4,4,0,23.58,,
90722,660-106GH,0,0,0,23.58,,
90723,660-106L,0,0,0,23.58,,
90724,660-106Y,0,0,0,23.58,,
90725,660-206CA,0,0,0,44.04,,
90726,660-206CC,1,1,0,44.04,,
90727,660-206G,3,3,0,44.04,,
90728,660-206GH,0,0,0,44.04,,
90729,660-206L,0,0,0,44.04,,
90730,660-206Y,0,0,0,44.04,,
90731,660-306CA,0,0,0,84.06,,
90732,660-306CC,0,0,0,84.06,,
90733,660-306G,0,0,0,84.06,,
90734,660-306GH,0,0,0,84.06,,
90735,660-306L,0,0,0,84.06,,
90736,660-306Y,0,0,0,84.06,,
90737,660-406CA,0,0,0,230.63,,
90738,660-406CC,0,0,0,230.63,,
90739,660-406G,0,0,0,230.63,,
90740,660-406GH,0,0,0,230.63,,
90741,660-406L,0,0,0,230.63,,
90742,660-406Y,0,0,0,230.63,,
90743,660-008CA,0,0,0,12.57,,
90744,660-008CC,0,0,0,12.57,,
90745,660-008G,0,0,0,12.57,,
90746,660-008GH,0,0,0,12.57,,
90747,660-008L,0,0,0,12.57,,
90748,660-008Y,0,0,0,12.57,,
90749,660-108CA,0,0,0,23.58,,
90750,660-108CC,0,0,0,23.58,,
90751,660-108G,0,0,0,23.58,,
90752,660-108GH,3,3,0,23.58,,
90753,660-108L,0,0,0,23.58,,
90754,660-108Y,0,0,0,23.58,,
90755,660-010CA,0,0,0,12.57,,
90756,660-010CC,2,2,0,12.57,,
90757,660-010G,0,0,0,12.57,,
90758,660-010GH,0,0,0,12.57,,
90759,660-010L,0,0,0,12.57,,
90760,660-010Y,0,0,0,12.57,,
90761,660-110CA,0,0,0,23.58,,
90762,660-110CC,9,9,0,23.58,,
90763,660-110G,6,6,0,23.58,,
90764,660-110GH,4,4,0,23.58,,
90765,660-110L,1,1,0,23.58,,
90766,660-110Y,0,0,0,23.58,,
90767,660-210CA,0,0,0,44.04,,
90768,660-210CC,2,2,0,44.04,,
90769,660-210G,7,7,0,38.27,,
90770,660-210GH,3,3,0,44.04,,
90771,660-210L,1,1,0,44.04,,
90772,660-210Y,0,0,0,44.04,,
90773,660-310CA,0,0,0,84.06,,
90774,660-310CC,0,0,0,84.06,,
90775,660-310G,0,0,0,84.06,,
90776,660-310GH,0,0,0,84.06,,
90777,660-310L,0,0,0,84.06,,
90778,660-310Y,0,0,0,84.06,,
90779,660-410CA,0,0,0,230.63,,
90780,660-410CC,0,0,0,230.63,,
90781,660-410G,0,0,0,230.63,,
90782,660-410GH,0,0,0,230.63,,
90783,660-410L,0,0,0,230.63,,
90784,660-410Y,0,0,0,230.63,,
90785,660-015CA,0,0,0,12.57,,
90786,660-015CC,0,0,0,12.57,,
90787,660-015G,0,0,0,12.57,,
90788,660-015GH,0,0,0,12.57,,
90789,660-015L,0,0,0,12.57,,
90790,660-015Y,0,0,0,12.57,,
90791,660-115CA,0,0,0,23.58,,
90792,660-115CC,0,0,0,23.58,,
90793,660-115G,1,1,0,23.58,,
90794,660-115GH,5,5,0,23.58,,
90795,660-115L,1,1,0,23.58,,
90796,660-115Y,0,0,0,23.58,,
90797,660-215CA,0,0,0,44.04,,
90798,660-215CC,2,2,0,44.04,,
90799,660-215G,2,2,0,44.04,,
90800,660-215GH,0,0,0,44.04,,
90801,660-215L,0,0,0,44.04,,
90802,660-215Y,0,0,0,44.04,,
90803,660-315CA,1,1,0,84.06,,
90804,660-315CC,1,1,0,84.06,,
90805,660-315G,0,0,0,84.06,,
90806,660-315GH,0,0,0,84.06,,
90807,660-315L,0,0,0,84.06,,
90808,660-315Y,0,0,0,84.06,,
90809,660-415CA,0,0,0,230.63,,
90810,660-415CC,1,1,0,230.63,,
90811,660-415G,0,0,0,230.63,,
90812,660-415GH,0,0,0,230.63,,
90813,660-415L,0,0,0,230.63,,
90814,660-415Y,0,0,0,230.63,,
90815,660-020CA,3,3,0,12.57,,
90816,660-020CC,3,3,0,12.57,,
90817,660-020G,1,1,0,12.57,,
90818,660-020GH,0,0,0,12.57,,
90819,660-020L,0,0,0,12.57,,
90820,660-020Y,1,1,0,12.57,,
90821,660-120CA,0,0,0,23.58,,
90822,660-120CC,1,1,0,23.58,,
90823,660-120G,8,8,0,23.58,,
90824,660-120GH,9,9,0,23.58,,
90825,660-120L,0,0,0,23.58,,
90826,660-120Y,2,2,0,23.58,,
90827,660-220CA,0,0,0,44.04,,
90828,660-220CC,0,0,0,44.04,,
90829,660-220G,8,8,0,44.04,,
90830,660-220GH,3,3,0,44.04,,
90831,660-220L,0,0,0,44.04,,
90832,660-220Y,0,0,0,44.04,,
90833,660-320CA,0,0,0,84.06,,
90834,660-320CC,0,0,0,84.06,,
90835,660-320G,0,0,0,84.06,,
90836,660-320GH,0,0,0,84.06,,
90837,660-320L,0,0,0,84.06,,
90838,660-320Y,0,0,0,84.06,,
90839,660-420CA,0,0,0,230.63,,
90840,660-420CC,0,0,0,230.63,,
90841,660-420G,0,0,0,230.63,,
90842,660-420GH,0,0,0,230.63,,
90843,660-420L,0,0,0,230.63,,
90844,660-420Y,0,0,0,230.63,,
90845,660-030CA,1,1,0,12.57,,
90846,660-030CC,0,0,0,12.57,,
90847,660-030G,0,0,0,12.57,,
90848,660-030GH,0,0,0,12.57,,
90849,660-030L,0,0,0,12.57,,
90850,660-030Y,0,0,0,12.57,,
90851,660-130CA,0,0,0,23.58,,
90852,660-130CC,2,2,0,23.58,,
90853,660-130G,6,6,0,23.58,,
90854,660-130GH,0,0,0,23.58,,
90855,660-130L,0,0,0,23.58,,
90856,660-130Y,0,0,0,23.58,,
90857,660-230CA,2,2,0,44.04,,
90858,660-230CC,3,3,0,44.04,,
90859,660-230G,16,16,0,44.04,,
90860,660-230GH,0,0,0,44.04,,
90861,660-230L,0,0,0,44.04,,
90862,660-230Y,0,0,0,44.04,,
90863,660-330CA,0,0,0,84.06,,
90864,660-330CC,0,0,0,84.06,,
90865,660-330G,0,0,0,84.06,,
90866,660-330GH,1,1,0,84.06,,
90867,660-330L,0,0,0,84.06,,
90868,660-330Y,0,0,0,84.06,,
90869,660-430CA,0,0,0,230.63,,
90870,660-430CC,0,0,0,230.63,,
90871,660-430G,0,0,0,230.63,,
90872,660-430GH,1,1,0,230.63,,
90873,660-430L,0,0,0,230.63,,
90874,660-430Y,0,0,0,230.63,,
90875,6012F-10,0,0,0,74.45,,
90876,6013F-10,0,0,0,78.86,,
90877,6014F-10,0,0,0,116.65,,
90878,6015F-10,0,0,0,120.65,,
90879,6016F-10,0,0,0,130.06,,
90880,6017F-10,0,0,0,138.08,,
90881,6018F-10,0,0,0,148.80,,
90882,61060F-10,0,0,0,21.70,,
90883,61061F-10,2,2,0,43.85,,
90884,70000F-10,0,0,0,13.38,,
90885,70000S-11,0,0,0,15.03,,
90886,70001F-10,0,0,0,19.61,,
90887,70001S-11,0,0,0,22.01,,
90889,70002F-10,0,0,0,23.66,,
90890,70002S-11,1,1,0,19.99,,
90891,70003F-10,0,0,0,25.70,,
90892,70003S-11,0,0,0,28.85,,
90893,70005F-10,0,0,0,27.79,,
90894,70005S-11,0,0,0,31.18,,
90895,70006F-10,0,0,0,41.56,,
90896,70006S-11,0,0,0,46.65,,
90897,70009F-10,0,0,0,20.71,,
90898,70009S-11,0,0,0,23.23,,
90899,RCLR,2,2,0,16.47,,
90900,RDS100,2,2,0,45.02,,
90901,70017S-11,0,0,0,237.84,,
90902,RESS7,3,3,0,33.21,,
90904,70018S-11,0,0,0,253.01,,
90905,RPRTC,3,3,0,34.45,,
90906,RPTC,10,10,0,17.64,,
90907,70019S-11,0,0,0,269.30,,
90908,RTC-1,0,0,0,31.76,,
90910,70020S-11,0,0,0,295.41,,
90911,RTC-6P136C,0,0,0,21.82,,
90912,70021S-11,0,0,0,307.35,,
90913,RTC-6PCHS,4,4,0,18.35,,
90914,70022S-11,0,0,0,324.70,,
90915,RTC-6PFSC,2,2,0,31.56,,
90916,70024S-11,0,0,0,357.31,,
90917,RTC-6SPLS,0,0,0,13.09,,
90918,70025S-11,0,0,0,375.76,,
90919,RTDS-15,27,27,0,49.95,,
90920,70112F-10,0,0,0,114.30,,
90921,70113F-10,0,0,0,117.63,,
90922,70114F-10,0,0,0,118.48,,
90923,70115F-10,0,0,0,124.34,,
90924,70117F-10,0,0,0,150.25,,
90925,70122F-10,0,0,0,114.30,,
90926,70124F-10,1,1,0,118.48,,
90927,70125F-10,0,0,0,124.34,,
90928,70126F-10,0,0,0,128.33,,
90929,7014F-10,0,0,0,142.11,,
90930,7015F-10,0,0,0,151.49,,
90931,7016F-10,0,0,0,162.20,,
90932,71016S-11,0,0,0,218.23,,
90933,71017S-11,0,0,0,222.58,,
90934,71018S-11,0,0,0,242.18,,
90935,679-1004C,0,0,0,76.94,,
90936,679-004C,2,2,0,19.23,,
90937,679-1006C,0,0,0,76.94,,
90938,679-006C,0,0,0,19.23,,
90939,679-1008C,0,0,0,76.94,,
90940,71019S-11,0,0,0,259.55,,
90941,679-008C,0,0,0,19.23,,
90942,679-1010C,1,1,0,76.94,,
90943,679-010C,0,0,0,19.23,,
90944,679-1012C,1,1,0,76.94,,
90945,679-012C,2,2,0,19.23,,
90946,679-1014C,0,0,0,88.48,,
90947,679-014C,2,2,0,21.53,,
90948,679-1017C,1,1,0,111.57,,
90949,679-017C,0,0,0,26.93,,
90950,71020S-11,0,0,0,282.35,,
90951,679-1020C,1,1,0,123.12,,
90952,679-020C,0,0,0,30.77,,
90953,679-1025C,0,0,0,138.50,,
90954,OCTAFG3012,0,0,0,800.75,,
90955,OCTAFG3024,0,0,0,800.75,,
90956,71021S-11,0,0,0,297.51,,
90957,679-025C,0,0,0,34.60,,
90958,679-1030C,1,1,0,153.90,,
90959,71023S-11,0,0,0,347.50,,
90960,679-030C,0,0,0,38.47,,
90961,FL10012,1,1,0,9.70,,
90962,FL10018,1,1,0,9.70,,
90963,FL15012,3,3,0,9.70,,
90964,71112F-10,0,0,0,114.30,,
90965,FL15018,5,5,0,9.70,,
90966,FL8012,3,3,0,9.70,,
90967,FL8018,3,3,0,9.70,,
90968,71113F-10,0,0,0,117.63,,
90969,71114F-10,0,0,0,118.48,,
90970,71115F-10,0,0,0,124.34,,
90971,71116EXF-10,0,0,0,159.44,,
90972,71116F-10,0,0,0,137.71,,
90973,71117F-10,0,0,0,150.25,,
90974,TLM506,0,0,0,7.03,,
90975,TLM5012,3,3,0,10.40,,
90977,TLM7512,5,5,0,12.31,,
90979,TLS156,13,13,0,6.94,,
90980,TLS1512,0,0,0,9.36,,
90981,TLS306,0,0,0,6.42,,
90982,TLS3012,0,0,0,9.69,,
90983,BGC8BD,0,0,0,13.56,,
90984,BGC8BLKPRPL,0,0,0,13.56,,
90985,BGC8BLPS,2,2,0,13.56,,
90986,BGC8BO,4,4,0,13.56,,
90987,BGC8HW,4,4,0,13.56,,
90988,BGC8LU,3,3,0,13.56,,
90989,BGC8PW,3,3,0,13.56,,
90990,BGC8RBLK,2,2,0,13.56,,
90994,71118S-11,0,0,0,198.53,,
90995,71119EXS-11,0,0,0,261.45,,
90996,71121EXS-11,0,0,0,303.94,,
90997,71122EXS-11,0,0,0,309.18,,
90998,71123EXS-11,0,0,0,315.14,,
90999,71124EXS-11,0,0,0,319.65,,
91000,71216F-10,0,0,0,222.98,,
91001,71217F-10,0,0,0,233.94,,
91002,71218NF-10,0,0,0,217.80,,
91003,71218F-10,0,0,0,237.95,,
91004,71219NS-11,0,0,0,284.01,,
91005,71219S-11,0,0,0,310.19,,
91006,71220NS-11,0,0,0,301.50,,
91007,71220S-11,0,0,0,327.71,,
91009,71221NS-11,0,0,0,318.81,,
91010,71221S-11,0,0,0,345.01,,
91011,71222NS-11,0,0,0,337.70,,
91012,71222S-11,0,0,0,363.91,,
91013,71223NS-11,0,0,0,355.19,,
91014,71223S-11,0,0,0,381.36,,
91015,71224NS-11,0,0,0,375.56,,
91016,71224S-11,0,0,0,401.76,,
91017,71418XS-11,0,0,0,290.46,,
91018,71419XS-11,0,0,0,303.94,,
91020,71420XS-11,0,0,0,317.41,,
91022,71421XS-11,0,0,0,329.45,,
91023,71513S-11,0,0,0,197.86,,
91024,71515S-11,0,0,0,212.31,,
91025,72215F-10,0,0,0,215.86,,
91026,72216F-10,0,0,0,220.49,,
91027,72217NF-10,0,0,0,230.83,,
91028,72217F-10,0,0,0,225.26,,
91029,72218NF-10,0,0,0,235.80,,
91030,72218F-10,0,0,0,229.95,,
91031,72316F-10,0,0,0,233.19,,
91032,72317F-10,0,0,0,238.28,,
91033,72318F-10,0,0,0,240.14,,
91034,010-12390-43,0,0,0,22.49,,
91035,010-11425-13,0,0,0,29.98,,
91036,72319S-11,0,0,0,306.31,,
91037,72320S-11,0,0,0,326.10,,
91038,72321S-11,0,0,0,356.84,,
91039,72418F-10,0,0,0,240.14,,
91040,74016F-10,0,0,0,146.90,,
91041,74017F-10,0,0,0,155.28,,
91042,74018F-10,0,0,0,166.14,,
91057,74099S-11,0,0,0,201.95,,
91061,74100S-11,0,0,0,205.23,,
91063,74101S-11,0,0,0,217.16,,
91064,74102S-11,0,0,0,238.90,,
91065,74103S-11,0,0,0,260.59,,
91066,74118F-10,0,0,0,166.14,,
91067,74119F-10,0,0,0,183.73,,
91068,74120F-10,0,0,0,192.93,,
91069,74121S-11,0,0,0,246.48,,
91070,74200F-10,0,0,0,119.43,,
91071,74201EXF-10,0,0,0,134.33,,
91072,74201F-10,0,0,0,120.18,,
91073,74202F-10,0,0,0,129.38,,
91074,74203F-10,0,0,0,140.24,,
91075,74204F-10,0,0,0,146.90,,
91076,74205F-10,0,0,0,148.59,,
91077,74300F-10,0,0,0,134.45,,
91078,74303F-10,1,1,0,87.99,,
91079,74305F-10,0,0,0,142.24,,
91080,74321S-11,0,0,0,255.19,,
91081,74324S-11,0,0,0,287.80,,
91082,74325S-11,0,0,0,300.80,,
91083,74326S-11,0,0,0,313.84,,
91084,74327S-11,0,0,0,331.25,,
91085,74328S-11,0,0,0,348.61,,
91086,74329S-11,0,0,0,365.94,,
91087,74421S-11,0,0,0,252.78,,
91088,74519S-11,0,0,0,452.48,,
91089,74520S-11,0,0,0,465.85,,
91090,74521S-11,0,0,0,483.46,,
91091,74522S-11,0,0,0,500.60,,
91092,74523S-11,0,0,0,508.59,,
91093,75119S-11,0,0,0,251.96,,
91094,75121S-11,0,0,0,288.85,,
91095,75122S-11,0,0,0,308.43,,
91096,"UC128-SVS 1P",2,0,2,726.44,,
91098,77014S-11,0,0,0,159.60,,
91099,77015S-11,0,0,0,178.08,,
91100,77016S-11,0,0,0,195.48,,
91101,77017S-11,0,0,0,208.49,,
91102,77018S-11,0,0,0,223.70,,
91103,77019S-11,0,0,0,234.56,,
91104,77020S-11,0,0,0,274.76,,
91105,77021S-11,0,0,0,298.68,,
91106,77022S-11,0,0,0,313.84,,
91107,77024S-11,0,0,0,342.09,,
91108,77116S-11,0,0,0,195.48,,
91109,77117S-11,0,0,0,208.49,,
91110,77118S-11,0,0,0,219.25,,
91111,77119S-11,0,0,0,229.90,,
91112,77120S-11,0,0,0,274.76,,
91113,77121S-11,0,0,0,298.68,,
91114,77122S-11,0,0,0,313.84,,
91115,77123S-11,0,0,0,327.95,,
91116,77124S-11,0,0,0,342.09,,
91117,77125S-11,0,0,0,360.53,,
91118,77216S-11,0,0,0,199.80,,
91119,77217S-11,0,0,0,211.73,,
91120,77218S-11,0,0,0,225.85,,
91121,77219S-11,0,0,0,244.33,,
91122,77220S-11,0,0,0,255.19,,
91123,77221S-11,0,0,0,262.80,,
91124,77316F-10,0,0,0,160.29,,
91125,77317F-10,0,0,0,171.14,,
91126,77318F-10,0,0,0,187.06,,
91127,77319F-10,0,0,0,196.25,,
91128,77320F-10,0,0,0,204.60,,
91129,77516S-11,0,0,0,329.04,,
91130,77518S-11,0,0,0,357.31,,
91131,77519S-11,0,0,0,363.63,,
91132,77520S-11,0,0,0,371.41,,
91133,77521S-11,0,0,0,387.73,,
91134,77522S-11,0,0,0,398.58,,
91135,77523S-11,0,0,0,413.78,,
91136,77524S-11,0,0,0,419.19,,
91137,77616S-11,0,0,0,312.61,,
91138,77618S-11,0,0,0,357.31,,
91139,77620S-11,0,0,0,371.41,,
91140,77622S-11,0,0,0,398.58,,
91141,77623S-11,0,0,0,413.78,,
91142,77624S-11,0,0,0,419.19,,
91143,77626S-11,0,0,0,447.45,,
91144,77718S-11,0,0,0,238.90,,
91145,77719S-11,0,0,0,262.78,,
91146,77720S-11,0,0,0,306.25,,
91147,77721S-11,0,0,0,329.04,,
91149,77722S-11,0,0,0,347.50,,
91150,77723S-11,0,0,0,361.63,,
91151,77724S-11,0,0,0,383.35,,
91152,77814F-10,0,0,0,132.68,,
91153,77815F-10,0,0,0,141.06,,
91154,77816EF-10,0,0,0,153.28,,
91155,77816F-10,0,0,0,146.90,,
91156,77817EF-10,0,0,0,159.24,,
91157,77817F-10,0,0,0,154.40,,
91158,77818EF-10,0,0,0,182.54,,
91159,77818F-10,0,0,0,166.44,,
91160,77819EF-10,0,0,0,190.05,,
91161,77918F-10,0,0,0,195.78,,
91162,77919F-10,0,0,0,214.56,,
91163,79015F-10,0,0,0,245.60,,
91164,79016F-10,0,0,0,255.70,,
91165,79017F-10,0,0,0,252.55,,
91166,79018F-10,0,0,0,257.91,,
91167,79019F-10,0,0,0,268.64,,
91170,79020XS-11,0,0,0,385.74,,
91171,79118S-11,0,0,0,306.96,,
91172,79119S-11,0,0,0,320.95,,
91173,79120S-11,0,0,0,327.89,,
91174,79120XS-11,0,0,0,367.34,,
91175,79121S-11,0,0,0,341.85,,
91176,79121XS-11,0,0,0,382.08,,
91177,7INF10BF-10,0,0,0,118.90,,
91178,7INF10F-10,0,0,0,117.71,,
91179,7INF11BF-10,0,0,0,120.48,,
91180,7INF11F-10,0,0,0,119.35,,
91181,7INF12BF-10,0,0,0,133.54,,
91182,7INF12F-10,0,0,0,133.11,,
91184,7INF13BF-10,0,0,0,142.08,,
91185,7INF13F-10,0,0,0,142.08,,
91186,7INF14BF-10,0,0,0,152.86,,
91187,7INF14F-10,0,0,0,153.43,,
91188,7INF15F-10,0,0,0,164.79,,
91189,7INF8BF-10,0,0,0,116.81,,
91190,7INF9BF-10,0,0,0,116.84,,
91191,7INF9F-10,0,0,0,116.86,,
91192,81119S-11,0,0,0,350.15,,
91193,81120S-11,0,0,0,368.79,,
91194,81121S-11,0,0,0,384.91,,
91195,81122S-11,0,0,0,404.70,,
91196,81123S-11,0,0,0,407.99,,
91197,82121S-11,0,0,0,404.03,,
91198,82122S-11,0,0,0,423.84,,
91199,82123S-11,0,0,0,427.16,,
91200,83118S-11,0,0,0,328.76,,
91201,83119S-11,0,0,0,333.08,,
91202,83120S-11,0,0,0,337.38,,
91203,83121S-11,0,0,0,364.63,,
91204,53012,0,0,0,36.88,,
91205,53013,1,1,0,43.64,,
91206,53014,0,0,0,50.10,,
91207,84012F-10,0,0,0,57.70,,
91208,84013F-10,0,0,0,82.44,,
91209,90019S-11,0,0,0,630.91,,
91210,90020S-11,0,0,0,646.86,,
91211,90021S-11,0,0,0,662.78,,
91212,90022S-11,0,0,0,678.73,,
91213,90023S-11,0,0,0,694.68,,
91214,90024S-11,0,0,0,710.64,,
91215,90025S-11,0,0,0,726.58,,
91216,90026S-11,0,0,0,742.53,,
91217,90027S-11,0,0,0,788.08,,
91218,90028S-11,0,0,0,833.64,,
91219,95120S-11,0,0,0,374.63,,
91220,95121S-11,0,0,0,390.91,,
91221,95122S-11,0,0,0,407.19,,
91222,95123S-11,0,0,0,423.48,,
91223,95124S-11,0,0,0,439.76,,
91224,95125S-11,0,0,0,456.04,,
91225,96122S-11,0,0,0,536.86,,
91226,97019S-11,0,0,0,373.00,,
91227,97020S-11,0,0,0,416.89,,
91228,97021S-11,0,0,0,434.41,,
91229,97118S-11,1,1,0,254.99,,
91230,97119S-11,0,0,0,351.05,,
91231,97120S-11,0,0,0,373.00,,
91232,97121S-11,0,0,0,394.94,,
91233,97122S-11,0,0,0,412.49,,
91234,97123S-11,0,0,0,421.29,,
91235,97124S-11,0,0,0,449.76,,
91238,INFCC10BNF-10,0,0,0,154.28,,
91239,INFCC11BNF-10,0,0,0,157.98,,
91240,INFCC12BNF-10,0,0,0,159.44,,
91241,INFCC12DRF-10,0,0,0,169.76,,
91242,INFCC13BNF-10,0,0,0,161.69,,
91243,INFCC13DRF-10,0,0,0,169.76,,
91244,INFCC14BNF-10,0,0,0,140.04,,
91245,INFCC14BF-10,0,0,0,167.64,,
91246,INFCC14DRF-10,0,0,0,176.05,,
91247,INFCC15BF-10,0,0,0,197.09,,
91248,INFCC15DRS-11,0,0,0,245.38,,
91249,INFCC16DRS-11,0,0,0,268.13,,
91250,INFCC17DRS-11,0,0,0,274.93,,
91251,INFCC18DRS-11,0,0,0,279.54,,
91252,INFCC19BS-11,0,0,0,286.34,,
91253,INFCC19DRS-11,0,0,0,286.34,,
91254,INFCC20DRS-11,0,0,0,290.86,,
91255,INFCC21DRS-11,0,0,0,302.28,,
91260,PP5200-20,0,0,0,392.72,,
91262,PP5920-10,0,0,0,414.53,,
91263,BPP900455070,14,0,14,262.51,,323.85
91264,BPP900465050,5,2,3,12.40,,15.30
91265,BPP900465070,37,20,17,24.11,,29.75
91266,BPP900460050,3,1,2,19.98,,24.65
91267,BMS800200104,1,0,1,31.69,,39.10
91269,MO716,0,0,0,11.49,,
91280,010-02635-00,0,0,0,239.99,,
91281,010-02635-02,0,0,0,279.98,,
91284,740172-1,1,0,1,45.45,,
91285,740164-1,2,2,0,45.45,,
91287,V12-9980CP100-1,0,0,0,258.42,,
91288,9000S-11,0,0,0,131.13,,
91289,9001S-11,0,0,0,131.13,,
91290,9002S-11,0,0,0,123.84,,
91291,9003S-11,0,0,0,152.98,,
91292,9004S-11,0,0,0,114.74,,
91293,9005S-11,0,0,0,152.98,,
91294,DST810PV-N2,8,3,5,318.47,,
91295,048-054,2,2,0,2.42,,
91296,M3-TD32,2,0,2,239.99,293.60,
91299,010-12531-20,0,0,0,29.51,,
91301,010-12531-21,0,0,0,21.07,,
91306,503100-700-030-22,1,1,0,39.99,,
91307,503100-700-040-22,0,0,0,53.33,,
91308,503100-700-050-22,0,0,0,53.33,,
91309,503100-700-060-22,0,0,0,53.33,,
91310,503100-700-070-22,0,0,0,53.33,,
91311,503200-700-030-22,0,0,0,44.00,,
91312,503200-700-040-22,0,0,0,44.00,,
91313,503200-700-050-22,4,2,2,44.00,,
91314,503200-700-060-22,0,0,0,44.00,,
91315,503200-700-070-22,0,0,0,44.00,,
91316,502900-701-030-22,0,0,0,37.33,,
91317,502900-701-040-22,0,0,0,37.33,,
91318,502900-701-050-22,0,0,0,37.33,,
91319,502900-701-060-22,2,0,2,37.33,,
91320,502900-701-070-22,0,0,0,37.33,,
91321,503000-701-030-22,0,0,0,30.67,,
91322,503000-701-040-22,0,0,0,30.67,,
91323,503000-701-050-22,0,0,0,30.67,,
91324,503000-701-060-22,0,0,0,30.67,,
91325,503000-701-070-22,0,0,0,30.67,,
91326,104400-105-001-22,0,0,0,15.44,,
91327,104200-300-000-22,0,0,0,21.00,,
91328,112400-100-000-22,0,0,0,21.07,,
91329,112400-505-000-22,3,0,3,21.07,,
91330,112200-100-001-22,0,0,0,21.07,,
91331,112200-600-001-22,0,0,0,21.07,,
91332,112200-105-002-22,6,0,6,21.07,,
91333,112200-500-002-22,12,6,6,21.07,,
91334,112200-701-010-22,4,2,2,25.67,,
91335,112200-505-010-22,3,2,1,25.67,,
91336,112200-100-030-22,0,0,0,25.67,,
91337,112200-100-050-22,5,2,3,25.67,,
91338,112200-100-080-22,1,1,0,25.67,,
91339,112200-100-110-22,0,0,0,25.67,,
91340,112200-500-030-22,8,3,5,18.99,,
91341,112200-500-050-22,1,0,1,21.99,,
91342,112200-500-080-22,0,0,0,25.67,,
91343,112200-500-110-22,0,0,0,25.67,,
91344,112200-505-030-22,0,0,0,25.67,,
91345,112200-505-050-22,2,0,2,18.99,,
91346,112200-505-080-22,0,0,0,25.67,,
91347,112000-100-004-22,0,0,0,23.00,,
91348,112000-100-005-22,0,0,0,23.00,,
91349,142100-300-000-22,0,0,0,32.67,,
91350,142100-500-001-22,0,0,0,32.67,,
91351,142100-600-001-22,7,6,1,32.67,,
91352,142100-100-002-22,6,0,6,32.67,,
91353,142100-105-002-22,6,0,6,32.67,,
91354,142400-400-009-22,12,5,7,35.99,,
91355,142100-505-030-22,1,1,0,42.67,,
91356,142100-505-050-22,0,0,0,42.67,,
91357,142100-701-030-22,3,0,3,32.99,,
91358,142100-701-050-22,1,1,0,42.67,,
91359,142100-701-080-22,4,0,4,32.99,,
91360,142100-500-030-22,3,0,3,31.99,,
91361,142100-500-050-22,2,0,2,29.99,,
91362,142100-500-080-22,0,0,0,42.67,,
91363,142200-505-000-22,0,0,0,42.00,,
91364,142200-500-000-22,0,0,0,42.00,,
91366,142500-105-001-22,0,0,0,42.00,,
91367,142500-500-001-22,4,0,4,42.00,,
91368,142500-105-002-22,0,0,0,42.00,,
91369,142500-100-002-22,0,0,0,42.00,,
91370,142500-105-810-22,4,0,4,37.99,,
91371,142500-105-820-22,3,0,3,46.99,,
91372,142500-105-830-22,0,0,0,61.33,,
91373,142500-105-840-22,0,0,0,61.33,,
91374,142500-105-850-22,0,0,0,61.33,,
91376,142500-701-030-22,0,0,0,61.33,,
91377,142500-701-040-22,0,0,0,61.33,,
91378,142500-701-050-22,0,0,0,61.33,,
91379,142500-701-060-22,0,0,0,61.33,,
91380,142500-100-020-22,0,0,0,61.33,,
91381,142500-100-030-22,0,0,0,61.33,,
91382,142500-100-040-22,2,2,0,46.99,,
91383,142500-100-050-22,0,0,0,61.33,,
91384,142500-100-060-22,0,0,0,61.33,,
91385,142500-100-070-22,0,0,0,61.33,,
91386,142500-400-030-22,0,0,0,61.33,,
91387,142500-400-040-22,0,0,0,61.33,,
91388,142500-400-050-22,0,0,0,61.33,,
91389,142500-400-060-22,0,0,0,61.33,,
91390,303400-100-002-21,0,0,0,247.50,,
91391,302200-100-002-21,0,0,0,125.63,,
91392,302200-300-003-21,0,0,0,157.50,,
91393,302400-100-002-21,1,1,0,114.38,,
91394,302400-500-003-21,0,0,0,143.75,,
91395,302000-400-001-21,0,0,0,71.25,,
91396,302900-500-002-21,0,0,0,166.25,,
91398,340800-500-999-21,0,0,0,15.36,,
91399,341100-300-999-21,0,0,0,19.64,,
91400,341000-300-999-21,0,0,0,15.71,,
91401,340100-702-999-21,3,0,3,15.71,,
91402,310100-700-999-12,5,5,0,17.99,,
91403,310000-700-999-12,3,3,0,12.99,,
91404,310300-700-999-12,0,0,0,33.33,,
91405,310200-700-999-21,4,0,4,13.99,,
91424,TM265C-LM-12F,0,0,0,1543.75,,
91425,0343-BK,1,1,0,19.94,,
91426,FVC080391230Q00,2,2,0,384.77,,
91427,51502,10,5,5,10.69,,
91428,51501,7,2,5,11.51,,
91429,550030,0,0,0,260.75,,
91430,758000,0,0,0,20.32,,
91431,758201,0,0,0,84.70,,
91432,CMD6-MDR-BR,3,1,2,112.50,,
91433,CMD6-MBR-BR,0,0,0,112.50,,
91434,CMD6-MDR-R,0,0,0,112.50,,
91435,CMD6-MBR-R,0,0,0,112.50,,
91436,OCTAFMDRSSYS8,0,0,0,1234.58,,
91438,9602,0,0,0,288.08,,
91439,SSM-517A,30,15,15,29.65,,
91441,A80589,1,0,1,129.16,,
91452,20128,0,0,0,25.56,,
91453,A10-1290CN,8,3,5,56.25,,
91455,958130511,0,0,0,215.19,,
91456,958130611,1,1,0,215.19,,
91457,958130641,0,0,0,215.19,,
91458,958130451,0,0,0,240.51,,
91459,958128811,0,0,0,24.05,,
91460,85-741-BL,0,0,0,49.94,,
91461,85-741-WT,2,0,2,49.94,,
91467,MFR-5,1,0,1,1300.00,1840.50,
91471,G210608,5,0,5,21.68,,
91475,102408,0,0,0,20.69,,
91476,102416,0,0,0,23.88,,
91482,XT-SF-250-DV-KIT,0,0,0,1227.61,1444.00,
91483,LLB-63AS-01-00,0,0,0,13.72,,
91484,09-707B-1,0,0,0,29.63,,
91486,X3002,4,0,4,5.13,,
91487,X210200,4,0,4,8.46,,
91488,P7185400AJ,0,0,0,54.46,,
91489,P7187200AJ,0,0,0,41.90,,
91490,P7188700AJ,0,0,0,46.08,,
91491,P7702200AJ,0,0,0,22.19,,
91492,CA-0005-SS,4,2,2,140.43,,
91493,CA-0004-15SS,4,2,2,126.39,,
91494,CA-0008-SS,7,4,3,126.39,,
91495,CA-0127-SS,6,2,4,137.22,,
91496,CA-0128-SS,4,2,2,137.22,,
91497,CA-0122-SS,5,3,2,137.22,,
91498,013017,2,0,2,517.65,,
91502,FFKIT,0,0,0,25.34,,
91503,SG230,4,0,4,264.85,311.00,
91505,SG2-0130,0,0,0,157.03,185.00,
91559,69041,3,0,3,45.95,,
91663,69044,1,0,1,44.68,,
91665,270167-1,2,0,2,18.24,,
91671,22007,20,12,8,5.27,6.97,
91672,22405,22,10,12,8.88,12.99,
91673,550103NE,1,1,0,439.50,,
91674,44320305,0,0,0,716.00,,895.00
91675,30251,25,3,22,19.62,29.99,
91723,EX650,0,0,0,149.14,,
91724,G-1-GRAPHITE,2,2,0,7.99,,
91725,G-2-GRAPHITE,0,0,0,15.73,,
91726,G-3-GRAPHITE,5,1,4,18.94,,
91727,G-4-GRAPHITE,2,0,2,20.99,,
91728,G-5-GRAPHITE,1,1,0,38.99,,
91729,G-6-GRAPHITE,8,4,4,73.13,,
91730,HTM-1-GRAPHITE,6,6,0,30.99,,
91731,HTM-2-GRAPHITE,0,0,0,51.40,,
91732,HTM-3-GRAPHITE,0,0,0,91.23,,
91733,HTM-4-GRAPHITE,0,0,0,134.63,,
91806,P12848-100GR-MS,0,0,0,340.00,,
91807,P12848-200-MS,1,1,0,201.45,,
91808,P12848-100-MS,0,0,0,362.67,,
91811,0140-1729,6,6,0,5.19,,
91812,0140-0014,4,0,4,3.70,,
91813,0140-0006,42,21,21,3.05,,3.99
91818,ZIPK8N2,0,0,0,771.25,,
91819,SCC125110412,0,0,0,496.77,,612.85
91831,32-77,2,0,2,226.19,,
91832,20408000,0,0,0,6.56,,
91834,ZDIG4GX-US,2,1,1,1199.96,,
91835,12444,0,0,0,201.76,,
91838,33-351-01,0,0,0,101.09,,
91846,SD1829B,3,3,0,224.76,,
91847,SD1829G,4,4,0,224.76,,
91848,SD1829N,1,0,1,224.76,,
91849,SD1842B,7,4,3,269.88,,
91850,SD1842G,0,0,0,269.88,,
91851,SD1842N,2,2,0,269.88,,
91852,SD1858B,6,2,4,314.99,,
91853,SD1858G,7,5,2,314.99,,
91854,SD1858N,0,0,0,314.99,,
91855,SD2442B,0,0,0,360.14,,
91856,SD2442G,0,0,0,360.14,,
91857,SD2442N,0,0,0,360.14,,
91863,P13168-1300TEBCL,0,0,0,151.11,,
91864,P13168-1300TEBK,0,0,0,151.11,,
91865,P13168-1300TEBGR,0,0,0,151.11,,
91866,P13198-2380TEBCL,0,0,0,377.81,,
91867,P13198-2380TEBBK,0,0,0,377.81,,
91868,P13198-2380TEBGR,0,0,0,377.81,,
91869,P13198-2500TEBCL,0,0,0,377.81,,
91870,P13198-2500TEBBK,0,0,0,377.81,,
91871,P13198-2500TEBGR,0,0,0,377.81,,
91872,P13276-1000TEBCL,0,0,0,1205.36,,
91873,P13276-1000TEBBK,0,0,0,1205.36,,
91874,P13276-1000TEBGR,0,0,0,1205.36,,
91878,FSBL20612FY7A00,0,0,0,1433.85,,
91880,FSBL20912FY7A00,0,0,0,1654.56,,
91900,806-1883,0,0,0,1109.42,,
91903,LLB-33OW-81-OT,0,0,0,55.59,,
91906,VSRT-15,0,0,0,4484.00,,
91907,VSRT-17,0,0,0,5876.00,,
91908,VSRT-19,0,0,0,6464.00,,
91909,VSRT-21W,0,0,0,6611.00,,
91910,CD-19T,0,0,0,2837.50,,
91911,CD-24T,0,0,0,3473.00,,
91913,CD-26T,0,0,0,3988.00,,
91914,SRT-10,0,0,0,2100.35,,
91915,SRT-12,1,0,1,2199.99,,
91916,SRT-15,0,0,0,3149.36,,
91917,00108,1,1,0,269.22,,389.00
91918,00110,2,2,0,269.22,,389.00
91919,SRT-17,0,0,0,3528.59,,
91920,00112,6,6,0,269.22,,389.00
91921,SRT-19,1,0,1,3899.99,,
91922,SRT-24,0,0,0,4515.86,,
91923,SRT-15W,0,0,0,3528.59,,
91924,SRT-185W,0,0,0,4339.00,,
91925,SRT-21W,0,0,0,4410.74,,
91926,SRT-24W-1080,0,0,0,4515.86,,
91927,SRT-27,0,0,0,4795.00,,
91928,PHT-12,0,0,0,1838.68,,
91929,PHT-15,0,0,0,1910.99,,
91930,PHT-17,0,0,0,2132.11,,
91931,PHT-19,0,0,0,2205.22,,
91932,PHT-24,0,0,0,3112.94,,
91933,PHT-15W,0,0,0,2237.31,,
91934,PHT-185W,0,0,0,2447.00,,
91935,PHT-21W,0,0,0,3211.76,,
91936,PHT-24W-1080,0,0,0,3285.88,,
91937,PHT-27W,0,0,0,3285.00,,
91942,IND-19,0,0,0,2731.54,,
91943,IND-24W,0,0,0,3667.50,,
91954,PIN125010510,0,0,0,116.44,,143.65
91955,013016,0,0,0,478.26,,
91956,013018,0,0,0,478.26,,
91957,013024,1,0,1,478.26,,
91958,VBS127010010,4,1,3,28.25,,34.85
91959,AQL4029RB,4,1,3,26.39,,
91960,LLB-53R4-01-00,3,2,1,36.00,,
91961,453382,1,0,1,4.68,,
91962,453386,6,3,3,32.27,,
91963,453502,0,0,0,9.09,,
91964,453506,6,3,3,39.29,,
91965,453752,0,0,0,10.35,,
91966,453756,5,3,2,54.41,,
91967,453901,0,0,0,9.98,,
91968,453906,6,2,4,78.18,,
91969,452251,0,0,0,5.33,,
91971,452381,0,0,0,6.20,,
91972,452385,25,10,15,41.08,,
91973,452501,0,0,0,7.55,,
91974,452505,6,4,2,50.72,,
91975,452751,0,0,0,12.49,,
91976,452755,0,0,0,85.87,,
91977,452900,0,0,0,10.25,,
91978,452905,0,0,0,137.11,,
91980,HCE50K-GRAY,0,0,0,27.51,,
91981,HCE25SW-GRAY,0,0,0,110.08,,
91982,HCE50SW-GRAY,11,9,2,122.31,,
91983,WN515,9,9,0,4.88,,
91988,MAHC-BP,8,5,3,13.86,,
91989,FHAS100-BP,6,4,2,6.60,,
91990,FHMS200-BP,10,5,5,6.60,,
92044,23901-80293,2,0,2,16.69,,
92048,FX-16-AS,0,0,0,324.65,,
92049,FX-115,1,1,0,1234.34,,
92050,MOFCR-25FT.4CH,0,0,0,23.25,,39.95
92051,MOFCR-6FT.4CH,0,0,0,13.25,,21.95
92052,MOFCR-25FT,0,0,0,13.25,,21.95
92053,MOFCR-12FT,2,0,2,10.00,,16.95
92054,MOFCR-6FT,0,0,0,8.25,,13.95
92055,MOFCR-3FT,0,0,0,7.00,,11.95
92056,MOFCR-1F2M,2,0,2,5.00,,9.95
92057,MOFCR-2F1M,1,0,1,5.00,,9.95
92059,221600,0,0,0,118.90,,
92060,PRS,0,0,0,40.63,,
92065,RT022,0,0,0,31.65,,56.99
92072,RT057,0,0,0,59.99,,107.99
92074,011-A592-7,0,0,0,13.54,,
92075,011-E592-7,0,0,0,26.29,,
92079,21620006,0,0,0,2604.13,,
92080,20130017,0,0,0,2047.50,,
92081,10110009B,0,0,0,3651.06,,
92084,A80653,12,4,8,179.16,,
92085,A80658,11,4,7,179.16,,
92086,DC-2500-KIT-XL,0,0,0,273.41,394.60,
92088,SSP-200-KIT,0,0,0,340.00,490.70,
92089,81300200,0,0,0,369.34,,
92092,PPLI28PV,2,2,0,629.00,,729.95
92093,PPLI30BB,0,0,0,696.00,,809.95
92097,RF7110,5,2,3,102.21,135.15,
92098,RF7120,0,0,0,105.63,139.67,
92099,RF7210,0,0,0,118.29,156.40,
92100,RF7220,3,1,2,126.36,167.08,
92101,RF7310,0,0,0,147.21,194.65,
92102,RF7320,0,0,0,147.09,194.48,
92105,134402-200-004-21,0,0,0,202.54,,
92108,1020SF,0,0,0,50.83,,
92109,27627,19,10,9,61.57,114.99,
92110,27647,21,8,13,65.39,114.99,
92116,610564,2,1,1,8.40,,
92117,610565,0,0,0,8.40,,
92118,577359,140,97,43,13.99,,
92119,769,185,80,105,18.34,,
92120,778,486,191,295,18.34,,
92121,432053,73,43,30,10.00,,
92122,432029,42,24,18,10.00,,
92123,613773,8,7,1,16.99,,
92124,609801,5,0,5,38.52,,
92125,609802,0,0,0,45.82,,
92126,606127,1,0,1,37.23,,
92127,SCC115060211,4,2,2,284.56,,351.05
92128,658975,0,0,0,39.48,,
92129,648707,39,0,39,4.50,,
92130,605354,28,0,28,4.50,,
92131,605353,0,0,0,4.50,,
92132,658978,64,14,50,11.19,,
92133,648702,21,21,0,11.19,,
92134,648701,25,0,25,11.19,,
92135,91283,24,11,13,14.99,,
92137,108616,23,12,11,22.80,,
92139,91572,61,41,20,56.87,,
92140,122775,12,4,8,166.89,,
92141,451588,52,31,21,54.99,,
92142,473594,0,0,0,222.69,,
92144,606547,7,2,5,123.30,,
92145,606128,14,4,10,123.12,,
92146,606126,0,0,0,104.09,,
92147,648910,0,0,0,107.45,,
92149,JPZ-4-DP,0,0,0,353.45,,
92150,JPZ-6-DP,0,0,0,367.66,,
92151,JPZ-10-DP,0,0,0,490.68,,
92152,JPZ-12-DP,0,0,0,604.34,,
92153,JPZHSP-6,0,0,0,48.73,,
92154,JPZHSP-8,0,0,0,53.80,,
92155,JPZHSP-10,3,2,1,57.12,,
92156,JPZ-8-DP,0,0,0,434.82,,
92157,APM-12,0,0,0,65.74,80.99,
92158,APM-24,7,1,6,73.04,89.99,
92168,4148-163-E75,2,0,2,233.23,,
92170,4230175,0,0,0,1319.74,,
92171,PP5030-03,0,0,0,399.99,,
92172,UC128TS-2,8,1,7,484.07,,
92175,GP1040-52,0,0,0,334.53,,
92176,GP1080-15,0,0,0,385.44,,
92177,GP1080-31,0,0,0,385.44,,
92178,GP1080-33,0,0,0,385.44,,
92179,GP1080-35,0,0,0,385.44,,
92180,GP1170-25,0,0,0,385.44,,
92181,GP2030-02,0,0,0,363.62,,
92182,GP2050-15,0,0,0,327.26,,
92183,GP2050-22,0,0,0,327.26,,
92184,GP2050-26,0,0,0,327.26,,
92185,GP2050-33,0,0,0,327.26,,
92186,GP2050-60,0,0,0,327.26,,
92187,GP2200-20,0,0,0,363.62,,
92188,GP2920-01,0,0,0,392.72,,
92189,PP4400-15,0,0,0,269.08,,
92190,PP4600-08,0,0,0,305.44,,
92191,PP4800-14,0,0,0,356.35,,
92192,PP5050-26,0,0,0,370.90,,
92193,PP5100-02,0,0,0,356.35,,
92194,PP5920-00,0,0,0,399.99,,
92195,PP5920-06,0,0,0,414.53,,
92196,PP5920-07,0,0,0,414.53,,
92197,PP5920-13,0,0,0,414.53,,
92198,RMX4400-12,0,0,0,334.53,,
92199,RMX4400-15,0,0,0,392.72,,
92200,RMX4500-09,0,0,0,399.99,,
92201,RMX4500-14,0,0,0,399.99,,
92202,2375002/3,0,0,0,25.71,,
92203,2363001/2,0,0,0,12.86,,
92204,010-12390-41,2,0,2,18.74,,
92205,33-536-01,0,0,0,33.16,,
92207,756015P,0,0,0,143.80,,
92209,S2-6817,2,0,2,1279.99,,
92210,100-343-822-10,0,0,0,40.91,,
92212,SM-ACC3-N2KCT,3,3,0,31.26,,38.47
92213,ME6005D,4,3,1,263.11,,
92214,2000036922,3,2,1,55.16,,
92216,2166927,0,0,0,238.24,,
92218,2000036414,2,2,0,66.47,,
92222,3000006611,0,0,0,139.38,189.99,
92228,MD6284-263-0-202,0,0,0,264.68,,384.99
92229,MD4016-806-0-253,2,0,2,116.87,,169.99
92230,MV7051-9-S/M-216,0,0,0,106.25,,169.99
92231,MV7051-9-L/XL-216,0,0,0,106.25,,169.99
92232,MV7050-860-S/M-216,2,2,0,64.99,,
92233,MV7050-860-L/XL-216,2,2,0,84.39,,134.99
92234,MV807MMS-853-XS/S-253,0,0,0,68.75,,109.99
92235,MV807MMS-853-M/L-253,0,0,0,68.75,,109.99
92236,MV807MMS-853-XL/XXL-253,0,0,0,68.75,,109.99
92237,MV807MMS-857-XS/S-253,0,0,0,68.75,,109.99
92238,MV807MMS-857-M/L-253,2,2,0,68.75,,109.99
92239,MV807MMS-857-XL/XXL-253,0,0,0,68.75,,109.99
92241,MV7161-4-S/M-216,0,0,0,106.24,,169.99
92243,MV7161-4-L/XL-216,0,0,0,106.24,,169.99
92244,MV7061-862-S/M-216,0,0,0,106.25,,169.99
92245,MV7061-862-L/XL-216,0,0,0,106.25,,169.99
92246,MV7160-131-S/M-216,0,0,0,84.39,,134.99
92247,MV7160-131-L/XL-216,0,0,0,84.39,,134.99
92248,MV7060-4-S/M-216,0,0,0,75.00,,119.99
92249,MV7060-4-L/XL-216,0,0,0,75.00,,119.99
92250,MV7060-13-S/M-216,0,0,0,75.00,,119.99
92251,MV7060-13-L/XL-216,0,0,0,75.00,,119.99
92252,MV7113-123-XS/S-216,0,0,0,75.00,,119.99
92253,MV7113-123-M/L-216,0,0,0,75.00,,119.99
92254,MV7113-123-XL/XXL-216,0,0,0,75.00,,119.99
92255,MV7113-201-XS/S-216,0,0,0,75.00,,119.99
92256,MV7113-201-M/L-216,0,0,0,75.00,,119.99
92257,MV7113-201-XL/XXL-216,0,0,0,75.00,,119.99
92258,MV7113-862-XS/S-216,0,0,0,75.00,,119.99
92259,MV7113-862-M/L-216,0,0,0,75.00,,119.99
92260,MV7113-862-XL/XXL-216,0,0,0,75.00,,119.99
92262,MV807NMS-123-XS/S-216,0,0,0,68.75,,109.99
92263,MV807NMS-123-M/L-216,0,0,0,68.75,,109.99
92264,MV807NMS-123-XL/XXL-216,0,0,0,68.75,,109.99
92265,MV807NMS-222-XS/S-216,0,0,0,68.75,,109.99
92266,MV807NMS-222-M/L-216,0,0,0,68.75,,109.99
92267,MV807NMS-222-XL/XXL-216,0,0,0,68.75,,109.99
92268,MV807NMS-863-XS/S-216,0,0,0,68.75,,109.99
92269,MV807NMS-863-M/L-216,0,0,0,68.75,,109.99
92270,MV807NMS-863-XL/XXL-216,0,0,0,68.75,,109.99
92271,MV7020-190-XS/S-216,0,0,0,56.25,,89.99
92272,MV7020-190-M/L-216,2,2,0,56.25,,89.99
92273,MV7020-190-XL/XXL-216,0,0,0,56.25,,89.99
92274,MV7020-222-XS/S-216,0,0,0,56.25,,89.99
92275,MV7020-222-M/L-216,0,0,0,56.25,,89.99
92276,MV7020-222-XL/XXL-216,0,0,0,56.25,,89.99
92277,MV7020-861-XS/S-216,0,0,0,56.25,,89.99
92278,MV7020-861-M/L-216,0,0,0,56.25,,89.99
92279,MV7020-861-XL/XXL-216,3,3,0,56.25,,89.99
92280,MV4111-222-0-216,0,0,0,53.13,,84.99
92281,MV4111-806-0-216,0,0,0,53.13,,84.99
92282,MV4111-861-0-216,0,0,0,53.13,,84.99
92283,MV7112-25-XS/S-216,0,0,0,46.88,,74.99
92284,MV7112-25-M/L-216,0,0,0,46.88,,74.99
92285,MV7112-25-XL/XXL-216,0,0,0,46.88,,74.99
92286,MV7112-35-XS/S-216,0,0,0,46.88,,74.99
92287,MV7112-35-XL/XXL-216,0,0,0,46.88,,74.99
92288,MV7112-131-XS/S-216,0,0,0,46.88,,74.99
92289,MV7112-131-M/L-216,4,2,2,46.88,,74.99
92290,MV7112-131-XL/XXL-216,0,0,0,46.88,,74.99
92291,MV7112-35-M/L-216,0,0,0,46.88,,74.99
92292,MV701DMS-4-XS/S-216,0,0,0,37.51,,59.99
92293,MV701DMS-4-M/L-216,0,0,0,37.51,,59.99
92294,MV701DMS-4-XL/XXL-216,2,0,2,37.51,,59.99
92295,MV701DMS-25-XS/S-216,1,0,1,37.51,,59.99
92296,MV701DMS-25-M/L-216,3,1,2,37.51,,59.99
92297,MV701DMS-25-XL/XXL-216,5,4,1,37.51,,59.99
92298,MV701DMS-131-XS/S-216,0,0,0,37.51,,59.99
92299,MV701DMS-131-M/L-216,0,0,0,37.51,,59.99
92300,MV701DMS-131-XL/XXL-216,3,0,3,29.99,,
92301,MV2500-5-0-216,4,3,1,56.25,,89.99
92302,MV7030-80-0-216,4,2,2,50.00,,79.99
92303,MV7030-220-0-216,2,0,2,50.00,,79.99
92304,MV2300-203-0-253,5,5,0,31.25,,49.99
92305,MV2301-123-0-253,0,0,0,31.25,,49.99
92306,MV4112-3-0-216,0,0,0,78.13,,124.99
92307,MV9080-33-0-253,0,0,0,88.00,,144.99
92308,MV9080-123-0-253,0,0,0,88.00,,144.99
92309,MV9080-124-0-253,0,0,0,88.00,,144.99
92310,MV9070-33-0-253,0,0,0,70.00,,119.99
92311,MV9070-123-0-253,0,0,0,70.00,,119.99
92312,MV9070-124-0-253,0,0,0,70.00,,119.99
92313,MV5020-123-XS-216,2,0,2,43.75,,69.99
92314,MV5020-123-S-216,1,0,1,43.75,,69.99
92315,MV5020-123-M-216,1,1,0,43.75,,69.99
92316,MV5020-123-L-216,1,0,1,43.75,,69.99
92317,MV5020-123-XL-216,2,2,0,43.75,,69.99
92318,MACRS2-825-0-253,15,9,6,14.39,,22.99
92322,BLEEDKIT,1,0,1,17.99,,
92323,N-8/49FT,8,3,5,39.99,,
92324,OBSSKIT11/12TT,8,3,5,199.99,,
92325,EL-OB-KIT,0,0,0,1166.20,,
92370,701001,0,0,0,28.79,,
92371,122313,2,2,0,579.37,926.99,
92376,2159882,0,0,0,17.00,,
92377,2159884,7,3,4,23.33,,
92379,2159355,3,1,2,23.33,,
92382,2159885,0,0,0,17.00,,
92400,958126001,12,6,6,15.19,,
92405,WM1982B,5,3,2,73.81,,
92449,SC-USB-F1,50,25,25,28.66,,
92450,DS-HD6-BLK,28,0,28,19.10,,
92456,CIP100400060,5,3,2,31.00,,38.25
92457,H6HRN2TB,0,0,0,329.33,,
92458,VBB115021020,11,5,6,18.60,,22.95
92459,VBB115022020,7,4,3,28.94,,35.70
92460,VBB115040020,6,4,2,15.16,,18.70
92461,VBB115060020,2,1,1,22.74,,28.05
92462,VBB125020620,30,27,3,43.41,,53.55
92463,VBB125021220,7,3,4,50.30,,62.05
92464,VBB125040010,24,13,11,46.16,,56.95
92465,VBB160040010,25,22,3,106.11,,130.90
92466,VBB160080010,15,7,8,163.98,,202.30
92469,ZIPK4N1,0,0,0,527.50,,
92472,2-256,8,4,4,2.67,,
92483,9600017296,0,0,0,15.10,19.99,
92505,44310505,9,3,6,613.60,,767.00
92506,44310355,4,2,2,498.40,,623.00
92507,44320205,3,2,1,545.60,,682.00
92511,V12-4144BKA70-1,2,2,0,143.96,,
92516,G19124,2,0,2,5.99,,
92588,10-960-K,0,0,0,18.56,,
92590,BMS110022000,5,1,4,136.42,,168.30
92591,ASS070200100,6,3,3,13.78,,17.00
92592,ASS030560100,21,11,10,26.87,,33.15
92593,ASS030560200,7,3,4,28.25,,34.85
92594,ASS030560300,7,3,4,30.32,,37.40
92595,ASS030560500,5,2,3,34.45,,42.50
92596,ASS030550320,2,1,1,15.16,,18.70
92597,BMS210055000,11,2,9,188.79,,232.90
92598,SIM-N2K-N0183,0,0,0,446.16,,
92603,010-C1364-30,15,0,15,112.49,,
92604,010-C1365-30,4,4,0,112.49,,
92605,010-C1366-30,9,0,9,112.49,,
92607,010-C1368-30,4,4,0,74.99,,
92608,010-C1369-30,20,0,20,74.99,,
92609,010-C1370-30,1,0,1,74.99,,
92610,010-C1371-30,1,1,0,74.99,,
92612,FVSLANMG1820A00,7,0,7,20.33,,
92614,KAY1619,10,6,4,49.99,,
92616,SUP1619,4,0,4,49.99,,
92617,SAI1619,7,3,4,49.99,,
92618,REN1619,4,1,3,49.99,,
92619,RAD1619,0,0,0,65.63,,
92620,RET1619,0,0,0,65.63,,
92621,BVT-TDL-C,2,1,1,28.99,,
92622,BVT-TDL-Y,1,1,0,32.50,,
92623,BVT-SNR-C,4,4,0,24.99,,
92624,BVT-SNR-Y,0,0,0,32.50,,
92625,BVT-TDL-P-XS,0,0,0,38.13,,
92626,BVT-TDL-P-S,4,4,0,28.99,,
92627,BVT-TDL-P-M,0,0,0,38.13,,
92628,BVT-TDL-P-L,0,0,0,38.13,,
92629,BVT-SNR-P-XS,0,0,0,38.13,,
92631,BVT-SNR-P-S,0,0,0,38.13,,
92632,BVT-SNR-P-M,0,0,0,38.13,,
92633,BVT-SNR-P-L,0,0,0,38.13,,
92635,2000036885,0,0,0,26.25,,
92637,2000036886,0,0,0,26.25,,
92639,SV108546B,2,2,0,640.00,,
92641,2159359,4,1,3,23.44,,
92642,2159439,5,0,5,19.69,,
92643,2159358,0,0,0,19.69,,
92644,B00085501,6,2,4,219.87,267.29,
92645,2159436,7,0,7,23.44,,
92646,2159360,0,0,0,23.44,,
92647,2159438,1,1,0,22.81,,
92648,B00085502,2,2,0,415.32,504.89,
92649,2159354,0,0,0,22.81,,
92650,BPC240531104R,36,17,19,90.26,,111.35
92651,010-C1364-40,6,0,6,224.99,,
92652,010-C1365-40,0,0,0,224.99,,
92653,010-C1367-40,9,9,0,112.49,,
92654,010-C1368-40,0,0,0,112.49,,
92655,010-C1369-40,17,0,17,112.49,,
92656,010-C1370-40,12,1,11,112.49,,
92657,010-C1371-40,7,1,6,112.49,,
92665,861676,0,0,0,429.01,,
92666,T-941A,2,1,1,2239.30,,
92667,T-940A-3,0,0,0,4199.30,,
92669,010-C1287-20,13,2,11,112.49,,
92671,010-C1289-20,14,0,14,74.99,,
92672,010-C1290-20,14,0,14,74.99,,
92673,010-C1291-20,14,0,14,74.99,,
92674,010-C1292-20,14,0,14,74.99,,
92676,010-C1289-00,0,0,0,112.49,,
92677,010-C1290-00,0,0,0,112.49,,
92678,010-C1291-00,0,0,0,112.49,,
92679,010-C1292-00,0,0,0,112.49,,
92681,G7214,0,0,0,7.59,,
92682,G201316,12,3,9,7.49,,
92683,G210516,6,3,3,17.99,,
92684,20195-1W,0,0,0,15.00,,
92685,"GP2040-53 ",0,0,0,334.53,,
92686,0655001BLK,1,0,1,100.13,,
92687,0655001BLS,6,0,6,100.41,,
92688,0655001WHS,0,0,0,102.99,,
92689,0655001WHT,2,0,2,96.28,,
92690,0655002WHT,3,0,3,100.13,,
92691,0655002BLK,4,0,4,100.13,,
92692,0618000STS,2,1,1,108.62,,
92693,29280-0000,1,1,0,521.48,,
92694,29240-0000,1,1,0,107.06,,
92695,29270-0000,5,2,3,93.22,,
92696,29250-0000,3,0,3,96.86,,
92698,29279-0000,5,5,0,17.70,,
92700,30204ST,13,6,7,492.06,,679.00
92701,"HYCO 1.1T",0,0,0,934.55,,
92704,30214ST,1,0,1,488.09,,669.00
92705,30264ST,4,2,2,542.53,,749.00
92706,3020ST,1,1,0,291.28,,399.00
92707,3021ST,0,0,0,286.25,,399.00
92708,3026ST,0,0,0,344.76,,479.00
92709,54061-22PK,0,0,0,5.38,,
92710,54061-23PK,6,4,2,5.38,,
92711,54061-24PK,0,0,0,5.66,,
92718,IRID-PP-SIM-DP,1,1,0,21.43,,
92720,011706,0,0,0,30.00,,
92721,011707,0,0,0,60.00,,
92722,013019,0,0,0,95.66,,
92723,013025,0,0,0,95.66,,
92725,013010,0,0,0,1294.13,,
92726,013011,0,0,0,1294.13,,
92732,ORI122424120,9,5,4,129.53,,159.80
92737,B00084201,0,0,0,122.34,141.29,
92738,010-12545-02,3,3,0,22.49,,
92740,MC0075-1055,2,2,0,52.88,,
92741,MC0075-1031,2,2,0,43.42,,
92742,MC0075-1072,0,0,0,52.88,,
92743,010-12800-02,0,0,0,7.49,,
92750,RS-1002-HV-U,17,17,0,687.50,,
92751,72-0928,2,2,0,169.72,,
92754,IRID-SIM-DIP,0,0,0,21.43,,
92761,621-VUP-MC-120-DV,2,0,2,819.08,1003.00,
92769,92402,16,13,3,79.74,,
92772,BMS400100000,6,3,3,39.96,,49.30
92773,CYR010120430,7,2,5,61.32,,75.65
92775,101588,6,0,6,479.14,,
92776,101589,4,2,2,479.14,,
92777,101710,0,0,0,125.95,,
92778,101711,7,6,1,113.17,,
92779,101712,6,2,4,113.17,,
92780,101713,15,6,9,66.72,,
92781,101714,12,6,6,100.97,,
92782,101715,10,4,6,125.95,,
92783,101716,10,6,4,113.17,,
92784,101717,2,2,0,113.17,,
92785,101718,0,0,0,66.72,,
92786,101719,2,0,2,100.97,,
92787,101720,9,4,5,125.72,,
92788,101721,3,3,0,113.17,,
92789,101722,0,0,0,113.17,,
92790,101723,7,3,4,66.78,,
92791,101724,4,2,2,101.03,,
92792,101725,0,0,0,125.72,,
92793,101726,0,0,0,113.17,,
92794,101727,0,0,0,113.17,,
92795,101728,4,0,4,66.78,,
92796,101729,0,0,0,101.03,,
92797,101700,10,4,6,420.15,,
92798,101708,7,4,3,274.47,,
92799,101591,2,0,2,439.97,,
92800,101592,10,3,7,296.38,,
92801,101705,9,1,8,439.97,,
92802,FREEDOM,1,1,0,1379.99,,
92803,"FREEDOM LTE-A",0,0,0,2138.64,,
92804,101645,5,3,2,82.67,,
92805,101694,6,5,1,82.67,,
92806,101695,2,0,2,82.67,,
92807,101598,4,2,2,52.67,,
92808,101590,0,0,0,479.14,,
92809,101603,3,2,1,479.14,,
92810,101731,5,2,3,4.23,,
92811,101732,0,0,0,4.41,,
92817,M90X06,0,0,0,110.96,,
92818,M90X07,0,0,0,110.96,,
92819,M90X08,0,0,0,110.96,,
92820,221409,5,2,3,16.34,,
92821,221419,3,2,1,17.03,,
92822,221429,1,1,0,24.28,,
92823,HE-SLWH2,0,0,0,30.11,,
92824,M90X09,0,0,0,110.96,,
92826,M90X10,0,0,0,110.96,,
92828,M90X11,0,0,0,110.96,,
92830,M90X12,0,0,0,110.96,,
92832,M90X13,0,0,0,110.96,,
92833,M90X14,0,0,0,110.96,,
92835,M90X15,1,1,0,110.96,,
92836,M90X16,0,0,0,110.96,,
92837,M90X17,0,0,0,110.96,,
92838,M90X18,0,0,0,110.96,,
92840,50190,0,0,0,36.93,,
92841,808-1840,1,0,1,28.10,,
92842,B310B,0,0,0,370.23,,
92843,IT1104EVO/US,5,4,1,239.99,,
92851,SNAP-IND,0,0,0,41.44,56.99,
92859,2143,1,0,1,203.75,306.95,
92860,P12927-58TEBCL,0,0,0,12.98,,
92861,P12927-58TEBGR,0,0,0,12.98,,
92862,P12927-58TEBBK,0,0,0,12.98,,
92865,BAT512116610,0,0,0,782.01,,964.75
92866,1042,0,0,0,9.33,12.99,
92867,1041,0,0,0,10.67,14.99,
92868,1040,0,0,0,6.67,9.99,
92869,1039,0,0,0,10.67,14.99,
92870,1010,0,0,0,116.25,159.99,
92871,1011,0,0,0,116.25,159.99,
92872,1012,0,0,0,116.25,159.99,
92873,1055,0,0,0,116.25,159.99,
92875,1057,0,0,0,116.25,159.99,
92876,1061,0,0,0,116.25,159.99,
92877,1062,0,0,0,116.25,159.99,
92878,1063,0,0,0,116.25,159.99,
92879,1064,0,0,0,116.25,159.99,
92880,1065,0,0,0,116.25,159.99,
92881,1013,0,0,0,166.25,219.99,
92882,1060,0,0,0,166.25,219.99,
92883,1014,0,0,0,166.25,219.99,
92885,ORI122424110,6,1,5,92.33,,113.90
92887,RT320,5,5,0,31.65,56.99,
92890,ORI242441110,9,4,5,163.29,,201.45
92891,10-960,2,0,2,17.60,,
92893,4617,2,2,0,19.44,,
92895,IC900103-6-0-202,1,1,0,861.25,,
92896,MA5183-0-0-101,13,7,6,61.87,,
92897,MA5283-0-0-101,12,6,6,61.87,,
92898,MA7214-0-0-102,21,21,0,61.87,,
92899,MA2014-0-0-102,0,0,0,24.07,,
92900,MA7114-0-0-102,53,33,20,24.07,,
92901,MA7113-0-0-102,41,13,28,24.07,,
92902,MA7116-0-0-102,7,4,3,13.75,,
92903,MA4031-0-0-101,2,0,2,24.07,,
92904,MA3181-0-0-101,6,3,3,34.37,,
92905,MA3070-0-0-101,5,4,1,13.75,,
92907,010-12881-06,0,0,0,79.98,,
92908,010-12881-02,7,7,0,103.99,,
92909,140-24V,2,2,0,32.59,,
92910,MA228202-13-0-101,0,0,0,361.00,,
92911,MA228203-13-0-101,0,0,0,373.00,,
92912,MA260102-191-0-243,0,0,0,21.55,,29.99
92913,MA260202-191-0-243,0,0,0,25.15,,34.99
92914,MA260302-191-0-243,0,0,0,28.75,,39.99
92915,MA260402-191-0-243,0,0,0,32.35,,44.99
92916,MA260502-191-0-243,0,0,0,39.53,,54.99
92917,MA261102-13-0-202,2,2,0,197.65,,274.99
92918,MA261202-13-0-202,6,2,4,229.99,,319.99
92919,MA261502-168-0-233,1,0,1,86.24,,119.99
92920,MA261702-168-0-233,0,0,0,118.59,,164.99
92921,MA3032-13-0-101,40,22,18,62.44,,64.99
92922,11810,0,0,0,317.87,,
92923,11811,20,17,3,309.04,,
92924,11812,4,0,4,317.87,,
92926,11842,4,0,4,402.01,,
92927,MA600302-269-S-267,0,0,0,34.39,,54.99
92928,MA600302-269-M-267,0,0,0,34.39,,54.99
92929,MA600302-269-L-267,2,2,0,34.39,,54.99
92930,MA600302-269-XL-267,0,0,0,34.39,,54.99
92936,MA600402-262-XS-228,0,0,0,37.51,,59.99
92937,MA600402-262-S-228,0,0,0,37.51,,59.99
92938,MA600402-262-M-228,0,0,0,37.51,,59.99
92939,MA600402-262-L-228,0,0,0,37.51,,59.99
92940,MA600402-262-XL-228,0,0,0,37.51,,59.99
92941,MA600502-262-XS-267,0,0,0,40.63,,64.99
92942,MA600502-262-S-267,0,0,0,40.63,,64.99
92943,MA600502-262-M-267,0,0,0,40.63,,64.99
92944,MA600502-262-L-267,2,2,0,40.63,,64.99
92945,MA600502-262-XL-267,2,2,0,40.63,,64.99
92946,MA7632-13-0-101,64,63,1,16.25,,19.99
92947,MA7637-13-0-101,13,0,13,12.51,,19.99
92948,MA7206-0-0-102,2,2,0,53.75,,
92949,MA9210-0-0-205,0,0,0,93.75,,149.99
92950,MC1536-2-S-206,0,0,0,325.60,,
92951,MC1536-2-M-206,0,0,0,325.60,,
92952,MC1536-2-L-206,0,0,0,325.60,,
92953,MC1536-2-XL-206,0,0,0,325.60,,
92954,MC1536-2-XXL-206,0,0,0,325.60,,
92955,MC1536-2-XXXL-206,0,0,0,325.60,,
92956,MC1536-4-S-206,0,0,0,325.60,,
92957,MC1536-4-M-206,0,0,0,325.60,,
92958,MC1536-4-L-206,0,0,0,325.60,,
92959,MC1536-4-XL-206,0,0,0,325.60,,
92960,MC1536-4-XXL-206,0,0,0,325.60,,
92961,MC1536-4-XXXL-206,0,0,0,325.60,,
92962,MC5446-123-S-206,0,0,0,340.99,,
92963,MC5446-123-M-206,0,0,0,340.99,,
92964,MC5446-123-L-206,0,0,0,340.99,,
92965,MC5446-123-XL-206,0,0,0,340.99,,
92966,MC5446-123-XXL-206,0,0,0,340.99,,
92967,MC5446-123-XXXL-206,0,0,0,340.99,,
92968,MC5446-33-S-206,0,0,0,340.99,,
92969,MC5446-33-M-206,0,0,0,340.99,,
92970,MC5446-33-L-206,0,0,0,340.99,,
92971,MC5446-33XL-206,0,0,0,340.99,,
92972,MC5446-33-XXL-206,0,0,0,340.99,,
92973,MC5446-33-XXXL-206,0,0,0,340.99,,
92974,MJ5246-123-S-206,1,1,0,336.00,,
92975,MJ5246-123-M-206,0,0,0,336.00,,
92976,MJ5246-123-L-206,0,0,0,336.00,,
92977,MJ5246-123-XL-206,0,0,0,336.00,,
92978,MJ5246-123-XXL-206,0,0,0,336.00,,
92979,MJ5246-123-XXXL-206,0,0,0,336.00,,
92980,MJ5246-13-S-206,0,0,0,336.00,,
92981,MJ5246-13-M-206,2,2,0,336.00,,
92982,MJ5246-13-L-206,2,2,0,336.00,,
92983,MJ5246-13-XL-206,2,2,0,336.00,,
92984,MJ5246-13-XXL-206,0,0,0,336.00,,
92985,MJ5246-13-XXXL-206,0,0,0,336.00,,
92986,MJ5246-33-S-206,0,0,0,336.00,,
92987,MJ5246-33-M-206,0,0,0,336.00,,
92988,MJ5246-33-L-206,0,0,0,336.00,,
92989,MJ5246-33-XL-206,0,0,0,336.00,,
92990,MJ5246-33-XXL-206,0,0,0,336.00,,
92991,MJ5246-33-XXXL-206,0,0,0,336.00,,
92992,MP4212-13-S-101,0,0,0,306.25,,
92993,MP4212-13-M-101,0,0,0,306.25,,
92994,MP4212-13-L-101,0,0,0,306.25,,
92995,MP4212-13-XL-101,0,0,0,306.25,,
92996,MP4212-13-XXL-101,0,0,0,306.25,,
92997,MP4240-13-S-206,0,0,0,373.39,,
92998,MP4240-13-M-206,0,0,0,373.39,,
92999,MP4240-13-L-206,0,0,0,373.39,,
93000,MP4240-13-XL-206,0,0,0,373.39,,
93001,MP4240-13-XXL-206,0,0,0,373.39,,
93002,MP4240-13-XXXL-206,0,0,0,373.39,,
93003,MIS210HR-4-0-209,0,0,0,425.00,,
93004,MIS220HR-4-0-209,0,0,0,425.00,,
93005,MIS230HR-4-0-209,5,1,4,443.75,,
93006,MIS240HR-4-0-209,3,3,0,481.25,,
93012,MRD030-2-0-311,42,18,24,93.75,,
93013,MRD075-0-0-215,36,11,25,43.11,,
93014,MRD100-0-0-101,4,2,2,206.57,,
93015,MRD175-251-0-215,39,32,7,56.16,,
93016,MRD190-0-0-215,50,5,45,35.08,,
93017,MRD500-4-0-215,9,7,2,50.31,,69.99
93018,MRK110-25-0-102,0,0,0,487.44,,
93022,MRV15002-251-0-206,14,8,6,217.80,,
93023,MRV170-251-0-206,8,5,3,295.93,,
93024,MS2175-2-XS-206,0,0,0,599.99,,
93025,MS2175-2-S-206,0,0,0,599.99,,
93026,MS2175-2-M-206,2,2,0,599.99,,
93027,MS2175-2-L-206,0,0,0,599.99,,
93028,MS2175-2-XL-206,0,0,0,599.99,,
93029,MS2175-2-XXL-206,0,0,0,599.99,,
93030,MS2175-2-XXXL-206,0,0,0,599.99,,
93031,MS2175-33-XS-206,1,1,0,599.99,,
93032,MS2175-33-S-206,1,1,0,599.99,,
93033,MS2175-33-M-206,2,2,0,599.99,,
93034,MS2175-33-L-206,2,2,0,599.99,,
93035,MS2175-33-XL-206,2,2,0,599.99,,
93036,MS2175-33-XXL-206,0,0,0,599.99,,
93037,MS2175-33-XXXL-206,0,0,0,599.99,,
93042,MSL600GS-13-XS-101,0,0,0,235.47,,
93043,MSL600GS-13-S-101,0,0,0,235.47,,
93044,MSL600GS-13-M-101,0,0,0,235.47,,
93045,MSL600GS-13-L1-101,1,1,0,235.47,,
93046,MSL600GS-13-L2-101,0,0,0,235.47,,
93047,MSL600GS-13-XL-101,1,1,0,235.47,,
93048,MSL600GS-13-XXL-101,0,0,0,235.47,,
93049,MSL600GS-13-XXXL-101,0,0,0,235.47,,
93050,MSL606-13-0-101,0,0,0,30.35,,
93051,MV1254T1-2-S/M-216,15,6,9,70.45,,
93052,MV1254T1-2-L/XL-216,0,0,0,70.45,,
93053,MV1254T1-2-XXL/XXXL-216,1,0,1,70.45,,
93054,MV1254T1-2-4XL/5XL-216,32,17,15,70.45,,
93055,MV1254T3-239-S/M-216,0,0,0,97.37,,
93056,MV1254T3-239-L/XL-216,2,1,1,97.37,,
93057,MV1254T3-239-XXL/XXXL-216,7,4,3,97.37,,
93058,MV1254T3-239-4XL/5XL-216,0,0,0,97.37,,
93059,FNTCDEX08000A00,0,0,0,54.45,,
93061,FVEFF130CNLDA00,0,0,0,12.35,,
93062,FVEFF225CNLDA00,0,0,0,12.35,,
93063,FVEFF150CNLDA00,0,0,0,12.35,,
93064,FVEFF250CNLDA00,0,0,0,12.35,,
93065,FVEFF325CNLDA00,0,0,0,12.35,,
93066,FVEFPTFH3000A00,0,0,0,54.45,,
93068,FGTLV1250100A00,0,0,0,211.63,,
93069,FGTLV1400100A00,0,0,0,319.44,,
93070,FGTLV1850100A00,0,0,0,327.43,,
93076,61392C,0,0,0,506.29,,
93081,02152,3,0,3,17.21,,
93084,11920,0,0,0,33.03,,
93085,11921,0,0,0,31.44,,
93086,11922,0,0,0,30.71,,
93089,01201,0,0,0,7.56,11.90,
93090,01202,0,0,0,8.80,13.86,
93092,01203,1,0,1,11.29,17.77,
93093,01204,3,0,3,17.77,27.97,
93094,01205,1,0,1,28.68,45.14,
93095,01211,0,0,0,8.91,14.03,
93096,01212,4,0,4,10.64,16.75,
93097,01213,1,0,1,13.83,21.76,
93098,01214,7,0,7,21.49,33.83,
93099,01222,2,0,2,13.23,20.83,
93100,01223,0,0,0,14.75,23.21,
93101,01224,1,0,1,23.81,37.49,
93102,01241,3,0,3,9.29,14.62,
93103,01242,0,0,0,10.27,16.15,
93104,01243,2,0,2,13.07,20.57,
93105,01244,0,0,0,20.47,32.22,
93106,01245,2,0,2,33.53,52.79,
93107,01246,2,0,2,53.03,83.47,
93108,01262,0,0,0,15.99,25.16,
93109,01401,3,1,2,11.72,18.45,
93110,01402,0,0,0,14.25,22.44,
93111,01403,0,0,0,18.15,28.56,
93112,01404,0,0,0,27.49,43.27,
93113,01405,3,0,3,42.72,67.24,
93114,01406,2,0,2,65.01,102.34,
93115,01411,1,0,1,14.25,22.44,
93116,01412,0,0,0,16.69,26.27,
93117,01413,1,0,1,22.63,35.62,
93118,01414,3,0,3,35.32,55.59,
93119,01415,3,0,3,56.81,89.42,
93120,01422,0,0,0,18.31,28.82,
93121,01423,2,0,2,24.41,38.42,
93122,01424,3,0,3,37.43,58.91,
93123,01432,2,0,2,16.41,25.84,
93124,01433,1,0,1,21.97,34.60,
93125,01434,3,0,3,39.64,62.39,
93126,01441,2,0,2,13.23,20.83,
93127,01442,2,0,2,15.55,24.48,
93128,01443,0,0,0,20.20,31.79,
93129,01444,2,0,2,29.92,47.09,
93130,01445,0,0,0,47.73,75.14,
93131,01494,0,0,0,47.41,74.63,
93132,01495,4,1,3,73.49,115.69,
93133,02284,3,0,3,23.92,37.66,
93134,02313,4,0,4,17.60,27.71,
93135,02315,0,0,0,22.84,35.96,
93136,02316,2,0,2,30.56,48.11,
93137,02323,4,0,4,19.17,30.18,
93138,02325,0,0,0,25.11,39.53,
93139,02326,0,0,0,33.11,52.11,
93140,02327,0,0,0,55.13,86.79,
93141,02328,2,0,2,66.15,104.13,
93142,02333,3,0,3,15.49,24.40,
93143,PIN242510500,9,3,6,78.55,,96.90
93144,02335,0,0,0,20.95,32.98,
93145,02336,2,0,2,27.32,43.01,
93146,02337,2,0,2,46.33,72.93,
93147,02373,0,0,0,56.32,88.66,
93148,58243,0,0,0,17.04,,
93149,02375,0,0,0,80.47,126.65,
93150,02377,2,0,2,125.12,196.95,
93151,58269,5,3,2,48.59,,
93155,58270,0,0,0,48.59,,
93156,MALRB2-25-S/M-253,0,0,0,18.75,,29.99
93157,MALRB2-25-L/XL-253,0,0,0,18.75,,29.99
93159,69043,12,5,7,28.89,,
93160,"200-024G2 6M",1,1,0,276.36,,352.36
93163,MD201403-191-0-202,8,6,2,89.99,,139.99
93164,MD201403-4-0-202,8,4,4,104.99,,139.99
93166,MD2014C3-261-0-202,10,6,4,89.99,,139.99
93169,MD2016C3-261-0-202,6,1,5,94.99,,
93171,MD2016T1-33-0-202,12,12,0,152.27,,
93174,MD3070-191-0-202,4,4,0,72.51,,99.99
93175,MD3070-268-0-202,19,2,17,72.51,,99.99
93177,MD3181-123-0-202,6,1,5,147.80,,214.99
93178,MD3181-13-0-202,0,0,0,147.80,,214.99
93179,MD3181LE-13-0-101,0,0,0,305.81,,
93183,MD3181LE-33-0-101,0,0,0,305.81,,
93184,MD318302-123-0-202,22,15,7,192.49,,279.99
93185,MD318302-13-0-202,0,0,0,192.49,,279.99
93186,MD318302-262-0-202,11,5,6,192.49,,279.99
93187,MD3183LE-13-0-101,0,0,0,332.49,,
93190,MD3183LE-33-0-101,0,0,0,332.49,,
93191,MD3183T2-33-0-101,14,12,2,324.99,,
93192,MD3183T3-239-0-202,3,0,3,312.28,,
93193,MD318402-123-0-202,1,0,1,206.24,,299.99
93194,MD318402-13-0-202,13,10,3,206.24,,299.99
93195,MD4031-191-0-202,1,0,1,84.99,,
93201,MD5183-13-0-202,1,1,0,189.05,,274.99
93202,MD7183-191-0-202,3,1,2,148.80,,199.99
93203,MD7183-268-202,2,0,2,148.80,,199.99
93204,MD7183-4-0-202,3,1,2,148.80,,199.99
93210,000-156-058-11,1,1,0,77.27,,
93235,MV3104T1-2-0-216,19,7,12,46.39,,
93236,MV3128T2-2-S-216,13,6,7,56.51,,
93237,MV3128T2-2-M-216,11,3,8,56.51,,
93238,MV3128T2-2-L-216,38,0,38,56.51,,
93245,MV3128T2-2-XXL-216,12,2,10,56.51,,
93248,MV3128T2-2-7XL-216,24,18,6,56.51,,
93250,MV3192-2-0-16,12,4,8,82.83,,
93252,69080,0,0,0,16.76,,
93254,MV3196T2-2-S-216,0,0,0,59.28,,
93255,MV3196T2-2-M-216,0,0,0,59.28,,
93256,MV3196T2-2-L-216,0,0,0,59.28,,
93257,MV3196T2-2-XL-216,0,0,0,59.28,,
93258,MV3196T2-2-XXL-216,0,0,0,59.28,,
93259,MV3196T2-2-7XL-216,0,0,0,59.28,,
93260,806-1010-25,0,0,0,21.20,,
93262,MA7136-2-0-101,6,2,4,74.87,,
93263,MA7136-4-0-101,0,0,0,74.87,,
93279,MC1506-2-S-206,0,0,0,262.49,,
93280,MC1506-2-M-206,0,0,0,262.49,,
93282,MC1506-2-L-206,0,0,0,262.49,,
93283,MC1506-2-XL-206,0,0,0,262.49,,
93284,MC1506-2-XXL-206,0,0,0,262.49,,
93285,MC1506-2-XXXL-206,0,0,0,262.49,,
93286,MC1506-4-S-206,0,0,0,262.49,,
93287,MC1506-4-M-206,0,0,0,262.49,,
93288,MC1506-4-L-206,0,0,0,262.49,,
93289,MC1506-4-XL-206,0,0,0,262.49,,
93290,MC1506-4-XXL-206,0,0,0,262.49,,
93291,MC1506-4-XXXL-206,0,0,0,262.49,,
93292,MC1506T3-239-S-206,0,0,0,349.95,,
93293,MC1506T3-239-M-206,0,0,0,349.95,,
93294,MC1506T3-239-L-206,0,0,0,349.95,,
93295,MC1506T3-239-XL-206,0,0,0,349.95,,
93296,1810380,1,0,1,262.06,,
93297,MC1506T3-239-XXL-206,0,0,0,349.95,,
93298,1810381,4,0,4,262.06,,
93299,MC1506T3-239-XXXL-206,0,0,0,349.95,,
93300,1810382,2,0,2,262.06,,
93301,1810383,0,0,0,262.06,,
93302,1810384,2,2,0,286.63,,
93303,1810385,1,1,0,286.63,,
93304,1810386,2,0,2,286.63,,
93305,1810387,1,0,1,286.63,,
93306,1810388,0,0,0,114.64,,
93307,1810389,4,0,4,114.64,,
93308,1810350,0,0,0,91.71,,
93309,1810351,0,0,0,91.71,,
93310,1810356,0,0,0,90.08,,
93311,1810357,1,0,1,90.08,,
93317,MJ6214T1-2-S-206,0,0,0,287.49,,
93318,MJ6214T1-2-M-206,0,0,0,287.49,,
93319,MJ6214T1-2-L-206,0,0,0,287.49,,
93320,MJ6214T1-2-XL-206,0,0,0,287.49,,
93321,MJ6214T1-2-XXL-206,0,0,0,287.49,,
93322,MJ6214T1-2-XXXL-206,0,0,0,287.49,,
93323,MD318802-2-0-202,32,14,18,282.04,,
93324,MJ6214T1-33-S-206,0,0,0,287.49,,
93325,MJ6214T1-33-M-206,0,0,0,287.49,,
93326,MJ6214T1-33-L-206,2,2,0,287.49,,
93327,MJ6214T1-33-XL-206,1,1,0,287.49,,
93328,MJ6214T1-33-XXL-206,0,0,0,287.49,,
93329,MJ6214T1-33-XXXL-206,0,0,0,287.49,,
93330,MJ6214T3-239-S-206,0,0,0,374.95,,
93331,MJ6214T3-239-M-206,0,0,0,374.95,,
93332,MJ6214T3-239-L-206,0,0,0,374.95,,
93333,MJ6214T3-239-XL-206,0,0,0,374.95,,
93334,MJ6214T3-239-XXL-206,0,0,0,374.95,,
93335,MJ6214T3-239-XXXL-206,0,0,0,374.95,,
93342,MV3565-268-0-206,1,1,0,41.24,,59.99
93343,MV3565-277-0-206,9,4,5,41.24,,59.99
93345,MV3570-268-0-206,8,4,4,41.88,,59.99
93346,MV3570-277-0-206,3,1,2,41.88,,59.99
93348,MV3600-270-0-206,6,3,3,61.88,,89.99
93349,MV3600-272-0-206,0,0,0,61.88,,89.99
93350,MV3600CM-261-0-216,3,1,2,39.99,,
93351,P12848-100BK,0,0,0,322.40,,
93352,P12848-100BK-MS,0,0,0,362.67,,
93354,P13371-320TEBGR,0,0,0,201.49,,
93355,P13371-361TEBCL,0,0,0,201.49,,
93356,P13371-361TEBBK,0,0,0,201.49,,
93357,P13371-361TEBGR,0,0,0,201.49,,
93359,XT-SF-250-K6,0,0,0,986.21,1207.00,
93362,P12902-100GR,0,0,0,83.66,,
93363,P13157-170TEBCL,1,1,0,219.99,,
93364,P13157-170TEBGR,0,0,0,248.37,,
93365,P13157-170TEBBK,3,2,1,248.37,,
93366,T2H291,0,0,0,27.95,,
93367,TW4B19500,0,0,0,33.33,,
93368,TW4B19600,0,0,0,33.33,,
93369,TW4B19800,0,0,0,32.25,,
93370,TW4B19900,0,0,0,32.25,,
93371,TW4B20400,2,2,0,29.56,,
93372,MV5606-4-S-216,0,0,0,133.51,,
93373,MV5606-4-M-216,0,0,0,133.51,,
93374,MV5606-4-L-216,0,0,0,133.51,,
93375,TW4B23700,0,0,0,30.64,,
93376,MV5606-4-XL-216,0,0,0,133.51,,
93377,MV5606-4-XXL-216,0,0,0,133.51,,
93378,TW4B23800,2,2,0,30.64,,
93379,MV5606-4-XXXL-216,0,0,0,133.51,,
93380,TW4B24000,2,2,0,48.38,,
93381,TW4B24500,2,2,0,36.55,,
93383,TW5M40500,3,3,0,34.40,,
93384,TW5M41200,2,2,0,22.58,,
93385,TW5M41400,4,4,0,21.50,,
93386,TW5M42200,3,3,0,22.58,,
93387,TW5M42300,0,0,0,21.50,,
93388,TW5M44500,3,3,0,32.25,,
93389,P12848-1300TEBCL,0,0,0,523.88,,
93390,TW5M44900,1,1,0,32.25,,
93391,P12848-1300TEBGR,0,0,0,523.88,,
93392,TW5M46400,0,0,0,37.63,,
93393,P12848-1300TEBBK,0,0,0,523.88,,
93394,TW5M47500,58,58,0,43.00,,
93395,TW5M48600,2,2,0,32.25,,
93396,P12848-1320TEBCL,0,0,0,523.88,,
93397,P12848-1320TEBGR,0,0,0,523.88,,
93398,P12848-1320TEBBK,0,0,0,523.88,,
93399,P13371-360TEBCL,0,0,0,201.49,,
93400,P12848-1360TEBCL,0,0,0,523.88,,
93401,P12848-1360TEBGR,0,0,0,523.88,,
93402,P12848-1360TEBBK,0,0,0,523.88,,
93403,P12848-1361TEBCL,0,0,0,523.88,,
93404,P12848-1361TEBGR,0,0,0,523.88,,
93405,P12848-1361TEBBK,0,0,0,523.88,,
93406,P13228-300PCWH01,1,0,1,403.00,,
93407,P13228-135PCWH01,0,0,0,403.00,,
93408,P12848-2300TEBCL,0,0,0,362.67,,
93409,P12848-2300TEBGR,1,0,1,362.67,,
93410,P12848-2300TEBBK,2,1,1,362.67,,
93411,P12848-2320TEBCL,0,0,0,362.67,,
93412,P12848-2320TEBGR,0,0,0,362.67,,
93413,P12848-2320TEBBK,0,0,0,362.67,,
93414,P12848-2360TEBCL,0,0,0,362.67,,
93415,P12848-2360TEBGR,0,0,0,362.67,,
93416,P12848-2360TEBBK,0,0,0,362.67,,
93417,P12848-2361TEBCL,0,0,0,362.67,,
93418,P12848-2361TEBGR,0,0,0,362.67,,
93419,P12848-2361TEBBK,0,0,0,362.67,,
93420,MV4626-123-S-216,0,0,0,75.00,,119.00
93421,MV4626-123-M-216,0,0,0,75.00,,119.00
93422,MV4626-123-L-216,0,0,0,75.00,,119.00
93423,MV4626-123-XL-216,0,0,0,75.00,,119.00
93424,MV4626-123-XXL-216,0,0,0,75.00,,119.00
93425,MV4626-123-XXXL-216,0,0,0,75.00,,119.00
93426,MV8035-2-0-227,2,2,0,79.49,,
93427,MV8040-2-0-227,8,4,4,88.75,,
93428,FRBAP1319,0,0,0,22.93,,
93429,BE-EL-51004-DP,15,9,6,9.09,,
93430,BE-EL-31639-DP,5,5,0,16.33,,
93431,BE-EL-31640-DP,6,2,4,38.18,,
93432,BE-EL-51047-DP,6,5,1,14.35,,
93433,BE-EL-31643-DP,10,0,10,14.00,,
93434,BE-AN-50299-DP,9,6,3,16.93,,
93435,BE-AN-50301-DP,3,0,3,32.91,,
93437,90920,0,0,0,243.90,,
93441,OBI9000H-DS,4,2,2,505.78,,
93444,611513,0,0,0,97.99,144.19,
93464,SXV300M1,14,2,12,70.43,,
93467,010-11169-00,0,0,0,56.24,,
93472,010-12166-00,0,0,0,14.99,,
93474,02381,0,0,0,31.43,49.47,
93475,02470,0,0,0,34.35,54.06,
93476,02471,1,0,1,38.67,60.86,
93477,02472,3,0,3,58.16,91.55,
93478,02473,3,0,3,50.28,79.14,
93479,02474,3,0,3,53.68,84.49,
93481,UC-100D,1,1,0,42.19,,
93482,28510700,0,0,0,283.74,,
93483,28010700,0,0,0,297.37,,
93484,28011000,0,0,0,379.35,,
93485,28011500,0,0,0,566.84,,
93486,28012000,0,0,0,816.28,,
93487,28012500,0,0,0,985.42,,
93488,28013500,0,0,0,1299.38,,
93489,70405060,0,0,0,178.10,,
93490,70405070,2,0,2,219.87,,
93491,83301202,0,0,0,132.64,,
93492,83309002,6,3,3,215.93,,
93494,010-C1357-30,0,0,0,142.49,,
93495,010-C1358-30,0,0,0,142.49,,
93496,010-C1359-30,0,0,0,59.99,,
93497,010-C1360-30,0,0,0,59.99,,
93498,010-C1361-30,0,0,0,59.99,,
93499,010-C1362-30,0,0,0,59.99,,
93500,010-C1363-30,0,0,0,59.99,,
93513,MA7348-4-0-227,19,19,0,48.75,,
93514,MA6000-13-0-101,0,0,0,54.88,,
93515,MA6000-2-0-101,0,0,0,54.88,,
93518,010-02536-00,0,0,0,412.49,,
93519,010-02536-10,0,0,0,472.49,,
93520,010-12545-03,4,4,0,26.24,,
93521,1061017-BLK,11,6,5,69.99,,
93524,HE-EL3,0,0,0,116.10,,
93558,157050R,2,2,0,104.99,,
93559,158042R,6,6,0,89.99,,
93562,134218R,0,0,0,84.99,,
93563,138005R,0,0,0,49.99,,
93564,134212R,6,5,1,99.99,,
93565,132105R,2,2,0,59.99,,
93566,150142R,5,5,0,99.99,,
93567,134211R,6,1,5,94.99,,
93568,130105R,0,0,0,54.99,,
93573,GP2040-16,0,0,0,334.53,,
93574,3187,79,71,8,35.99,,
93579,B45-DT-9N,0,0,0,280.68,,
93581,890099P,3,0,3,38.42,66.97,
93582,890086WDP,35,15,20,30.50,53.97,
93583,62-542-TR-WT,28,28,0,52.44,,
93585,0315DP1STS,7,0,7,6.08,,
93586,0315DP2STS,2,0,2,7.57,,
93587,0330DP1STS,2,0,2,5.55,,
93588,0330DP2STS,0,0,0,7.57,,
93589,M0616,0,0,0,11.93,,
93590,2018MB,2,0,2,21.09,,
93612,BK-0019-C,0,0,0,28.44,,
93614,11185,0,0,0,7.33,,
93637,MDA-5H,7,3,4,769.30,,
93666,010-13228-04,5,1,4,74.99,,
93667,010-13228-03,19,17,2,22.49,,
93668,010-13228-02,0,0,0,22.49,,
93669,010-13228-01,0,0,0,22.49,,
93670,010-13228-00,3,1,2,89.99,,
93672,HT1424AW,0,0,0,153.85,,
93673,Z76-8000POL25.5-1,0,0,0,77.71,,
93677,1710BL-14B-KIT,0,0,0,594.75,,
93678,RBA-200-ROP,0,0,0,250.31,,
93679,RTB-50,1,1,0,42.99,,
93680,RTB-75,2,2,0,44.99,,
93681,BAT512132410,0,0,0,1340.79,,1654.10
93689,ARG-2,18,3,15,14.44,,
93690,ARG-3,15,3,12,16.11,,
93692,010-12953-01,0,0,0,39.99,,
93695,ARG-1,15,15,0,13.33,,
93697,SH-003,2,1,1,201.60,,
93698,B00070501,0,0,0,148.83,171.89,
93700,010-02815-00,102,44,58,849.99,,
93710,010-13267-00,4,2,2,26.24,,
93711,010-13268-00,3,1,2,18.74,,
93712,010-13268-10,4,4,0,26.24,,
93714,010-13266-10,1,1,0,74.99,,
93716,010-13269-10,2,1,1,26.24,,
93717,010-13266-20,10,10,0,71.24,,
93718,010-13269-20,4,3,1,14.99,,
93719,010-13266-30,2,1,1,14.99,,
93720,010-13270-00,6,0,6,18.74,,
93721,010-13269-00,0,0,0,14.99,,
93724,010-13273-00,9,7,2,22.49,,
93729,010-13274-10,5,4,1,29.99,,
93730,010-13275-00,4,3,1,18.74,,
93732,010-13276-00,1,1,0,22.49,,
93733,010-13269-01,1,0,1,14.99,,
93734,010-13273-10,1,1,0,22.49,,
93735,010-13269-40,1,0,1,14.99,,
93737,02475,2,0,2,59.08,92.99,
93738,02476,3,0,3,71.55,112.63,
93739,02477,0,0,0,107.63,169.41,
93740,02479,2,0,2,11.83,18.62,
93741,02480,1,0,1,16.41,25.84,
93742,02481,3,3,0,26.68,41.99,
93743,03-REV-BH,65,28,37,72.56,,
93744,62632,4,2,2,43.90,,
93759,010-13101-20,3,0,3,73.07,,
93760,010-13101-10,1,0,1,73.07,,
93761,010-13101-00,2,2,0,73.07,,
93763,1630001,0,0,0,37.71,,
93765,1640002,6,6,0,30.66,,
93766,11850,3,2,1,420.71,,
93771,6275,1,0,1,162.77,244.15,
93776,09-36012,0,0,0,4.67,,
93779,RF15107,0,0,0,9.70,,
93786,941600120,4,0,4,1332.99,,1549.99
93787,915313,0,0,0,352.49,,469.99
93788,LFV-12VA,8,8,0,55.68,,
93790,LFVLF-10,63,63,0,476.28,,
93791,LFVLF-8,33,33,0,325.00,,
93794,MSCLF-10,8,8,0,15.07,,
93796,CT3916,2,1,1,1154.59,,
93797,CT3918,1,1,0,1265.96,,
93798,CT3920,1,0,1,1384.76,,
93799,CT3920XS,0,0,0,1503.56,,
93800,CT3922,0,0,0,1689.19,,
93801,CT3924,0,0,0,1726.31,,
93802,CT3926,0,0,0,1793.14,,
93806,GP1600-17,0,0,0,341.81,,
93809,400-080-26,0,0,0,1015.03,,1294.15
93811,SB50GR1,16,12,4,19.94,,
93814,CABLE-STARTER-1,2,1,1,128.80,,
93827,MC0075-1084,0,0,0,52.88,,
93828,MC0075-1133,0,0,0,52.88,,
93830,MRV050WR-251-XS/S-216,0,0,0,93.75,,
93831,MRV050WR-251-M/L-216,4,4,0,93.75,,
93832,MRV050WR-251-XL/XXL-216,4,4,0,93.75,,
93834,325181-3,8,4,4,56.65,,
93835,325188-1,6,4,2,48.89,,
93836,325189-1,8,4,4,34.85,,
93837,403051-1,2,1,1,37.56,,
93839,FVSGEL185R05A00,1,1,0,39.60,,
93840,F4-A100-S,1,0,1,2749.99,,
93848,010-02732-10,5,4,1,674.99,,
93849,010-02732-11,2,1,1,1237.49,,
93853,"EXT CELL KIT - 20",0,0,0,135.37,,
93854,"EXT CELL KIT - 30",0,0,0,167.07,,
93855,25507,26,13,13,54.04,,
93856,25650,11,9,2,11.80,,
93857,25653,5,1,4,21.21,,
93858,39062,4,0,4,38.63,,
93859,39511,7,2,5,13.44,,
93860,39513,1,1,0,12.80,,
93861,98-1805,0,0,0,6.19,,
93862,98-1810,0,0,0,7.12,,
93863,98-1815,0,0,0,8.05,,
93864,39834,9,5,4,3.07,,
93865,98-2510,0,0,0,8.05,,
93866,98-2515,1,0,1,9.01,,
93867,98-2520,0,0,0,9.91,,
93868,98-3110,2,0,2,8.78,,
93869,98-3115,2,0,2,9.62,,
93870,98-3120,0,0,0,10.62,,
93871,70-07,0,0,0,21.15,,
93872,70-27,0,0,0,37.44,,
93873,77-17-BLK,0,0,0,5.06,,
93874,43031,4,0,4,22.88,,
93875,77-17-RED,0,0,0,5.06,,
93876,70-94,0,0,0,29.49,,
93877,43041,1,0,1,27.75,,
93878,70-95,2,0,2,37.86,,
93879,43051,86,64,22,35.05,,
93880,70-96,1,0,1,43.18,,
93881,70-98,0,0,0,59.72,,
93882,60-75,0,0,0,36.03,,
93883,60-120,5,0,5,38.33,,
93884,60-150,0,0,0,55.87,,
93885,43061,0,0,0,41.03,,
93886,60-200,0,0,0,98.31,,
93887,93-21,3,0,3,16.38,,
93888,93-33,0,0,0,13.59,,
93889,78-75,0,0,0,34.65,,
93890,36-18,1,0,1,99.99,,
93891,36-17,0,0,0,152.86,,
93892,43623,0,0,0,12.85,,
93893,44423,2,0,2,27.46,,
93894,44425,3,3,0,50.89,,
93895,44512,7,3,4,36.49,,
93896,44521,4,2,2,37.53,,
93897,44527,2,0,2,43.34,,
93898,44550,8,5,3,102.06,,
93899,44591,7,3,4,18.78,,
93900,44662,2,1,1,53.80,,
93915,39080,123,104,19,20.85,,
93916,39085,364,364,0,37.68,,
93917,39319,6,4,2,11.63,,
93919,39741,15,7,8,41.99,,
93920,39761,5,2,3,33.24,,
93921,39764,16,7,9,19.62,,
93922,39765,0,0,0,16.93,,
93924,39783,6,6,0,9.22,,
93926,39812,6,6,0,12.24,,
93927,39847,22,9,13,6.08,,
93929,39855,13,13,0,15.29,,
93930,39857,14,4,10,6.25,,
93931,39859,18,0,18,49.65,,
93932,39861,4,4,0,49.65,,
93934,39865,5,1,4,25.20,,
93935,39867,2,1,1,59.66,,
93938,187690,0,0,0,10.71,,
93939,22577,0,0,0,16.81,,
93941,22597,19,7,12,37.50,,
93942,40634,0,0,0,44.06,,
93947,ARG-506,15,11,4,7.22,,
93953,19-0618,1,0,1,39.99,,
93958,PHRKIIU,26,8,18,55.00,,
93959,3226,0,0,0,131.49,197.95,
93960,07001,4,0,4,86.40,136.00,
93961,07150,3,0,3,282.75,445.06,
93968,B45-DT-8G,0,0,0,280.68,,
93970,100-368-954-10,0,0,0,22.73,,
93972,DS30-P-BLK-3,4,0,4,58.48,,
93973,DS30-P-BLK-5,2,0,2,97.47,,
93974,DS-H10-BLK-3,1,0,1,53.60,,
93975,DS-H10-BLK-5,0,0,0,89.34,,
93976,DS30-P-5,2,1,1,97.53,,
93977,DS30-P-3,4,2,2,58.48,,
93978,DS-H6-BLK-3,0,0,0,38.46,,
93979,DS-H6-BLK-5,0,0,0,64.10,,
93980,DS21A-P-BLK-3,2,2,0,54.51,,
93981,DS21A-P-BLK-5,1,1,0,90.84,,
93982,50533PK,0,0,0,6.72,,
93983,35.2STA,2,0,2,715.76,946.95,
93984,35.2STC,0,0,0,795.71,1051.95,
93985,35.2STCCC,0,0,0,1193.29,1577.95,
93986,40.2STA,1,0,1,813.71,1075.95,
93987,40.2STC,0,0,0,908.47,1200.95,
93988,40.2STCCC,0,0,0,1258.94,1664.95,
93989,46.2STA,1,0,1,1105.94,1462.95,
93990,46.2STC,0,0,0,1326.18,1753.95,
93991,46.2STCCC,0,0,0,1658.12,2192.95,
93992,50.2STA,0,0,0,1723.76,2278.95,
93993,50.2STC,0,0,0,1922.82,2542.95,
93994,50.2STCCC,0,0,0,2652.35,3506.95,
93997,TFR-230,0,0,0,65.80,,
93998,TFR-280,0,0,0,76.03,,
93999,TFR-402,8,3,5,19.96,,
94000,TFR-403,34,30,4,12.99,,
94001,TFR-404,11,0,11,21.99,,
94002,APT-LB-L1,4,3,1,164.09,,
94010,883-0105-12,0,0,0,799.99,,
94011,883-0125-12,0,0,0,949.99,,
94012,883-0240-12,0,0,0,1799.99,,
94022,819-0120-12,4,4,0,1278.58,,
94029,808-0817-03,0,0,0,70.99,,
94031,TFR-280-2K,0,0,0,201.47,,
94038,HT1115AW,0,0,0,104.73,,
94044,000-12292-001,2,1,1,112.62,,
94047,F-1-BLUE,8,8,0,34.99,,
94048,F-2-BLUE,0,0,0,61.26,,
94049,F-3-BLUE,0,0,0,83.93,,
94050,F-4-BLUE,0,0,0,106.66,,
94051,F-5-BLUE,0,0,0,109.59,,
94052,F-6-BLUE,0,0,0,149.74,,
94053,F-7-BLUE,0,0,0,217.83,,
94054,F-8-BLUE,0,0,0,363.49,,
94055,F-10-BLUE,0,0,0,416.43,,
94059,"CS 02906",12,4,8,20.74,29.95,
94065,1935,0,0,0,353.71,,
94067,PST-1000F-12,0,0,0,419.32,605.10,
94072,PIN122122500,7,3,4,270.78,,334.05
94073,BPC241247106,11,3,8,144.00,,177.65
94075,720119-1,0,0,0,83.33,,
94083,2155747,14,6,8,43.24,74.99,
94084,2155764,0,0,0,24.71,,
94089,81-818-792,0,0,0,2.56,,
94090,260749,0,0,0,3.14,4.97,
94091,260800,0,0,0,3.85,5.97,
94092,240035,4,4,0,4.27,7.47,
94107,20RSB,47,17,30,40.63,,
94108,21RSB,16,6,10,44.38,,
94110,CABLE-STARTER-2,2,1,1,180.00,,
94118,MV3128T2-2-XL-216,19,8,11,56.51,,
94120,G-1-SAND,4,4,0,9.99,,
94121,G-2-SAND,9,9,0,10.30,,
94122,G-3-SAND,0,0,0,19.40,,
94123,G-4-SAND,0,0,0,29.17,,
94124,G-5-SAND,0,0,0,55.84,,
94125,G-6-SAND,2,2,0,59.31,,
94126,G-1-SANDWO,4,4,0,8.99,,
94127,G-2-SANDWO,9,9,0,9.99,,
94128,G-3-SANDWO,0,0,0,18.94,,
94129,G-4-SANDWO,0,0,0,28.71,,
94130,"MOROSINI U/CH/B",6,2,4,156.57,,
94131,G-5-SANDWO,0,0,0,55.39,,
94132,G-6-SANDWO,2,2,0,54.00,,
94133,HE-BD22,0,0,0,180.05,,
94134,NISIDA-B/B,1,1,0,120.68,,
94135,V27,4,2,2,96.78,,
94142,HE-BCS2PK,0,0,0,110.49,,
94144,36010,3,0,3,265.25,,
94145,36020,0,0,0,338.25,,
94146,36030,2,0,2,501.39,,
94147,10193,0,0,0,31.64,,
94148,10192,5,0,5,71.12,,
94149,07064,2,0,2,237.07,373.15,
94150,07061,1,0,1,169.56,266.90,
94151,07053,2,0,2,214.11,337.03,
94152,07052,3,0,3,179.77,282.97,
94153,07051,3,0,3,152.17,239.53,
94157,HE-BD14,0,0,0,127.09,,
94162,0160-0105,1,1,0,14.00,,31.79
94163,0160-0111,0,0,0,27.97,,46.99
94164,0160-0123,0,0,0,31.08,,51.99
94165,0160-0124,1,1,0,59.78,,99.99
94166,0160-0142,0,0,0,62.17,,99.99
94167,0160-0151,0,0,0,12.43,,20.49
94168,0160-0161,0,0,0,31.08,,51.99
94170,SCM-RAL-RGB-0.5,0,0,0,15.25,,22.00
94171,SCM-RAL-RGB-0.4-AB,0,0,0,12.99,,18.50
94172,SCM-RAL-RGB-0.4-PW,0,0,0,11.89,,16.99
94173,SC3-CC-ALSM,3,1,2,199.00,,279.00
94174,SC3-BB-ALSM,4,2,2,173.99,,249.00
94175,SC3-GW-ALSM,6,4,2,173.99,,249.00
94179,REC040010210R,4,3,1,16.54,,20.40
94206,FSDP20512007B00,0,0,0,1212.43,,
94208,WS-C15,0,0,0,118.29,,
94211,SCU-38,12,12,0,23.33,,
94212,400-401,0,0,0,90.96,,115.98
94213,400-401-B,0,0,0,90.96,,115.98
94214,B4-209DN2,0,0,0,2207.18,2580.00,
94215,B4-209DNSB2,0,0,0,2343.29,2656.00,
94216,B4-309DN2,0,0,0,2795.18,3300.00,
94217,B4-309DNSB2,0,0,0,2931.29,3616.00,
94218,MA0094-0-0-101,5,3,2,8.61,,
94220,MLS-410SP-B,9,5,4,33.32,,
94222,FNQNCCHCF000A00,3,3,0,591.69,,
94224,0057206,5,0,5,401.48,,
94225,0057406,15,8,7,157.27,,
94226,0057905,0,0,0,54.91,,
94227,0057907,0,0,0,75.89,,
94228,HKG-S8,0,0,0,25.01,,
94229,29060152BK,0,0,0,252.91,,
94230,29461354BK,0,0,0,566.15,,
94231,29462354BK,0,0,0,785.99,,
94233,49515055,0,0,0,653.90,,
94234,49515056,2,0,2,729.21,,
94235,49515057,0,0,0,653.90,,
94236,49530055,0,0,0,1011.40,,
94237,49530056,2,0,2,1105.63,,
94238,49530057,0,0,0,1011.40,,
94239,49540055,0,0,0,1218.45,,
94240,49540056,0,0,0,1312.50,,
94241,49540057,0,0,0,1218.45,,
94242,49545055,0,0,0,1646.56,,
94243,49545056,2,0,2,1740.71,,
94244,49545057,0,0,0,1646.56,,
94245,49550055,0,0,0,2094.94,,
94246,49550056,0,0,0,2329.48,,
94247,49550057,0,0,0,2094.94,,
94252,166132,0,0,0,13.77,19.97,
94253,49555055,0,0,0,2963.85,,
94254,49555056,0,0,0,3246.11,,
94255,49555057,0,0,0,2963.85,,
94256,589012,0,0,0,12.15,,
94257,SWIVEL500F,2,2,0,94.33,,
94258,66840066,5,3,2,188.13,,
94259,SS180003,4,2,2,46.15,,
94260,SS180007,6,1,5,66.86,,
94261,589150,4,1,3,13.55,,
94262,589842,0,0,0,151.93,,
94263,68000593,3,2,1,65.91,,
94264,68000917,5,2,3,38.55,,
94265,68000918,4,1,3,38.55,,
94266,39660070,0,0,0,814.44,,
94267,39910030,2,2,0,289.56,,
94268,FPWCS8300000,3,1,2,67.33,,
94272,SWIVEL312F,4,1,3,48.94,,
94273,0057910,0,0,0,96.87,,
94274,68000856,5,2,3,32.93,,
94275,89400470,1,0,1,15.84,,
94276,SS180001,3,2,1,40.52,,
94277,0057404,1,1,0,105.05,,
94278,69000334,5,2,3,310.52,,
94279,66840070,5,2,3,33.75,,
94280,0057416,0,0,0,314.41,,
94281,0057205,0,0,0,397.39,,
94282,0057915,0,0,0,129.72,,
94283,HM15HT200PX,5,2,3,422.80,,
94284,0058910,0,0,0,793.08,,
94285,69000331,6,3,3,177.38,,
94286,0057410,0,0,0,223.48,,
94297,589094,3,0,3,187.21,,
94298,589268,7,0,7,264.48,,
94299,589550,3,1,2,38.64,,
94300,590003LEW,2,1,1,1604.73,,
94301,591468,2,2,0,1700.23,,
94302,29140020,9,6,3,18.35,,
94303,29927201BK,3,0,3,43.36,,
94304,29145301,3,1,2,57.96,,
94305,29141010,2,1,1,58.83,,
94306,29925001BK,3,3,0,20.26,,
94307,29926001BK,5,2,3,27.96,,
94308,29140046,3,1,2,122.46,,
94309,29145311,3,1,2,61.98,,
94310,29929001BK,5,1,4,98.45,,
94311,29196001,0,0,0,59.44,,
94312,29197201,5,2,3,94.58,,
94313,29925040,0,0,0,29.90,,
94314,29140042,6,3,3,102.26,,
94315,29927240,3,1,2,43.36,,
94316,360002990,0,0,0,8.88,,
94317,361680990,12,6,6,48.68,,
94318,393820862,4,0,4,335.64,,
94319,360869999,7,4,3,34.70,,
94320,89700820,0,0,0,123.84,,
94321,19701000,4,2,2,18.35,,
94322,68001249,2,1,1,77.20,,
94323,68001256,0,0,0,77.20,,
94324,19700401,1,1,0,61.21,,
94325,19712056,2,0,2,12.41,,
94326,68000939,15,2,13,131.11,,
94327,6670011108-312,4,3,1,956.86,,
94328,0052531,5,2,3,160.05,,
94329,6656411108-102,3,2,1,1318.19,,
94330,6656211967-310,0,0,0,1212.52,,
94331,6657011108-102,3,0,3,1194.79,,
94332,66000099,8,4,4,17.43,,
94333,6670011108,4,1,3,834.14,,
94334,6656011967,3,3,0,1050.83,,
94335,6656811967-303,2,2,0,778.98,,
94336,66000610,9,5,4,130.15,,
94337,68000883,6,5,1,38.55,,
94338,68000884,4,2,2,38.55,,
94339,68000888,4,2,2,85.87,,
94340,68000889,0,0,0,85.87,,
94341,68000240,2,1,1,98.83,,
94342,68000129,4,2,2,296.14,,
94343,66000616,4,2,2,254.46,,
94344,300-136+112G2,0,0,0,2427.33,,3094.85
94346,BPAJ,0,0,0,288.56,385.00,
94353,AHJC-4V-DP,1,0,1,1305.49,,
94355,AHJC-6V-DP,4,1,3,1204.25,,
94356,E-4209-06,0,0,0,77.50,,
94358,S722-BK,2,0,2,97.96,133.99,
94366,APD-2-DP,7,3,4,3.97,,
94367,010-13116-01,2,1,1,14.99,,
94368,010-13116-00,35,16,19,14.99,,
94371,PB1133,0,0,0,93.26,119.00,
94372,PB1531,0,0,0,69.54,89.95,
94373,PB1543,0,0,0,88.73,119.00,
94374,PB1553,0,0,0,66.77,79.95,
94375,PB1563,0,0,0,40.98,59.95,
94376,PB1580,0,0,0,69.00,89.95,
94382,SCM-LC-PLUS,0,0,0,610.10,,699.00
94383,SCM-LC-N2K,2,0,2,358.96,,489.00
94384,EVO-4248SP,1,1,0,1393.18,2010.60,
94385,APT-250-02,1,1,0,261.56,,
94386,MAWSTL10-2-0-101,2,1,1,25.00,,39.99
94388,MGR300B,12,0,12,92.45,,
94389,02482,2,0,2,49.63,78.12,
94390,02493,1,0,1,62.69,98.69,
94391,02673,0,0,0,69.07,108.72,
94392,02776,0,0,0,145.04,228.31,
94395,06331,3,0,3,14.20,22.36,
94396,06341,0,0,0,21.55,33.92,
94397,06351,0,0,0,32.56,51.26,
94398,06361,0,0,0,50.44,79.39,
94399,06490,2,0,2,16.36,25.76,
94400,06491,0,0,0,17.88,28.14,
94401,06492,0,0,0,27.21,42.84,
94402,06493,0,0,0,27.49,43.27,
94403,06604,2,0,2,36.99,58.23,
94404,06605,0,0,0,51.84,81.60,
94405,06606,2,0,2,74.04,116.54,
94406,07007,2,0,2,139.87,220.15,
94407,07008,0,0,0,215.47,339.15,
94408,07485,2,0,2,74.04,116.54,
94409,09605,3,0,3,23.05,36.30,
94410,10112,0,0,0,29.71,,
94411,10122,0,0,0,36.29,,
94413,11203,1,0,1,29.16,45.90,
94414,11204,4,2,2,40.23,63.33,
94415,11205,2,0,2,62.53,98.43,
94416,11206,2,0,2,94.01,147.99,
94427,TR7412UB-OR,11,11,0,102.78,,
94428,TR7423UB-OR,1,1,0,129.32,,
94429,TR4512UBA-OR,0,0,0,149.88,,
94431,TRD7422U-OR,0,0,0,150.80,,
94433,CD7426UB-OR,0,0,0,169.18,,
94434,TR7411U-ORK,7,7,0,87.92,,
94435,TR7412UB-ORK,9,1,8,107.27,,
94436,CDD7418UB-ORK,1,1,0,184.08,,
94437,AC9745-MIC,0,0,0,5.68,,
94438,AC1111/330,3,2,1,4.78,,
94460,0582DPS99A,6,5,1,39.13,,
94461,010-C1237-00,0,0,0,112.49,,
94464,536810C,0,0,0,90.74,164.99,
94465,536800S,7,4,3,106.69,214.99,
94466,536810S,0,0,0,106.69,214.99,
94467,53696,10,10,0,6.00,,
94477,8664,0,0,0,60.52,,
94478,8665,2,1,1,85.29,,
94479,8666,3,2,1,115.48,,
94483,FT1PXC-K,9,1,8,174.14,,
94484,VP000080,0,0,0,11.46,,
94485,010-13094-00,13,3,10,22.49,,
94486,550103,3,3,0,513.02,,
94487,550503,0,0,0,573.04,,
94488,550101A,0,0,0,450.52,,
94489,550101ANE,1,1,0,434.31,,
94490,550503NE,0,0,0,527.93,,
94493,AC-1100-OB-S,0,0,0,234.00,,
94494,AC-1100-OB-M,0,0,0,234.00,,
94495,AC-1100-OB-L,0,0,0,234.00,,
94496,AC-1100-OB-XL,0,0,0,234.00,,
94497,AC-1100-OB-XXL,0,0,0,234.00,,
94498,AB-1100-OB-S,0,0,0,210.94,,
94499,AB-1100-OB-M,0,0,0,210.94,,
94500,AB-1100-OB-L,0,0,0,210.94,,
94501,AB-1100-OB-XL,0,0,0,210.94,,
94503,AB-1100-OB-XXL,0,0,0,210.94,,
94507,0057310,1,0,1,1227.53,,
94508,HNVGA,0,0,0,27.00,,
94509,HFL25,0,0,0,27.00,,
94510,HFLP,0,0,0,34.50,,
94511,CT3922-9004,0,0,0,1763.44,,
94512,RAA60,0,0,0,78.75,,
94514,55-0415,0,0,0,12.93,,
94515,"CT8718CR   ",0,0,0,647.31,,
94516,ACC-DF-1000,0,0,0,13.11,,
94517,ACC-DF-1062,0,0,0,6.86,,
94518,ACC-FF-1789,0,0,0,6.86,,
94519,ACC-FF-1550,0,0,0,4.11,,
94520,ACC-FF-1833,0,0,0,24.99,,
94521,ACC-FF-1642,0,0,0,4.11,,
94525,"CT8720CR     ",0,0,0,731.72,,
94527,425130-3,3,1,2,48.27,,
94537,LLB-51MC-81-00,0,0,0,96.25,,
94540,6656011967-310,1,0,1,1089.07,,
94541,SC20-BLK,0,0,0,280.69,,
94576,010-12800-00,0,0,0,7.49,,
94578,30227,298,0,298,3.50,,
94579,30228,1,0,1,3.50,,
94580,604-150-DV,3,1,2,738.35,904.00,
94581,30228/30227KIT,1,0,1,6.49,,
94601,MHS338BT,51,28,23,176.62,,
94672,20407021,1,0,1,27.60,,
94675,010-12824-00,0,0,0,29.98,,
94676,ASS030066100,17,6,11,20.67,,25.50
94677,SCC115045212,5,3,2,177.07,,218.45
94678,66000620,7,3,4,165.77,,
94679,4138-131-E65,0,0,0,136.94,,
94682,AV-5001-HV-S/M,2,2,0,61.88,,
94683,AV-5001-HV-L/XL,5,5,0,61.88,,
94687,50002,2,2,0,586.32,,
94688,50003,7,4,3,617.98,,
94690,PA-1000,1,1,0,29.99,,
94691,BC-9005,0,0,0,27.50,,
94692,2149570,3,1,2,299.99,439.99,
94693,UM725,8,3,5,155.42,,
94694,2000037532,3,2,1,209.12,289.99,
94695,UM725BK,5,3,2,155.42,,
94696,UM725G,12,7,5,176.62,,
94697,2000037534,4,2,2,268.61,389.99,
94698,UM725GBK,6,2,4,176.62,,
94699,2000037538,1,1,0,327.50,429.99,
94700,UM725GBT,8,4,4,190.75,,
94701,2000038276,4,3,1,257.94,359.99,
94702,UM725GBTBK,6,2,4,190.75,,
94703,2000038278,3,1,2,207.94,289.99,
94704,2154639,4,2,2,106.39,149.99,
94705,UMRMIC,6,1,5,108.32,,
94706,UMRMICBK,6,6,0,108.32,,
94707,2155647,0,0,0,236.25,324.99,
94708,2157690,0,0,0,119.69,149.99,
94709,2000036463,3,3,0,112.65,149.99,
94710,2000036529,0,0,0,150.94,199.99,
94711,2000037522,2,2,0,187.19,239.99,
94712,2000037524,2,0,2,232.19,299.99,
94713,2000037535,1,1,0,228.61,324.99,
94716,2155648,0,0,0,100.00,,
94717,2156413,1,1,0,89.12,129.99,
94720,2000035608,0,0,0,187.19,269.99,
94721,02995,2,0,2,50.39,79.31,
94722,1494,0,0,0,159.39,,
94723,1495,0,0,0,196.65,,
94724,1496,0,0,0,647.16,,
94725,1497,0,0,0,548.20,,
94726,1498,0,0,0,154.72,,
94727,1499,0,0,0,136.05,,
94729,1503,0,0,0,362.33,,
94730,1504,0,0,0,627.80,,
94731,1505,0,0,0,564.63,,
94732,2356100,4,4,0,27.16,,
94733,3121,0,0,0,415.15,,
94734,BFS-600,0,0,0,351.56,,
94735,3122,0,0,0,447.37,,
94736,3123,3,2,1,415.15,,
94737,3128,0,0,0,360.25,,
94738,3130,0,0,0,291.90,,
94739,3133,0,0,0,250.95,,
94740,3134,0,0,0,241.28,,
94741,3135,0,0,0,269.32,,
94742,2157474,0,0,0,181.56,249.99,
94754,5056100,3,2,1,29.99,,
94755,7718,0,0,0,170.73,,
94756,7718100,0,0,0,179.72,,
94757,7719,2,0,2,134.99,,
94758,7719100,0,0,0,179.72,,
94759,AT22-NY,0,0,0,26.37,36.99,
94768,740215-1,37,37,0,328.77,,
94769,700069-1,13,13,0,1830.00,,
94770,720118-1,0,0,0,26.51,,
94771,700068-1,32,32,0,262.58,,
94786,"FX-7 SHANK",0,0,0,79.99,,
94792,"FX-7 STOCK",0,0,0,8.16,,
94793,"FX-7 FLUKE",0,0,0,29.39,,
94794,"FX-7 CROWN",0,0,0,31.03,,
94795,"FX-7 CLIPSET",7,2,5,4.05,,
94796,"FX-7 MUDPALMSET",0,0,0,15.44,,
94797,"FX-11 SHANK",0,0,0,107.21,,
94798,"FX-11 STOCK",0,0,0,10.95,,
94799,"FX-11 FLUKE",2,0,2,39.39,,
94800,"FX-11 CROWN",1,1,0,41.58,,
94801,"FX-11 CLIPSET",0,0,0,5.88,,
94802,"FX-11 MUDPALMSET",0,0,0,15.44,,
94803,"FX-16 SHANK",0,0,0,155.10,,
94804,"FX-16 STOCK",0,0,0,15.83,,
94805,"FX-16 FLUKE",0,0,0,56.98,,
94806,"FX-16 CROWN",0,0,0,60.14,,
94807,"FX-16 CLIPSET",0,0,0,9.26,,
94808,"FX-16 MUDPALMSET",0,0,0,15.44,,
94809,"FX-23 SHANK",0,0,0,246.28,,
94810,"FX-23 STOCK",0,0,0,25.13,,
94811,"FX-23 FLUKE",0,0,0,90.46,,
94812,"FX-23 CROWN",0,0,0,95.50,,
94813,"FX-23 CLIPSET",0,0,0,14.54,,
94814,"FX-23 MUDPALMSET",0,0,0,25.73,,
94815,"FX-37 SHANK",0,0,0,366.60,,
94816,"FX-37 STOCK",0,0,0,37.41,,
94817,"FX-37 FLUKE",0,0,0,134.70,,
94818,"FX-37 CROWN",0,0,0,142.15,,
94819,"FX-37 CLIPSET",0,0,0,21.48,,
94820,"FX-37 MUDPALMSET",0,0,0,25.73,,
94821,"FX-55 SHANK",0,0,0,536.04,,
94822,"FX-55 STOCK",0,0,0,54.70,,
94823,"FX-55 FLUKE",0,0,0,196.91,,
94824,"FX-55 CROWN",0,0,0,207.86,,
94825,"FX-55 CLIPSET",0,0,0,32.90,,
94826,"FX-55 MUDPALMSET",0,0,0,25.73,,
94827,"FX-85 SHANK",0,0,0,822.41,,
94828,"FX-85 STOCK",0,0,0,83.93,,
94829,"FX-85 FLUKE",0,0,0,302.11,,
94830,"FX-85 CROWN",0,0,0,318.90,,
94831,"FX-85 CLIPSET",0,0,0,37.76,,
94832,"FX-85 MUDPALMSET",0,0,0,25.73,,
94833,"FX-125 SHANK",0,0,0,1205.06,,
94834,"FX-125 STOCK",0,0,0,116.73,,
94835,"FX-125 FLUKE",0,0,0,442.68,,
94836,"FX-125 CROWN",0,0,0,467.26,,
94837,"FX-125 CLIPSET",0,0,0,55.34,,
94838,"FX-125 MUDPALMSET",0,0,0,25.73,,
94843,8121,1,1,0,145.39,,
94844,8413,0,0,0,1065.78,,
94845,8421,0,0,0,162.39,,
94846,8521,0,0,0,162.39,,
94847,WUL6BK-25,2,2,0,23.80,,
94848,WUL6RD-25,4,2,2,23.80,,
94849,WUL6OR-25,3,1,2,23.80,,
94850,WUL6YL-25,0,0,0,23.80,,
94851,WUL6GN-25,4,2,2,23.80,,
94852,WUL6WH-25,8,4,4,23.80,,
94853,WUL6BK-50,4,2,2,46.00,,
94854,WUL6RD-50,4,2,2,46.00,,
94855,WUL6OR-50,4,2,2,46.00,,
94856,WUL6YL-50,4,2,2,46.00,,
94857,WUL6GN-50,5,2,3,46.00,,
94858,WUL6WH-50,6,3,3,46.00,,
94859,WUL6BK-100,4,2,2,88.00,,
94860,WUL6RD-100,5,1,4,88.00,,
94861,WUL6OR-100,4,2,2,88.00,,
94862,WUL6YL-100,4,2,2,88.00,,
94863,WUL6GN-100,4,2,2,88.00,,
94864,WUL6WH-100,9,6,3,91.00,,
94865,WUL6BK-250,3,0,3,212.50,,
94866,WUL6RD-250,4,0,4,212.50,,
94867,WUL6OR-250,0,0,0,212.50,,
94868,WUL6YL-250,0,0,0,212.50,,
94869,WUL6GN-250,4,2,2,212.50,,
94870,WUL6WH-250,0,0,0,212.50,,
94871,WUL6BK-500,0,0,0,440.00,,
94872,WUL6RD-500,0,0,0,440.00,,
94873,WUL6OR-500,0,0,0,440.00,,
94874,WUL6YL-500,0,0,0,440.00,,
94875,WUL6GN-500,0,0,0,440.00,,
94876,WUL6WH-500,0,0,0,440.00,,
94879,WUL6BK-FT,24,24,0,0.88,,
94882,WUL6RD-FT,44,44,0,0.88,,
94884,WUL6GN-FT,49,49,0,0.88,,
94886,WUL4BK-25,2,2,0,34.30,,
94887,WUL4RD-25,6,3,3,34.30,,
94888,WUL4YL-25,4,2,2,34.30,,
94889,WUL4GN-25,4,2,2,34.30,,
94890,WUL4WH-25,7,3,4,34.30,,
94891,WUL4BK-50,4,1,3,66.00,,
94892,WUL4RD-50,7,0,7,66.00,,
94893,WUL4YL-50,4,2,2,66.00,,
94894,WUL4GN-50,6,2,4,66.00,,
94895,WUL4WH-50,7,3,4,66.00,,
94896,WUL4BK-100,6,0,6,124.00,,
94897,WUL4RD-100,8,0,8,124.00,,
94898,WUL4YL-100,3,1,2,124.00,,
94899,WUL4GN-100,4,2,2,124.00,,
94900,WUL4WH-100,5,3,2,124.00,,
94901,WUL4BK-250,3,0,3,305.00,,
94902,WUL4RD-250,0,0,0,305.00,,
94903,WUL4YL-250,0,0,0,305.00,,
94904,WUL4GN-250,0,0,0,305.00,,
94905,WUL4WH-250,0,0,0,305.00,,
94906,WUL4BK-500,0,0,0,595.00,,
94907,WUL4RD-500,0,0,0,595.00,,
94908,WUL4YL-500,0,0,0,595.00,,
94909,WUL4GN-500,0,0,0,595.00,,
94910,WUL4WH-500,0,0,0,595.00,,
94913,WUL4BK-FT,49,49,0,1.24,,
94914,WUL4RD-FT,23,23,0,1.24,,
94915,WUL4YL-FT,24,24,0,1.24,,
94920,WUL2BK-25,4,2,2,54.00,,
94921,WUL2RD-25,10,5,5,54.00,,
94923,WUL2YL-25,6,4,2,54.00,,
94924,WUL2GN-25,6,4,2,54.00,,
94925,WUL2WH-25,6,1,5,54.00,,
94926,WUL2BK-50,5,4,1,100.00,,
94927,WUL2RD-50,6,3,3,100.00,,
94928,WUL2YL-50,4,2,2,100.00,,
94929,WUL2GN-50,5,2,3,100.00,,
94930,WUL2WH-50,6,4,2,100.00,,
94931,WUL2BK-100,3,2,1,198.00,,
94932,WUL2RD-100,6,0,6,198.00,,
94933,WUL2YL-100,3,2,1,198.00,,
94934,WUL2GN-100,7,4,3,198.00,,
94935,WUL2WH-100,9,5,4,198.00,,
94936,WUL2BK-250,0,0,0,482.50,,
94937,WUL2RD-250,2,0,2,482.50,,
94938,WUL2YL-250,3,2,1,482.50,,
94939,WUL2GN-250,0,0,0,482.50,,
94940,WUL2WH-250,0,0,0,482.50,,
94941,WUL2BK-500,0,0,0,940.00,,
94942,WUL2RD-500,0,0,0,940.00,,
94943,WUL2YL-500,0,0,0,940.00,,
94944,WUL2GN-500,0,0,0,940.00,,
94945,WUL2WH-500,0,0,0,940.00,,
94946,WUL2BK-FT,25,25,0,1.98,,
94947,WUL2RD-FT,39,39,0,1.98,,
94948,WUL2YL-FT,49,49,0,1.98,,
94949,WUL1BK-25,6,4,2,69.00,,
94950,WUL1RD-25,7,6,1,90.00,,
94951,WUL1YL-25,5,3,2,90.00,,
94952,WUL1BK-50,3,2,1,133.00,,
94953,WUL1RD-50,4,2,2,133.00,,
94954,WUL1YL-50,4,2,2,133.00,,
94955,WUL1BK-100,5,3,2,256.00,,
94956,WUL1RD-100,12,6,6,256.00,,
94957,WUL1YL-100,4,2,2,256.00,,
94958,WUL1BK-250,0,0,0,640.00,,
94959,WUL1RD-250,0,0,0,640.00,,
94960,WUL1YL-250,0,0,0,640.00,,
94961,WUL1BK-500,0,0,0,1265.00,,
94962,WUL1RD-500,0,0,0,1265.00,,
94963,WUL1YL-500,0,0,0,1265.00,,
94964,WUL1BK-FT,35,35,0,2.56,,
94965,WUL1RD-FT,65,65,0,2.56,,
94966,WUL1YL-FT,49,49,0,2.56,,
94967,WUL1/0BK-25,4,2,2,80.26,,
94968,WUL1/0RD-25,2,1,1,80.26,,
94969,WUL1/0YL-25,5,3,2,80.26,,
94970,WUL1/0BK-50,3,1,2,149.50,,
94971,WUL1/0YL-50,3,1,2,149.50,,
94972,WUL1/0BK-100,3,1,2,295.00,,
94973,WUL1/0RD-100,5,3,2,295.00,,
94974,WUL1/0YL-100,3,2,1,295.00,,
94975,WUL1/0BK-FT,51,51,0,2.96,,
94976,WUL1/0RD-FT,10,10,0,2.96,,
94977,WUL1/0YL-FT,46,46,0,2.96,,
94978,WUL2/0BK-25,5,3,2,101.00,,
94979,WUL2/0RD-25,6,2,4,101.00,,
94980,WUL2/0YL-25,4,2,2,101.00,,
94981,WUL2/0BK-50,4,2,2,187.50,,
94982,WUL2/0RD-50,6,2,4,187.50,,
94983,WUL2/0YL-50,1,0,1,187.50,,
94984,WUL2/0BK-100,5,3,2,370.00,,
94985,WUL2/0RD-100,5,1,4,370.00,,
94986,WUL2/0YL-100,3,1,2,370.00,,
94987,WUL2/0BK-250,0,0,0,905.00,,
94988,WUL2/0RD-250,0,0,0,905.00,,
94989,WUL2/0YL-250,0,0,0,905.00,,
94990,WUL2/0BK-FT,67,67,0,3.70,,
94991,WUL2/0RD-FT,85,85,0,3.70,,
94992,WUL2/0YL-FT,35,35,0,3.70,,
94993,WUL3/0BK-25,3,1,2,138.00,,
94994,WUL3/0RD-25,2,0,2,181.26,,
94995,WUL3/0YL-25,2,0,2,181.26,,
94996,WUL3/0BK-50,3,1,2,268.50,,
94997,WUL3/0RD-50,1,0,1,268.50,,
94998,WUL3/0YL-50,0,0,0,268.50,,
94999,WUL3/0BK-100,0,0,0,523.00,,
95000,WUL3/0RD-100,0,0,0,523.00,,
95001,WUL3/0YL-100,3,1,2,523.00,,
95002,WUL3/0BK-250,0,0,0,1275.00,,
95003,WUL3/0RD-250,0,0,0,1275.00,,
95004,WUL3/0YL-250,0,0,0,1275.00,,
95005,WUL3/0BK-FT,6,6,0,5.23,,
95006,WUL3/0RD-FT,8,8,0,5.23,,
95007,WUL3/0YL-FT,44,44,0,5.23,,
95008,WUL4/0BK-25,2,2,0,161.76,,
95009,WUL4/0RD-25,3,3,0,161.76,,
95010,WUL4/0YL-25,0,0,0,161.76,,
95011,WUL4/0BK-50,2,0,2,292.00,,
95012,WUL4/0RD-50,3,1,2,292.00,,
95013,WUL4/0YL-50,5,3,2,292.00,,
95014,WUL4/0BK-100,3,2,1,557.00,,
95015,WUL4/0RD-100,2,0,2,557.00,,
95016,WUL4/0YL-100,2,1,1,557.00,,
95017,WUL4/0BK-250,0,0,0,1392.50,,
95018,WUL4/0RD-250,0,0,0,1392.50,,
95019,WUL4/0YL-250,0,0,0,1392.50,,
95020,WUL4/0BK-FT,25,25,0,5.57,,
95021,WUL4/0RD-FT,0,0,0,5.57,,
95022,WUL4/0YL-FT,43,43,0,5.57,,
95023,WUL18BK-100,6,3,3,8.20,,
95024,WUL18BR-100,1,0,1,8.20,,
95025,WUL18RD-100,6,4,2,8.20,,
95026,WUL18OR-100,4,2,2,8.20,,
95027,WUL18YL-100,4,4,0,8.20,,
95028,WUL18GN-100,6,3,3,8.20,,
95029,WUL18BL-100,3,1,2,8.20,,
95030,WUL18VI-100,6,3,3,8.20,,
95031,WUL18GY-100,2,2,0,8.20,,
95032,WUL18WH-100,7,3,4,9.00,,
95033,WUL18BK-250,0,0,0,18.26,,
95034,WUL18BR-250,0,0,0,18.26,,
95035,WUL18RD-250,1,0,1,18.26,,
95036,WUL18OR-250,0,0,0,18.26,,
95037,WUL18YL-250,0,0,0,18.26,,
95038,WUL18GN-250,0,0,0,18.26,,
95039,WUL18BL-250,0,0,0,18.26,,
95040,WUL18VI-250,0,0,0,18.26,,
95041,WUL18GY-250,0,0,0,18.26,,
95042,WUL18WH-250,0,0,0,18.26,,
95043,WUL18BK-500,0,0,0,33.50,,
95044,WUL18BR-500,2,2,0,33.50,,
95045,WUL18RD-500,0,0,0,33.50,,
95046,WUL18OR-500,0,0,0,33.50,,
95047,WUL18YL-500,0,0,0,33.50,,
95048,WUL18GN-500,0,0,0,33.50,,
95049,WUL18BL-500,1,1,0,33.50,,
95050,WUL18VI-500,0,0,0,33.50,,
95051,WUL18GY-500,0,0,0,33.50,,
95052,WUL18WH-500,0,0,0,33.50,,
95053,WUL18BK-1000,0,0,0,60.00,,
95054,WUL18BR-1000,0,0,0,60.00,,
95055,WUL18RD-1000,0,0,0,60.00,,
95056,WUL18OR-1000,0,0,0,60.00,,
95057,WUL18YL-1000,0,0,0,60.00,,
95058,WUL18GN-1000,1,0,1,60.00,,
95059,WUL18BL-1000,0,0,0,71.54,,
95060,WUL18VI-1000,0,0,0,60.00,,
95061,WUL18GY-1000,0,0,0,60.00,,
95062,WUL18WH-1000,2,0,2,60.00,,
95063,WUL16BK-25,7,5,2,4.56,,
95064,WUL16BR-25,6,2,4,4.56,,
95065,WUL16RD-25,4,3,1,4.56,,
95066,WUL16OR-25,2,0,2,4.56,,
95067,WUL16YL-25,9,4,5,4.56,,
95068,WUL16GN-25,5,3,2,4.56,,
95069,WUL16LG-25,0,0,0,5.00,,
95070,WUL16BL-25,8,4,4,4.56,,
95071,WUL16LB-25,2,1,1,4.56,,
95072,WUL16VI-25,6,3,3,4.20,,
95073,WUL16GY-25,5,2,3,4.56,,
95075,WUL16WH-25,10,4,6,4.56,,
95076,WUL16TN-25,4,2,2,4.56,,
95077,WUL16PK-25,0,0,0,4.20,,
95078,WUL16BK-100,3,0,3,10.10,,
95079,WUL16BR-100,5,0,5,10.10,,
95080,WUL16RD-100,2,0,2,10.10,,
95081,WUL16OR-100,0,0,0,10.10,,
95082,WUL16YL-100,4,1,3,10.10,,
95083,WUL16GN-100,3,0,3,10.10,,
95084,WUL16LG-100,4,2,2,10.10,,
95085,WUL16BL-100,2,1,1,10.10,,
95086,WUL16LB-100,4,2,2,10.10,,
95087,WUL16VI-100,3,0,3,10.10,,
95088,WUL16GY-100,4,2,2,10.10,,
95089,WUL16WH-100,9,5,4,10.10,,
95090,WUL16TN-100,2,0,2,10.10,,
95091,WUL16PK-100,4,2,2,10.10,,
95092,WUL16BK-250,4,2,2,23.76,,
95093,WUL16BR-250,4,1,3,23.76,,
95094,WUL16RD-250,2,0,2,23.76,,
95095,WUL16OR-250,0,0,0,23.76,,
95096,WUL16YL-250,0,0,0,23.76,,
95097,WUL16GN-250,0,0,0,23.76,,
95098,WUL16LG-250,0,0,0,23.76,,
95099,WUL16BL-250,0,0,0,23.76,,
95100,WUL16LB-250,1,1,0,23.76,,
95101,WUL16VI-250,0,0,0,23.76,,
95102,WUL16GY-250,0,0,0,23.76,,
95103,WUL16WH-250,0,0,0,23.76,,
95104,WUL16TN-250,3,1,2,23.76,,
95105,WUL16PK-250,0,0,0,23.76,,
95106,WUL16BK-500,0,0,0,43.50,,
95107,WUL16BR-500,2,0,2,43.50,,
95108,WUL16RD-500,0,0,0,43.50,,
95109,WUL16OR-500,0,0,0,45.00,,
95110,WUL16YL-500,0,0,0,43.50,,
95111,WUL16GN-500,0,0,0,43.50,,
95112,WUL16LG-500,0,0,0,43.50,,
95113,WUL16BL-500,0,0,0,43.50,,
95114,WUL16LB-500,0,0,0,43.50,,
95115,WUL16VI-500,0,0,0,43.50,,
95116,WUL16GY-500,0,0,0,43.50,,
95117,WUL16WH-500,0,0,0,43.50,,
95118,WUL16TN-500,3,2,1,43.50,,
95119,WUL16PK-500,0,0,0,43.50,,
95120,WUL16BK-1000,0,0,0,85.00,,
95121,WUL16BR-1000,0,0,0,85.00,,
95122,WUL16RD-1000,0,0,0,85.00,,
95123,WUL16OR-1000,0,0,0,85.00,,
95124,WUL16YL-1000,0,0,0,85.00,,
95125,WUL16GN-1000,0,0,0,85.00,,
95126,WUL16LG-1000,0,0,0,85.00,,
95127,WUL16BL-1000,0,0,0,85.00,,
95128,WUL16LB-1000,0,0,0,85.00,,
95129,WUL16VI-1000,0,0,0,85.00,,
95130,WUL16GY-1000,0,0,0,85.00,,
95131,WUL16WH-1000,0,0,0,85.00,,
95132,WUL16TN-1000,0,0,0,85.00,,
95133,WUL16PK-1000,0,0,0,85.00,,
95134,WUL14BK-18,1,1,0,4.20,,
95135,MLS-410SP-W,24,13,11,37.49,,
95136,WUL14BR-18,2,1,1,4.20,,
95137,WUL14RD-18,5,3,2,4.20,,
95139,MLS-410PA-B,10,0,10,52.49,,
95141,WUL14GN-18,6,4,2,4.20,,
95142,MLS-410PA-W,13,9,4,52.49,,
95143,MLS-410LH-B,8,4,4,44.99,,
95145,MLS-410LH-W,4,2,2,44.99,,
95149,WUL14VI-18,7,4,3,4.20,,
95153,WUL14PK-18,1,1,0,4.20,,
95154,WUL14BK-25,4,2,2,5.23,,
95155,WUL14BR-25,2,0,2,5.23,,
95156,WUL14RD-25,5,3,2,5.23,,
95157,WUL14OR-25,4,2,2,5.23,,
95158,WUL14YL-25,4,2,2,5.23,,
95159,WUL14GR-25,8,3,5,5.00,,
95160,WUL14LG-25,0,0,0,5.23,,
95161,WUL14BL-25,0,0,0,5.23,,
95162,WUL14LB-25,2,2,0,5.23,,
95163,WUL14VI-25,6,4,2,5.23,,
95164,WUL14GY-25,2,2,0,5.23,,
95165,WUL14WH-25,7,4,3,5.23,,
95166,WUL14TN-25,3,1,2,5.23,,
95167,WUL14PK-25,4,2,2,5.23,,
95168,WUL14BK-100,14,5,9,14.30,,
95169,WUL14BR-100,3,3,0,14.30,,
95170,WUL14RD-100,4,1,3,14.30,,
95171,WUL14OR-100,4,2,2,14.30,,
95172,WUL14YL-100,6,2,4,14.30,,
95173,WUL14GN-100,4,2,2,14.30,,
95174,WUL14LG-100,4,2,2,14.30,,
95175,WUL14BL-100,0,0,0,14.30,,
95176,WUL14LB-100,1,0,1,15.00,,
95177,WUL14VI-100,8,4,4,14.30,,
95178,WUL14GY-100,1,0,1,14.30,,
95179,WUL14WH-100,6,4,2,14.30,,
95180,WUL14TN-100,4,2,2,14.30,,
95181,WUL14PK-100,4,2,2,14.30,,
95182,WUL14BK-250,2,0,2,34.76,,
95183,WUL14BR-250,0,0,0,34.76,,
95184,WUL14RD-250,2,0,2,34.76,,
95185,WUL14OR-250,2,0,2,34.76,,
95186,WUL14YL-250,0,0,0,34.76,,
95187,WUL14GN-250,0,0,0,34.76,,
95188,WUL14LG-250,0,0,0,34.76,,
95189,WUL14BL-250,0,0,0,34.76,,
95190,WUL14LB-250,4,2,2,34.76,,
95191,WUL14VI-250,0,0,0,34.76,,
95192,WUL14GY-250,0,0,0,34.76,,
95193,WUL14WH-250,0,0,0,34.76,,
95194,WUL14TN-250,3,2,1,34.76,,
95195,WUL14PK-250,0,0,0,34.76,,
95196,WUL14BK-500,0,0,0,62.50,,
95197,WUL14BR-500,0,0,0,62.50,,
95198,WUL14RD-500,0,0,0,62.50,,
95199,WUL14OR-500,0,0,0,62.50,,
95200,WUL14YL-500,2,1,1,62.50,,
95201,WUL14GN-500,1,0,1,65.00,,
95202,WUL14LG-500,0,0,0,62.50,,
95203,WUL14BL-500,0,0,0,62.50,,
95204,WUL14LB-500,0,0,0,62.50,,
95205,WUL14VI-500,0,0,0,62.50,,
95206,WUL14GY-500,0,0,0,62.50,,
95207,WUL14WH-500,0,0,0,62.50,,
95208,WUL14TN-500,3,2,1,62.50,,
95209,WUL14PK-500,0,0,0,62.50,,
95210,WUL14BK-1000,2,0,2,124.00,,
95211,WUL14BR-1000,2,0,2,124.00,,
95212,WUL14RD-1000,2,0,2,124.00,,
95213,WUL14OR-1000,2,0,2,124.00,,
95214,WUL14YL-1000,0,0,0,124.00,,
95215,WUL14GN-1000,0,0,0,124.00,,
95216,WUL14LG-1000,0,0,0,124.00,,
95217,WU14BL-1000,0,0,0,124.00,,
95218,WUL14LB-1000,0,0,0,124.00,,
95219,WUL14VI-1000,0,0,0,124.00,,
95220,WUL14GY-1000,0,0,0,124.00,,
95221,WUL14WH-1000,0,0,0,124.00,,
95222,WUL14TN-1000,0,0,0,124.00,,
95223,WUL14PK-1000,2,0,2,119.00,,
95224,CT3916-9002,0,0,0,1158.88,,
95235,WUL12BK-25,3,1,2,7.63,,
95236,WUL12BR-25,1,0,1,7.63,,
95237,WUL12RD-25,2,1,1,7.63,,
95238,WUL12OR-25,4,2,2,7.63,,
95239,WUL12YL-25,3,1,2,7.63,,
95241,WUL12BL-25,8,4,4,7.63,,
95242,WUL12VI-25,9,5,4,7.63,,
95243,WUL12GY-25,4,2,2,7.63,,
95244,WUL12WH-25,8,4,4,7.63,,
95245,WUL12BK-100,2,0,2,20.20,,
95246,WUL12BR-100,4,2,2,21.00,,
95247,WUL12RD-100,2,0,2,20.20,,
95248,WUL12OR-100,4,2,2,20.20,,
95249,WUL12YL-100,4,2,2,20.20,,
95250,WUL12GN-100,7,4,3,20.20,,
95251,WUL12BL-100,4,2,2,20.20,,
95252,WUL12VI-100,8,4,4,20.20,,
95253,WUL12GY-100,3,2,1,20.20,,
95254,WUL12WH-100,8,5,3,20.20,,
95255,WUL12BK-250,4,0,4,48.26,,
95256,WUL12BR-250,0,0,0,48.26,,
95257,WUL12RD-250,1,0,1,48.26,,
95258,WUL12OR-250,0,0,0,48.26,,
95259,WUL12YL-250,0,0,0,48.26,,
95260,WUL12GN-250,6,2,4,50.00,,
95261,WUL12BL-250,0,0,0,48.26,,
95262,WUL12VI-250,0,0,0,48.26,,
95263,WUL12GY-250,0,0,0,48.26,,
95264,WUL12WH-250,0,0,0,48.26,,
95265,WUL12BK-500,0,0,0,92.00,,
95266,WUL12BR-500,0,0,0,92.00,,
95267,WUL12RD-500,0,0,0,92.00,,
95268,WUL12OR-500,0,0,0,92.00,,
95269,WUL12YL-500,0,0,0,92.00,,
95270,WUL12GN-500,0,0,0,92.00,,
95271,WUL12BL-500,4,2,2,87.16,,
95272,WUL12VI-500,0,0,0,92.00,,
95273,WUL12GY-500,0,0,0,92.00,,
95274,WUL12WH-500,0,0,0,92.00,,
95290,WUL10YL-8,0,0,0,4.36,,
95296,WUL10BK-25,1,0,1,8.88,,
95297,WUL10BR-25,1,0,1,8.88,,
95298,WUL10RD-25,2,1,1,8.88,,
95299,WUL10OR-25,4,2,2,12.50,,
95300,WUL10YL-25,6,3,3,8.88,,
95301,WUL10GN-25,6,2,4,8.88,,
95302,WUL10BL-25,0,0,0,10.24,,
95303,WUL10VI-25,8,4,4,8.88,,
95304,WUL10GY-25,3,2,1,8.88,,
95305,WUL10WH-25,4,4,0,8.88,,
95306,WUL10BK-100,2,0,2,32.30,,
95307,WUL10BR-100,4,3,1,32.30,,
95308,WUL10RD-100,2,0,2,32.30,,
95309,WUL10OR-100,2,1,1,32.30,,
95310,WUL10YL-100,3,2,1,32.30,,
95311,WUL10GN-100,6,4,2,32.30,,
95312,WUL10BL-100,0,0,0,32.30,,
95313,WUL10VI-100,8,4,4,32.30,,
95314,WUL10GY-100,4,2,2,32.30,,
95315,WUL10WH-100,9,3,6,32.30,,
95316,WUL10BK-250,2,1,1,78.26,,
95317,WUL10BR-250,0,0,0,78.26,,
95318,WUL10RD-250,2,1,1,78.26,,
95319,WUL10OR-250,0,0,0,78.26,,
95320,WUL10YL-250,0,0,0,78.26,,
95321,WUL10GN-250,0,0,0,78.26,,
95322,WUL10BL-250,0,0,0,78.26,,
95323,WUL10VI-250,0,0,0,78.26,,
95324,WUL10GY-250,0,0,0,78.24,,
95325,WUL10WH-250,0,0,0,78.26,,
95326,WUL10BK-500,0,0,0,153.50,,
95327,WUL10BR-500,0,0,0,153.50,,
95328,WUL10RD-500,0,0,0,153.50,,
95329,WUL10OR-500,0,0,0,153.50,,
95330,WUL10YW-500,0,0,0,153.50,,
95331,WUL10GN-500,1,0,1,153.50,,
95332,WUL10BL-500,0,0,0,177.12,,
95333,WUL10VI-500,0,0,0,153.50,,
95334,WUL10GY-500,0,0,0,153.50,,
95335,WUL10WH-500,0,0,0,153.50,,
95346,WUL8BK-25,4,2,2,18.76,,
95347,WUL8RD-25,4,2,2,18.76,,
95348,WUL8YL-25,0,0,0,18.76,,
95349,WUL8GN-25,6,4,2,18.76,,
95350,WUL8WH-25,12,8,4,18.76,,
95351,WUL8BK-100,5,2,3,53.20,,
95352,WUL8RD-100,3,0,3,53.20,,
95353,WUL8YL-100,4,2,2,53.20,,
95354,WUL8GN-100,2,0,2,53.20,,
95356,WUL8WH-100,9,3,6,53.20,,
95357,WUL8BK-250,4,0,4,133.00,,
95358,WUL8RD-250,12,2,10,133.00,,
95359,WUL8YL-250,0,0,0,133.00,,
95360,WUL8GN-250,3,2,1,133.00,,
95361,WUL8WH-250,0,0,0,133.00,,
95362,WUL8BK-500,0,0,0,262.50,,
95363,WUL8RD-500,0,0,0,262.50,,
95364,WUL8YL-500,0,0,0,262.50,,
95365,WUL8GN-500,0,0,0,311.54,,
95366,WUL8WH-500,0,0,0,262.50,,
95367,WUL8BK-1000,0,0,0,494.00,,
95368,WUL8RD-1000,0,0,0,494.00,,
95369,WUL8YL-1000,0,0,0,494.00,,
95370,WUL8GN-1000,0,0,0,494.00,,
95371,WUL8WH-1000,0,0,0,494.00,,
95372,W18/2RYW-100,3,2,1,23.00,,
95373,W18/2RYW-250,2,0,2,55.00,,
95374,W18/2RYW-500,0,0,0,100.00,,
95375,W18/2YRW-1000,0,0,0,190.00,,
95376,W16/2RYW-100,3,0,3,27.69,,
95377,W16/2RYW-250,4,2,2,57.50,,
95378,2171001,39,28,11,11.41,,
95379,W16/2RYW-500,0,0,0,110.00,,
95380,W16/2RYW-1000,0,0,0,220.00,,
95381,W16/2RYW-FT,35,35,0,0.24,,
95384,W14/2RYW-100,3,0,3,33.00,,
95385,W142RYW-250,5,3,2,320.00,,
95386,W14/2RYW-500,0,0,0,160.00,,
95387,W14/2RYW-1000,0,0,0,320.00,,
95388,W14/2RYW-FT,90,90,0,0.33,,
95389,W12/2RYW-100,7,3,4,51.00,,
95390,W12/2RYW-250,4,2,2,122.50,,
95391,W12/2RYW-500,0,0,0,240.00,,
95392,W12/2RYW-1000,0,0,0,470.00,,
95393,914313,0,0,0,150.92,249.99,
95394,"G-5 SHANK",0,0,0,26.59,,
95395,"G-5 STOCK",0,0,0,5.33,,
95396,"G-5 FLUKE",0,0,0,13.30,,
95397,"G-5 CROWN",0,0,0,13.30,,
95398,"G-5 CLIPSET",0,0,0,2.96,,
95399,"G-5 MUDPALMSET",0,0,0,15.44,,
95400,"G-7 SHANK",0,0,0,34.14,,
95401,"G-7 STOCK",0,0,0,6.83,,
95402,"G-7 FLUKE",0,0,0,17.06,,
95403,"G-7 CROWN",0,0,0,17.06,,
95404,"G-7 CLIPSET",0,0,0,2.96,,
95405,"G-7 MUDPALMSET",0,0,0,15.44,,
95406,"G-11 SHANK",0,0,0,46.83,,
95407,"G-11 STOCK",0,0,0,9.36,,
95408,"G-11 FLUKE",0,0,0,23.41,,
95409,"G-11 CROWN",0,0,0,23.41,,
95410,"G-11 CLIPSET",0,0,0,4.05,,
95411,"G-11 MUDPALMSET",0,0,0,15.44,,
95412,"G-16 SHANK",0,0,0,67.88,,
95413,"G-16 STOCK",0,0,0,13.58,,
95414,"G-16 FLUKE",0,0,0,33.94,,
95415,"G-16 CROWN",0,0,0,33.94,,
95416,"G-16 CLIPSET",0,0,0,5.88,,
95417,"G-16 MUDPALMSET",0,0,0,25.73,,
95418,W10/2RYW-100,4,2,2,76.00,,
95419,W10/2RYW-250,3,1,2,182.50,,
95420,W10/2RYW-500,0,0,0,360.00,,
95421,W10/2RYW-1000,0,0,0,700.00,,
95422,W10/2RYW-FT,99,99,0,0.76,,
95423,W8/2RYW-50,3,1,2,64.00,,
95424,W8/2RYW-100,4,2,2,121.00,,
95425,W8/2RYW-250,2,0,2,290.00,,
95426,W8/2RYW-500,0,0,0,575.00,,
95427,"G-23 SHANK",0,0,0,107.16,,
95428,W6/2RYW-50,7,3,4,111.50,,
95429,"G-23 STOCK",0,0,0,21.43,,
95430,W6/2RYW-100,7,3,4,208.00,,
95431,"G-23 FLUKE",0,0,0,53.59,,
95432,W6/2RYW-250,3,1,2,507.50,,
95433,"G-23 CROWN",0,0,0,53.59,,
95434,"G-23 CLIPSET",0,0,0,9.26,,
95435,W6/2RYW-500,0,0,0,995.00,,
95436,"G-23 MUDPALMSET",0,0,0,25.73,,
95437,"G-37 SHANK",0,0,0,168.09,,
95438,"G-37 STOCK",0,0,0,33.61,,
95439,"G-37 FLUKE",0,0,0,84.05,,
95440,"G-37 CROWN",0,0,0,84.05,,
95441,"G-37 CLIPSET",0,0,0,14.54,,
95442,W18/2DC-100,11,4,7,23.00,,
95443,"G-37 MUDPALMSET",0,0,0,25.73,,
95444,W18/2DC-250,2,0,2,55.00,,
95445,W18/2DC-500,0,0,0,100.00,,
95446,"G-55 SHANK",0,0,0,257.19,,
95447,"G-55 STOCK",0,0,0,49.66,,
95448,W18/2DC-1000,0,0,0,190.00,,
95449,"G-55 FLUKE",0,0,0,124.13,,
95450,"G-55 CROWN",0,0,0,124.13,,
95451,"G-55 CLIPSET",0,0,0,21.48,,
95452,W16/2DC-100,7,4,3,24.00,,
95453,"G-55 MUDPALMSET",0,0,0,25.73,,
95454,W16/2DC-250,6,4,2,57.50,,
95455,W16/2DC-500,0,0,0,110.00,,
95456,W16/2DC-1000,0,0,0,220.00,,
95457,"G-85 SHANK",0,0,0,380.46,,
95458,W14/2DC-100,8,0,8,33.00,,
95459,"G-85 STOCK",0,0,0,76.09,,
95460,"G-85 FLUKE",0,0,0,190.21,,
95461,"G-85 CROWN",0,0,0,190.21,,
95462,W14/2DC-250,8,1,7,80.00,,
95463,W14/2DC-500,0,0,0,160.00,,
95464,W14/2DC-1000,0,0,0,320.00,,
95465,"G-85 CLIPSET",0,0,0,32.90,,
95466,W12/2DC-100,8,5,3,51.00,,
95467,"G-85 MUDPALMSET",0,0,0,25.73,,
95468,W12/2DC-250,4,2,2,122.50,,
95469,W12/2DC-500,2,2,0,240.00,,
95470,"G-125 SHANK",0,0,0,563.80,,
95471,W12/2DC-1000,0,0,0,470.00,,
95472,"G-125 STOCK",0,0,0,112.76,,
95473,"G-125 FLUKE",0,0,0,281.90,,
95474,"G-125 CROWN",0,0,0,281.90,,
95475,"G-125 CLIPSET",0,0,0,37.76,,
95476,"G-125 MUDPALMSET",0,0,0,25.73,,
95477,W10/2DC-100,7,2,5,76.00,,
95478,W10/2DC-250,5,2,3,182.50,,
95479,W10/2DC-500,0,0,0,360.00,,
95480,W10/2DC-1000,0,0,0,700.00,,
95481,W10/2DC-FT,163,163,0,0.76,,
95482,W8/2DC-50,15,4,11,64.00,,
95483,W8/2DC-100,5,5,0,121.00,,
95484,W8/2DC-250,3,0,3,290.00,,
95485,W8/2DC-500,0,0,0,575.00,,
95486,W8/2DC-FT,61,61,0,1.21,,
95487,W6/2DC-50,5,1,4,106.50,,
95488,W6/2DC-100,5,0,5,198.00,,
95489,W6/2DC-250,2,0,2,485.00,,
95490,W6/2DC-500,0,0,0,950.00,,
95491,W6/2DC-FT,74,74,0,1.98,,
95492,SC-CW-01F,14,7,7,50.60,,
95493,SC-CW-02F,16,15,1,51.75,,
95494,SC-CW-04F,18,7,11,95.35,,
95495,SC-CW-05F,19,10,9,113.91,,
95496,SC-CW-06F,0,0,0,70.31,,
95497,SC-CW-07F,22,10,12,50.60,,
95498,SC-CW-08F,9,1,8,64.69,,
95499,SC-CW-09F,20,18,2,72.56,,
95500,SC-CW-10F,25,12,13,80.16,,
95501,SC-CW-BZ,4,2,2,10.26,,
95502,WR16/2RYW-100,5,3,2,47.00,,
95503,WR16/2RYW-250,3,1,2,105.00,,
95504,WR16/2RYW-500,0,0,0,219.23,,
95505,WR14/2RYW-100,5,3,2,55.00,,
95506,WR14/2RYW-250,2,0,2,127.50,,
95507,WR14/2RYW-500,0,0,0,305.77,,
95508,WR12/2RYW-100,7,4,3,79.00,,
95509,WR12/2RYW-250,3,1,2,212.50,,
95510,WR12/2RYW-500,3,0,3,375.00,,
95511,WR10/2RYW-100,4,2,2,126.00,,
95512,WR10/2RYW-250,4,0,4,312.50,,
95513,WR10/2RYW-500,3,0,3,545.00,,
95514,W16/3-100,4,2,2,38.00,,
95515,W16/3-250,0,0,0,92.50,,
95516,010-13194-00,0,0,0,44.99,,
95517,W16/3-500,0,0,0,180.00,,
95518,W16/3-1000,0,0,0,350.00,,
95519,W14/3-100,4,2,2,49.00,,
95520,W14/3-250,2,1,1,120.00,,
95521,W14/3-500,0,0,0,225.00,,
95522,W14/3-1000,0,0,0,440.00,,
95523,W12/3-100,6,2,4,73.00,,
95524,W12/3-250,4,2,2,177.50,,
95525,W12/3-500,0,0,0,365.00,,
95526,W12/3-1000,0,0,0,690.00,,
95527,W10/3-100,5,3,2,108.00,,
95528,W10/3-250,0,0,0,267.50,,
95529,W10/3-500,0,0,0,530.00,,
95530,W8/3-50,2,0,2,105.50,,
95531,W8/3-100,3,2,1,206.00,,
95532,W8/3-250,0,0,0,500.00,,
95533,W8/3-500,0,0,0,965.00,,
95534,W6/3-50,3,1,2,197.50,,
95535,W6/3-100,4,2,2,389.00,,
95536,W6/3-250,0,0,0,942.50,,
95583,30302CASE,1,0,1,27.60,,
95584,30302,27,0,27,2.76,,
95588,BAT512110610,0,0,0,583.58,,719.95
95589,BAT524110610,0,0,0,1190.59,,1468.80
95590,BAT524120610,0,0,0,1719.05,,2120.75
95609,EOS-II-MPLS-BK,2,1,1,67.06,99.99,
95614,HE-BD32,0,0,0,240.18,,
95615,HE-BD42,0,0,0,312.94,,
95617,10-044,0,0,0,11.28,,
95622,T10-322,0,0,0,45.00,,
95623,66810025,3,1,2,1661.47,,
95624,68000535,4,2,2,1721.68,,
95625,68000358,3,2,1,392.86,,
95626,SDTG2401001,4,2,2,1178.88,,1454.35
95628,10-912,0,0,0,15.13,,
95629,10-911,1,0,1,12.38,,
95630,106999,0,0,0,191.29,,
95631,106099,0,0,0,182.40,,
95658,CT3926-9003,0,0,0,1839.12,,
95659,800137CS,0,0,0,3.99,6.97,
95661,SM-ACC3-RCGA-PUCK,3,2,1,80.26,,98.79
95662,710308-1,1,1,0,2533.44,,2999.99
95663,740210-1,7,5,2,1266.71,,1499.99
95664,411840-1,1,0,1,83.33,,
95665,740211-1,0,0,0,172.86,,
95674,65001063,0,0,0,2.26,,
95675,66000102,4,2,2,129.97,,
95676,66000103,2,0,2,48.53,,
95677,66000104,4,0,4,26.18,,
95678,66000107,3,2,1,166.29,,
95679,66000108,4,1,3,21.01,,
95680,66000605,4,2,2,41.84,,
95681,66000612,2,0,2,171.84,,
95682,66000613,6,2,4,124.43,,
95683,66000614,5,3,2,43.56,,
95684,66000615,4,1,3,12.99,,
95687,T10-534,0,0,0,78.75,,139.99
95692,A10-223,0,0,0,28.13,,
95693,A10-220,0,0,0,28.13,,
95694,A10-219,0,0,0,28.13,,
95695,A10-225,0,0,0,56.25,,
95696,10-187,0,0,0,24.06,,
95697,10-183,2,1,1,15.81,,
95698,10-182,0,0,0,13.06,,
95699,A10-272,0,0,0,11.25,,
95700,T10-785,0,0,0,73.13,,
95701,A10-230,0,0,0,28.13,,
95702,A10-231,0,0,0,28.13,,
95703,A10-232,0,0,0,28.13,,
95704,A10-890JB,0,0,0,39.38,,
95705,A10-890PB,0,0,0,39.38,,
95706,T10-980,0,0,0,70.31,,124.99
95707,T10-348,0,0,0,162.49,,199.99
95709,CO10-191,0,0,0,52.49,,69.99
95710,CO10-295,0,0,0,67.49,,89.99
95711,CO10-393,0,0,0,11.25,,
95714,CO10-192,0,0,0,67.49,,89.99
95715,CO10-292,0,0,0,74.99,,99.99
95716,T10-346,0,0,0,33.75,,
95717,T10-347,0,0,0,78.75,,
95720,621-120-DV,2,0,2,625.99,766.00,
95722,5530-36BP7,6,4,2,42.61,,
95723,5530-42BP7,8,5,3,48.07,,
95724,594-MW,5,3,2,193.92,,
95725,SC-USB-F2,0,0,0,29.23,,
95731,88531,0,0,0,1216.46,1899.99,
95759,10-769,0,0,0,20.61,,
95760,10-770,0,0,0,20.63,,
95761,CO10-272,0,0,0,34.38,,
95762,010-13089-10,1,1,0,73.07,,
95763,010-13089-00,1,0,1,65.76,,
95764,010-13089-30,2,0,2,21.91,,
95791,01-0432-11,1,0,1,13099.99,,
95792,01-0436-11,0,0,0,20156.40,,
95793,01-0441-11,0,0,0,28796.40,,
95794,R70430,3,0,3,93.74,,
95795,03-REV-HK,19,8,11,25.61,,
95796,03-REV-SB,23,11,12,36.67,,
95797,03-REV-FB,23,11,12,36.67,,
95798,03-REV-UF,22,11,11,29.27,,
95799,03-REV-SBP,36,18,18,109.02,,
95800,03-REV-FBP,33,17,16,92.99,,
95801,39970812,0,0,0,1029.59,,
95802,S522-NY,0,0,0,82.89,113.99,
95803,S722-NY,5,2,3,97.96,133.99,
95812,TM260-9N,0,0,0,987.78,,
95813,6CM-D5OS,0,0,0,213.50,259.25,
95814,10CM-D5OS,4,2,2,311.50,378.25,
95815,20CCM-D5OS,9,4,5,493.50,599.25,
95816,30CCM-D5OS,8,4,4,682.50,828.75,
95817,40CCM-D5OS,7,4,3,875.00,1062.50,
95818,50CCM-D5OS,3,0,3,1148.00,1394.00,
95819,10CC-D5OS,0,0,0,290.50,352.75,
95820,20CC-D5OS,0,0,0,476.00,578.00,
95821,30CC-D5OS,0,0,0,658.00,799.00,
95822,40CC-D5OS,0,0,0,822.50,998.75,
95823,50CC-D5OS,0,0,0,1036.00,1258.00,
95824,4F-D5OS,0,0,0,161.00,195.50,
95825,4S-D5OS,0,0,0,161.00,195.50,
95826,6C-D5OS,0,0,0,192.50,233.75,
95827,20C-D5OS,0,0,0,476.00,578.00,
95828,10C-D5OS,0,0,0,290.50,352.75,
95829,30C-D5OS,0,0,0,658.00,799.00,
95830,40C-D5OS,1,0,1,822.50,998.75,
95831,50C-D5OS,0,0,0,1036.00,1258.00,
95832,20SL-D5OS,3,2,1,476.00,578.00,
95833,10CM-S5OS,0,0,0,234.50,284.75,
95834,20CM-S5OS,0,0,0,385.00,467.50,
95837,SS125-REC-KIT,0,0,0,51.41,,
95838,30CM-S5OS,1,0,1,532.00,646.00,
95839,40CM-S5OS,3,1,2,686.00,833.00,
95840,50CM-S5OS,2,1,1,875.00,1062.50,
95841,6C-S5OS,0,0,0,143.50,174.25,
95842,MAL-RGB,6,2,4,43.40,52.70,
95843,RL-W,2,0,2,35.00,42.50,
95844,RL-R,4,2,2,35.00,42.50,
95845,RL-A,9,6,3,35.00,42.50,
95846,RL-G,0,0,0,35.00,42.50,
95847,RL-B,6,0,6,35.00,42.50,
95848,RL-RGB,7,4,3,43.40,52.70,
95849,RGB-C,3,2,1,43.40,52.70,
95850,DIM,3,2,1,43.40,52.70,
95851,2IR-POD850,22,12,10,101.25,114.75,
95852,10IR-850,2,0,2,364.00,442.00,
95853,20IR-850,3,1,2,511.00,620.50,
95854,2IR-POD940,4,2,2,101.25,114.75,
95855,10IR-940,2,2,0,364.00,442.00,
95856,20IR-940,3,2,1,511.00,620.50,
95857,2MIR-POD850,3,1,2,108.75,123.25,
95858,10MIR-850,4,0,4,381.50,463.25,
95859,20MIR-850,3,2,1,532.00,646.00,
95860,2R-POD3OS,0,0,0,97.50,110.50,
95861,2G-POD3OS,0,0,0,97.50,110.50,
95862,10R-D3OS,1,0,1,311.50,378.25,
95863,10G-D3OS,0,0,0,311.50,378.25,
95864,20CR-D3OS,4,0,4,490.00,595.00,
95865,20CG-D30S,0,0,0,490.00,595.00,
95866,30CR-D3OS,3,0,3,675.50,820.25,
95867,30CG-D3OS,0,0,0,675.50,820.25,
95868,10C-S5OS,0,0,0,213.50,259.25,
95869,20C-S5OS,2,2,0,357.00,433.50,
95870,30C-S5OS,1,0,1,472.50,573.75,
95871,40C-S5OS,2,2,0,658.00,799.00,
95872,50C-S5OS,2,2,0,738.50,896.75,
95873,2FM-POD10CR,3,0,3,101.25,114.75,
95874,2DM-POD10CR,0,0,0,101.25,114.75,
95875,2SM-POD10CR,3,0,3,101.25,114.74,
95876,2F-POD10CR,2,2,0,96.75,109.65,
95877,2D-POD10CR,2,2,0,96.75,109.65,
95878,2S-POD10CR,3,2,1,96.75,109.65,
95879,2F-FPOD10CR,0,0,0,112.50,127.50,
95880,2D-FPOD10CR,0,0,0,112.50,127.50,
95881,2DM-FPOD10CR,0,0,0,116.25,131.75,
95882,2SL-POD10CR,6,4,2,96.75,109.65,
95883,4MS-S,9,3,6,112.00,136.00,
95884,4MS-F,6,2,4,112.00,136.00,
95885,2-MS-S,10,5,5,73.50,89.25,
95886,2SR-SL-10CR,2,0,2,70.00,85.00,
95887,2FSLB-S,8,8,0,78.40,95.20,
95888,2FSL-SRPOD10CR,3,3,0,81.90,99.45,
95889,4FMSL-S,6,2,4,122.50,148.75,
95890,4BFMSL-S,1,0,1,119.00,144.50,
95891,MAL-W,13,8,5,35.00,42.50,
95892,MAL-B,6,0,6,35.00,42.50,
95893,MAL-R,4,0,4,35.00,42.50,
95894,MAL-G,2,0,2,35.00,42.50,
95895,FASP3422X02CA00,0,0,0,60.99,,
95896,010-13248-00,0,0,0,89.99,,
95897,010-13248-01,0,0,0,22.49,,
95898,010-13248-02,0,0,0,22.49,,
95903,E-4209-10,6,6,0,88.75,,
95904,E-4209-14,0,0,0,96.25,,
95905,E-4209-24,0,0,0,118.75,,
95906,E-4209-28,0,0,0,131.25,,
95907,E-4209-36,1,0,1,167.50,,
95908,E-4209-42,0,0,0,181.25,,
95909,E-4209-50,0,0,0,200.00,,
95910,90107,0,0,0,15.00,,
95913,WH2,0,0,0,28.00,34.00,
95914,WH4,3,1,2,31.50,38.35,
95916,2000038028,0,0,0,42.06,,
95917,3000004258,10,7,3,90.88,,
95918,2000034936,0,0,0,11.18,,
95920,2000034939,0,0,0,32.06,,
95924,SS100-CIR-KIT,0,0,0,51.41,,
95932,2A-POD30S,4,2,2,81.75,92.65,
95933,010-C1285-00,0,0,0,224.99,,
95934,010-C1286-00,3,0,3,224.99,,
95936,MSD57602-251-M-101,0,0,0,1312.51,,
95937,MSD57602-251-L-101,0,0,0,1312.51,,
95938,MSD57602-251-XL-101,0,0,0,1312.51,,
95939,MSD57602-251-XXL-101,0,0,0,1312.51,,
95941,11881,0,0,0,598.35,,
95943,MSD62403-251-XSS-101,0,0,0,1662.51,,
95944,MSD62403-251-XSR-101,0,0,0,1662.51,,
95945,MSD62403-251-XSL-101,0,0,0,1662.51,,
95946,MSD62403-251-SS-101,0,0,0,1662.51,,
95947,MSD62403-251-SR-101,0,0,0,1662.51,,
95948,MSD62403-251-SL-101,0,0,0,1662.51,,
95949,MSD62403-251-MS-101,0,0,0,1662.51,,
95950,MSD62403-251-MR-101,0,0,0,1662.51,,
95951,MSD62403-251-ML-101,0,0,0,1662.51,,
95952,MSD62403-251-L1S-101,0,0,0,1662.51,,
95953,MSD62403-251-L1R-101,0,0,0,1662.51,,
95954,MSD62403-251-L1L-101,0,0,0,1662.51,,
95955,MSD62403-251-L2S-101,0,0,0,1662.51,,
95956,MSD62403-251-L2R-101,0,0,0,1662.51,,
95957,MSD62403-251-L2L-101,0,0,0,1662.51,,
95958,MSD62403-251-XLS-101,0,0,0,1662.51,,
95959,MSD62403-251-XLR-101,0,0,0,1662.51,,
95960,MSD62403-251-XLL-101,0,0,0,1662.51,,
95961,MSD62403-251-XXLS-101,0,0,0,1662.51,,
95962,MSD62403-251-XXLR-101,0,0,0,1662.51,,
95963,MSD62403-251-XXLL-101,0,0,0,1662.51,,
95964,MSD62403-251-3XLS-101,0,0,0,1662.51,,
95965,MSD62403-251-3XLR-101,0,0,0,1662.51,,
95966,MSD62403-251-3XLL-101,0,0,0,1662.51,,
95972,33-957-400,0,0,0,24.71,,
95973,"XT-DF4-250-DV-KIT ",2,0,2,1179.78,1444.00,
95976,5620-6,0,0,0,14.04,,
95979,G-1-PINKWO,0,0,0,13.46,,
95980,G-2-PINKWO,0,0,0,15.73,,
95981,G-3-PINKWO,0,0,0,18.94,,
95982,G-4-PINKWO,0,0,0,28.71,,
95983,G-5-PINKWO,0,0,0,55.39,,
95984,G-6-PINKWO,0,0,0,73.13,,
95986,NVC-W-S,5,2,3,3525.00,3995.00,
95987,NVC-W-T,0,0,0,3577.50,4054.50,
95989,010-02590-25,0,0,0,439.99,,
96000,SPC40RT,0,0,0,75.00,,
96003,010-C1213-20,0,0,0,112.49,,
96004,010-C1214-20,0,0,0,112.49,,
96005,010-C1215-20,2,0,2,74.99,,
96006,010-C1216-20,2,0,2,74.99,,
96007,010-C1217-20,2,0,2,74.99,,
96008,010-C1218-20,2,0,2,74.99,,
96009,010-C1219-20,2,0,2,74.99,,
96010,010-C1220-20,0,0,0,74.99,,
96011,010-C1221-20,2,0,2,74.99,,
96012,010-C1222-20,2,0,2,74.99,,
96013,010-C1223-20,2,0,2,74.99,,
96014,010-C1224-20,0,0,0,82.49,,
96015,010-C1225-20,0,0,0,82.49,,
96016,010-C1226-20,0,0,0,82.49,,
96017,010-C1227-20,0,0,0,82.49,,
96018,S522-BK,2,0,2,82.89,113.99,
96019,FRED21-BK,0,0,0,22.38,30.99,
96021,010-C1228-20,0,0,0,112.49,,
96022,010-C1229-20,0,0,0,82.49,,
96023,010-C1230-20,0,0,0,82.49,,
96024,010-C1231-20,0,0,0,82.49,,
96025,010-C1232-20,0,0,0,82.49,,
96026,XKA9X9,4,2,2,521.87,646.00,
96027,010-C1233-20,0,0,0,82.49,,
96028,XKA9X12,4,2,2,535.60,663.00,
96029,010-C1234-20,0,0,0,82.49,,
96030,010-C1235-20,0,0,0,82.49,,
96031,XKA9X18,3,1,2,773.19,957.10,
96032,XKA9X24,3,1,2,847.35,1048.90,
96033,010-C1236-20,0,0,0,82.49,,
96034,010-C1237-20,0,0,0,82.49,,
96035,010-C1238-20,0,0,0,82.49,,
96036,XKA12X9,3,1,2,538.35,666.40,
96037,XKA12X12,4,1,3,563.07,697.00,
96038,010-C1239-20,0,0,0,82.49,,
96039,XKA12X18,5,1,4,780.05,965.60,
96040,XKA12X24,3,1,2,1223.64,1514.70,
96041,XKA9X9A,3,2,1,482.04,596.70,
96042,XKA9X12A,3,2,1,505.39,625.60,
96044,010-C1240-20,0,0,0,82.49,,
96045,XKA9X18A,2,1,1,556.20,688.50,
96047,010-C1241-20,0,0,0,82.49,,
96049,XKA9X24A,3,1,2,607.01,751.40,
96050,010-C1242-20,0,0,0,82.49,,
96051,XKA12X9A,1,0,1,491.65,608.60,
96052,XKA12X12A,2,1,1,513.63,635.80,
96054,XKA12X18A,2,1,1,582.29,720.80,
96056,XKA12X24A,2,2,0,642.72,795.60,
96057,010-C1243-20,0,0,0,82.49,,
96058,010-C1244-20,0,0,0,82.49,,
96059,010-C1245-20,0,0,0,82.49,,
96060,010-C1246-20,0,0,0,82.49,,
96061,010-C1247-20,0,0,0,82.49,,
96062,010-C1248-20,0,0,0,82.49,,
96063,010-C1249-20,0,0,0,82.49,,
96064,010-C1250-20,0,0,0,82.49,,
96065,010-C1251-20,0,0,0,82.49,,
96066,010-C1252-20,0,0,0,82.49,,
96067,010-C1253-20,0,0,0,82.49,,
96068,010-C1254-20,0,0,0,82.49,,
96069,010-C1255-20,0,0,0,82.49,,
96070,010-C1256-20,0,0,0,82.49,,
96071,010-C1258-20,0,0,0,82.49,,
96072,010-C1259-20,0,0,0,82.49,,
96073,010-C1260-20,0,0,0,82.49,,
96074,010-C1261-20,0,0,0,82.49,,
96075,010-C1262-20,0,0,0,82.49,,
96076,010-C1264-20,0,0,0,82.49,,
96077,010-C1266-20,0,0,0,82.49,,
96078,010-C1267-20,0,0,0,82.49,,
96079,010-C1268-20,0,0,0,82.49,,
96080,010-C1269-20,0,0,0,82.49,,
96081,010-C1270-20,0,0,0,112.49,,
96082,010-C1271-20,0,0,0,112.49,,
96083,010-C1272-20,0,0,0,112.49,,
96084,010-C1273-20,0,0,0,112.49,,
96085,010-C1274-20,0,0,0,112.49,,
96086,010-C1275-20,0,0,0,112.49,,
96087,010-C1276-20,0,0,0,112.49,,
96089,010-C1279-20,0,0,0,104.99,,
96090,010-C1280-20,0,0,0,59.99,,
96091,010-C1281-20,0,0,0,59.99,,
96092,010-C1282-20,0,0,0,59.99,,
96093,010-C1283-20,0,0,0,59.99,,
96094,010-C1284-20,0,0,0,59.99,,
96095,010-C1285-20,13,2,11,112.49,,
96096,010-C1286-20,13,2,11,112.49,,
96100,0058102,8,5,3,84.26,,
96101,0058103,15,8,7,139.88,,
96103,0058105,12,7,5,202.21,,
96104,0058107,6,4,2,326.89,,
96105,0058110,6,3,3,523.39,,
96108,66000618,3,1,2,21.76,,
96109,66000619,5,4,1,7.71,,
96110,66000634,3,0,3,50.59,,
96111,66000649,5,4,1,7.71,,
96112,66000758,2,1,1,22.93,,
96113,66000759,3,3,0,28.57,,
96114,66000763,3,2,1,178.53,,
96115,66000764,3,1,2,40.26,,
96116,66000769,1,1,0,112.32,,
96117,66200146,2,2,0,146.12,,
96118,66000096,7,3,4,21.59,,
96119,66000097,8,4,4,41.84,,
96120,66000098,1,1,0,56.15,,
96121,66000600,1,0,1,21.59,,
96122,66000607,9,4,5,12.54,,
96123,66000609,2,1,1,77.26,,
96124,66000617,3,3,0,21.01,,
96125,66000628,2,1,1,16.56,,
96126,66000631,3,0,3,28.57,,
96127,66000635,2,0,2,257.82,,
96137,66000636,2,1,1,114.56,,
96138,66000760,3,0,3,129.97,,
96141,66000761,2,1,1,284.13,,
96142,68001024,3,0,3,102.93,,
96144,65001211,0,0,0,16.56,,
96145,66810065,3,0,3,877.91,,
96146,68000951,2,1,1,596.34,,
96147,66000720,4,2,2,71.97,,
96148,68000360,3,2,1,360.82,,
96149,68000361,2,1,1,360.82,,
96150,68000362,4,3,1,360.82,,
96151,19700501,2,2,0,55.65,,
96152,19701100,0,0,0,43.09,,
96153,19701500,0,0,0,39.71,,
96154,19701600,0,0,0,11.31,,
96155,45000108P,9,3,6,26.56,,
96156,45000308P,2,0,2,29.50,,
96157,45000408P,2,1,1,31.78,,
96158,45000508P,1,0,1,34.06,,
96159,45500108P,5,1,4,19.22,,
96160,45500308P,1,0,1,19.22,,
96161,45500408P,1,0,1,20.34,,
96162,45500508P,1,1,0,21.50,,
96163,45500608P,3,2,1,22.53,,
96164,48000014,0,0,0,42.19,,
96165,48000017,0,0,0,33.96,,
96166,48000018,4,1,3,81.85,,
96167,48000019,0,0,0,33.96,,
96169,ALC-1,4,0,4,831.92,1071.00,
96170,MLC-1,2,0,2,283.91,365.50,
96171,SAF-SC,3,0,3,82.54,106.25,
96173,"HELM FITTING",4,2,2,12.92,,
96174,"BOSS FITTING",36,6,30,26.79,,
96177,CO10-101-M,8,2,6,231.57,,
96178,CO10-105-M,7,3,4,173.67,,
96179,CO10-103-M,4,0,4,173.67,,299.99
96180,CO10-101,9,3,6,205.25,,299.99
96181,CO10-102,8,4,4,273.67,,399.99
96182,CO10-105,1,1,0,100.00,,
96183,CO10-103,2,0,2,100.00,,
96184,CO10-104,1,0,1,88.94,,129.99
96185,CO10-106,3,2,1,54.73,,
96186,A10-210JB,11,5,6,25.63,,
96188,RMX4800-14,0,0,0,436.35,,
96189,"CONNECTOR FITT.",8,3,5,14.80,,
96190,"BLEED TEE",6,4,2,24.48,,
96191,"UNION T",1,1,0,14.03,,
96192,DSM410-DUST-COVER,1,0,1,8.56,,
96193,010-C1213-00,0,0,0,224.99,,
96194,010-C1214-00,0,0,0,224.99,,
96195,010-C1215-00,7,0,7,112.49,,
96196,010-C1216-00,7,0,7,112.49,,
96197,010-C1217-00,7,0,7,112.49,,
96198,010-C1218-00,7,0,7,112.49,,
96199,010-C1219-00,7,0,7,112.49,,
96200,010-C1220-00,7,0,7,112.49,,
96201,010-C1221-00,7,0,7,112.49,,
96202,010-C1222-00,7,0,7,112.49,,
96203,010-C1223-00,7,0,7,112.49,,
96204,010-C1224-00,0,0,0,112.49,,
96205,010-C1225-00,0,0,0,112.49,,
96206,010-C1226-00,0,0,0,112.49,,
96207,010-C1227-00,0,0,0,112.49,,
96208,010-C1228-00,0,0,0,187.49,,
96209,010-C1229-00,0,0,0,112.49,,
96210,010-C1230-00,0,0,0,112.49,,
96211,010-C1231-00,0,0,0,112.49,,
96212,010-C1232-00,0,0,0,112.49,,
96213,010-C1233-00,0,0,0,112.49,,
96214,010-C1234-00,0,0,0,112.49,,
96215,010-C1235-00,0,0,0,112.49,,
96216,010-C1236-00,0,0,0,112.49,,
96217,010-C1238-00,0,0,0,112.49,,
96218,010-C1239-00,0,0,0,112.49,,
96219,010-C1240-00,0,0,0,112.49,,
96220,010-C1241-00,0,0,0,112.49,,
96221,010-C1242-00,0,0,0,112.49,,
96222,ZDIGGPS160F,3,2,1,224.96,,
96229,PM111C-LHW,0,0,0,2813.89,,
96232,QUA481030010,0,0,0,2780.11,,3429.75
96252,SS60-SLTD/20,0,0,0,355.56,,
96253,A-BK,1,0,1,174.41,215.90,
96254,A-BK-13,5,2,3,184.03,227.80,
96255,S-BK-16,1,0,1,199.13,246.50,
96256,A-BK-20,4,2,2,195.71,242.25,
96257,A-BK-43,4,1,3,209.44,259.25,
96258,A-BK-26,4,1,3,194.33,,
96259,BL,5,1,4,12.36,15.30,
96260,BU,1,1,0,12.36,15.30,
96261,BU-5,4,0,4,13.73,17.00,
96262,XKAF9X9,2,0,2,607.71,752.25,
96263,XKAF9X12,2,0,2,621.44,769.25,
96264,XKAF9X18,2,0,2,859.03,1063.35,
96265,XKAF9X24,0,0,0,933.19,1155.15,
96266,XKAF12X9,2,0,2,624.19,772.65,
96267,XKAF12X12,3,0,3,648.91,803.25,
96268,XKAF12X18,3,0,3,865.89,1071.85,
96269,XKAF12X24,2,0,2,1309.48,1620.95,
96270,XKASL9X9,2,0,2,810.27,1003.00,
96271,XKASL9X12,2,0,2,824.00,1020.00,
96272,XKASL9X18,2,0,2,1061.59,1314.10,
96273,XKASL9X24,2,0,2,1134.37,1404.20,
96274,XKASL12X9,2,0,2,826.75,1023.40,
96275,XKASL12X12,3,0,3,851.47,1054.00,
96276,XKASL12X18,3,0,3,1068.45,1322.60,
96277,XKASL12X24,2,0,2,1512.04,1871.70,
96278,XKASML9X9,2,0,2,817.13,1011.50,
96279,XKASML9X12,2,0,2,830.87,1028.50,
96280,XKASML9X18,0,0,0,1068.45,1322.60,
96281,XKASML9X24,2,0,2,1141.24,1412.70,
96282,XKASML12X9,2,0,2,833.61,1031.90,
96283,XKASML12X12,2,0,2,858.33,1062.50,
96284,XKASML12X18,2,0,2,1075.32,1331.10,
96285,XKASML12X24,2,0,2,1518.91,1880.20,
96286,XKASAL9X9,2,0,2,1387.07,1717.00,
96287,XKASAL9X12,2,0,2,1400.80,1734.00,
96288,XKASAL9X18,2,0,2,1638.39,2028.10,
96289,XKASAL9X24,2,0,2,1711.17,2118.20,
96290,XKASAL12X9,2,0,2,1403.55,1737.40,
96291,XKASAL12X12,3,0,3,1428.27,1768.00,
96292,XKASAL12X18,4,0,4,1645.25,2036.60,
96293,XKASAL12X24,2,0,2,2088.84,2585.70,
96294,XKAF9X9A,1,0,1,567.88,702.95,
96295,XKAF9X12A,1,0,1,591.23,731.85,
96296,XKAF9X18A,1,0,1,642.04,794.75,
96298,XKAF9X24A,2,0,2,692.85,857.65,
96299,XKAF12X9A,1,0,1,577.49,714.85,
96300,XKAF12X12A,1,0,1,599.47,742.05,
96301,XKAF12X18A,1,0,1,668.13,827.05,
96302,XKAF12X24A,0,0,0,728.56,901.85,
96304,XKASL9X9A,1,0,1,770.44,953.70,
96305,XKASL9X12A,1,0,1,793.79,982.60,
96306,XKASL9X18A,1,0,1,790.31,,
96307,XKASL9X24A,2,0,2,895.41,1108.40,
96308,XKASL12X9A,1,0,1,780.05,965.60,
96309,XKASL12X12A,1,0,1,802.03,992.80,
96310,XKASL12X18A,1,0,1,870.69,1077.80,
96311,XKASL12X24A,0,0,0,931.12,1152.60,
96316,225T-SS904,2,1,1,711.11,,
96318,M4016,0,0,0,10.67,,
96319,G18516,0,0,0,7.60,,
96321,G220200,0,0,0,7.12,,
96323,G220216,0,0,0,9.26,,
96324,G220316,14,5,9,10.29,,
96325,G220416,6,4,2,7.00,,
96326,1673-PW,0,0,0,117.14,,
96330,R70739,0,0,0,59.65,,
96331,XKASML9X9A,1,0,1,777.31,962.20,
96332,XKASML9X12A,1,0,1,800.65,991.10,
96333,XKASML9X18A,1,0,1,851.47,1054.00,
96334,XKASML9X24A,2,0,2,902.28,1116.90,
96335,XKASML12X9A,1,0,1,786.92,974.10,
96336,XKASML12X12A,1,0,1,808.89,1001.30,
96337,XKASML12X18A,1,0,1,877.56,1086.30,
96338,XKASML12X24A,0,0,0,937.99,1161.10,
96339,XKASAL9X9A,1,0,1,1347.24,1667.70,
96340,XKASAL9X12A,1,0,1,1370.59,1696.60,
96341,XKASAL9X18A,1,0,1,1421.40,1759.50,
96342,XKASAL9X24A,2,0,2,1472.21,1822.40,
96343,XKASAL12X9A,1,0,1,1356.85,1679.60,
96344,XKASAL12X12A,1,0,1,1378.83,1706.80,
96345,XKASAL12X18A,1,0,1,1447.49,1791.80,
96346,XKASAL12X24A,0,0,0,1507.92,1866.60,
96354,BK4514,0,0,0,121.33,140.95,
96357,200-012G2-H1C,0,0,0,599.57,,764.46
96358,200-012G2-H1C-B,0,0,0,599.57,,764.46
96359,200-014G2-H1C,0,0,0,599.57,,764.46
96360,200-014G2-H1C-B,0,0,0,599.57,,764.46
96366,RH5999-9002,6,6,0,18.91,,
96367,81545,1,0,1,6.17,,
96369,81546,2,0,2,7.95,,
96370,81547,2,0,2,11.47,,
96371,81549,2,0,2,5.00,,
96372,A80731,6,1,5,322.57,,
96373,010-C1243-00,0,0,0,112.49,,
96374,010-C1244-00,0,0,0,112.49,,
96375,010-C1245-00,0,0,0,112.49,,
96376,010-C1246-00,0,0,0,112.49,,
96377,010-C1247-00,0,0,0,112.49,,
96378,010-C1248-00,0,0,0,112.49,,
96379,010-C1249-00,0,0,0,112.49,,
96380,010-C1250-00,0,0,0,112.49,,
96381,010-C1251-00,0,0,0,112.49,,
96382,010-C1252-00,0,0,0,112.49,,
96383,010-C1253-00,0,0,0,112.49,,
96384,010-C1254-00,0,0,0,112.49,,
96385,010-C1255-00,0,0,0,112.49,,
96386,010-C1256-00,0,0,0,112.49,,
96387,010-C1258-00,0,0,0,112.49,,
96388,010-C1259-00,0,0,0,112.49,,
96389,010-C1260-00,0,0,0,112.49,,
96390,010-C1261-00,0,0,0,112.49,,
96391,010-C1262-00,0,0,0,112.49,,
96392,010-C1264-00,0,0,0,112.49,,
96393,010-C1266-00,0,0,0,112.49,,
96394,010-C1267-00,0,0,0,112.49,,
96395,010-C1268-00,0,0,0,112.49,,
96396,010-C1269-00,0,0,0,112.49,,
96401,MA5700-0-0-101,0,0,0,9.39,,14.99
96402,1664-PW,0,0,0,209.41,,
96403,1685-PW,0,0,0,204.86,,
96406,010-12953-03,0,0,0,31.99,,
96407,58541-1000,7,4,3,46.15,,
96408,68000604,3,1,2,91.78,,
96411,10205GA,12,0,12,5.50,,
96412,10000G,8,0,8,6.27,,
96413,15253A,16,7,9,4.78,,
96414,15252A,20,8,12,4.49,,
96415,27657,6,6,0,15.67,,
96416,10727A,46,12,34,6.53,,
96417,29502,13,9,4,14.60,,
96418,GC001,0,0,0,427.27,,
96420,FOURTECHBLK06,0,0,0,166.87,,
96421,FOURTECHBLK07,0,0,0,166.87,,
96422,FOURTECHBLK08,0,0,0,166.87,,
96423,FOURTECHBLK09,0,0,0,166.87,,
96432,FOURTECHBLK10,0,0,0,166.87,,
96436,FOURTECHBLK11,0,0,0,166.87,,
96438,FOURTECHBLK12,0,0,0,166.87,,
96439,FOURTECHBLK13,0,0,0,166.87,,
96440,FOURTECHBLK14,0,0,0,166.87,,
96441,2000037885,1,1,0,28.24,,
96442,FOURTECHBLK15,0,0,0,166.87,,
96443,FOURTECHBLK16,1,0,1,166.87,,
96444,FOURTECHBLK17,1,1,0,166.87,,
96445,FOURTECHBLK18,0,0,0,166.87,,
96446,FOURTECHBLK20,0,0,0,214.53,,
96449,WUL8BK-FT,79,79,0,0.53,,
96450,WUL10RD-FT,190,190,0,0.32,,
96451,WUL10BK-FT,240,240,0,0.32,,
96452,WUL8RD-FT,83,83,0,0.53,,
96474,SCC115085411,3,3,0,367.24,,453.05
96476,W12/2RYW-FT,250,250,0,0.51,,
96477,W16/2DC-FT,869,869,0,0.24,,
96478,1215-FT,72,72,0,0.48,,
96479,980577011,0,0,0,79.75,,
96482,HD800,2,0,2,32.91,,
96484,M90BX08,1,0,1,110.96,,
96485,M90BX09,1,0,1,110.96,,
96486,M90BX10,0,0,0,110.96,,
96487,M90BX11,1,0,1,110.96,,
96488,M90BX12,2,0,2,110.96,,
96489,M90BX13,1,0,1,110.96,,
96490,M90BX14,0,0,0,110.96,,
96491,M90BX15,2,0,2,110.96,,
96492,M90BX16,1,0,1,110.96,,
96493,M90BX17,2,0,2,110.96,,
96494,M90BX18,0,0,0,110.96,,
96495,UC128TS-1P,3,1,2,558.54,,
96496,UC95OBF-1,4,0,4,431.81,,
96503,CYR010120011R,4,2,2,39.96,,49.30
96504,ARG100301020R,11,4,7,93.01,,114.75
96506,1854080,0,0,0,377.20,,
96507,1854081,0,0,0,377.20,,
96508,1854082,0,0,0,377.20,,
96524,53242,6,3,3,273.29,,339.99
96525,53243,5,2,3,293.74,,369.99
96526,53244,9,3,6,313.51,,389.99
96527,53363,2,1,1,358.95,,449.99
96528,53364,9,2,7,385.72,,479.99
96529,53505,5,3,2,484.39,,599.99
96530,53600,6,3,3,33.99,,39.99
96532,30227CASE,49,0,49,20.99,,
96538,69600943,13,10,3,1163.43,,
96539,69600944,16,9,7,1163.43,,
96541,PMP242305130,21,13,8,970.11,,1196.80
96573,959037521,0,0,0,132.91,,
96588,PMP122305120,8,3,5,852.98,,1052.30
96589,PMP122305102,1,1,0,1031.43,,1272.45
96590,PMP242305100,16,5,11,852.98,,1052.30
96591,SHU065150050,15,10,5,95.08,,117.30
96592,SHU065210050,20,11,9,157.09,,193.80
96593,SHU065220050,4,2,2,239.08,,294.95
96594,69330,0,0,0,8.94,,
96595,69320,0,0,0,21.06,,
96596,69321,23,23,0,20.81,,
96598,69380,2,2,0,133.20,,
96599,69381,1,1,0,107.13,,
96611,PLABU171,2,2,0,66.81,,
96612,PLABU260,0,0,0,48.60,,
96613,PLABU270,0,0,0,60.74,,
96614,PLABP360,0,0,0,48.20,,
96616,PLABW570,1,1,0,30.93,,
96617,PLABS705,8,8,0,15.00,,
96618,PLASE301,6,6,0,22.50,,
96619,PLASE401,4,4,0,38.57,,
96620,PLASE602,5,0,5,21.21,,
96621,PLASE603,3,0,3,22.50,,
96622,PLASE701,1,1,0,32.14,,
96623,PLASE702,8,8,0,35.36,,
96628,FRBAP15,0,0,0,12.05,,
96632,FRBAP40,0,0,0,44.41,,
96636,131200-100-004-23,0,0,0,100.69,,
96638,135100-701-999-23,0,0,0,13.67,,
96639,123200-400-020-23,0,0,0,55.00,,
96640,123200-400-040-23,13,8,5,55.00,,
96641,123200-400-060-23,6,5,1,55.00,,
96642,123000-500-020-23,5,0,5,39.99,,
96643,123000-500-040-23,5,5,0,48.75,,
96644,123000-500-060-23,6,6,0,48.75,,
96645,123000-600-020-23,10,4,6,48.75,,
96646,123000-600-040-23,9,4,5,48.75,,
96647,123000-600-060-23,1,1,0,48.75,,
96648,132100-700-004-23,0,0,0,142.16,,
96652,2000010648,0,0,0,20.00,,
96653,2157601,0,0,0,33.44,,
96656,2155767,2,2,0,13.44,,
96657,2000038016,0,0,0,120.31,,
96659,PM411C-LWM,0,0,0,4291.19,,
96660,K00-00494-01,3,3,0,1.00,,
96666,600-GDL,0,0,0,238.86,,
96667,710309-1,1,1,0,1731.18,,2049.99
96669,601001-1,7,7,0,97.40,,149.99
96670,601002-1,20,20,0,97.40,,149.99
96671,601003-1,4,4,0,97.40,,149.99
96672,601019-1,2,2,0,97.40,,149.99
96673,601004-1,37,0,37,97.40,,149.99
96674,601005-1,18,16,2,97.40,,149.99
96675,601006-1,65,63,2,97.40,,149.99
96676,601007-1,44,44,0,97.40,,149.99
96677,601020-1,73,38,35,97.40,,149.99
96678,601021-1,6,6,0,97.40,,149.99
96679,601008-1,8,3,5,97.40,,149.99
96680,601009-1,18,11,7,97.40,,149.99
96681,601010-1,30,30,0,97.40,,149.99
96682,602001-1,6,5,1,129.87,,199.99
96683,602002-1,0,0,0,129.87,,199.99
96684,602003-1,21,21,0,129.87,,199.99
96685,602004-1,21,0,21,129.87,,199.99
96686,602005-1,73,0,73,129.87,,199.99
96687,602006-1,41,41,0,129.87,,199.99
96688,602007-1,20,20,0,129.87,,199.99
96689,602008-1,150,71,79,129.87,,199.99
96690,602009-1,14,2,12,129.87,,199.99
96691,602010-1,51,51,0,129.87,,199.99
96692,602020-1,176,118,58,162.34,,249.99
96693,602019-1,5,5,0,129.87,,199.99
96694,602021-1,9,9,0,129.87,,199.99
96695,1865115,46,14,32,36.32,,
96696,1865120,0,0,0,108.96,,
96701,B00086001,0,0,0,74.81,90.89,
96702,B00084701,2,0,2,134.99,215.99,
96703,B00084801,1,0,1,199.99,310.49,
96704,B00111301,1,0,1,89.99,117.89,
96705,2000035685,0,0,0,38.00,44.99,
96706,B00110901,4,2,2,72.99,96.29,
96707,B00109001,1,0,1,43.25,57.59,
96714,SCC125060221,7,3,4,336.23,,414.80
96715,BPC900110114,12,7,5,17.22,,21.25
96741,0528006CHR,12,0,12,70.95,,
96743,XRMAGST17ANC,3,3,0,19.39,,
96744,XRMAGST17HDBSRD,2,2,0,19.39,,
96745,XRMAGST17HDBTO,1,1,0,19.39,,
96746,XRMAGST17HDGH,1,1,0,19.39,,
96747,XRMAGST17HDHPU,2,2,0,19.39,,
96748,XRMAGST17HDRHU,3,3,0,19.39,,
96749,XRMAGST17HDSBM,2,2,0,19.39,,
96750,XRMAGST17HDSFU,0,0,0,19.39,,
96751,XRMAGST17HDWHU,2,2,0,19.39,,
96752,XRMAGST17MU,3,3,0,19.39,,
96753,XRMAGST17PHV,3,3,0,19.39,,
96754,XRMAGST17PLD,0,0,0,19.39,,
96755,XRMAGXP130AYU,2,2,0,15.88,,
96756,XRMAGXP130BSRD,0,0,0,15.88,,
96757,XRMAGXP130D,0,0,0,15.88,,
96758,XRMAGXP130FFU,1,1,0,15.88,,
96759,XRMAGXP130HWHU,0,0,0,15.88,,
96760,XRMAGXP130MU,3,3,0,15.88,,
96761,XRMAGXP170AYU,3,3,0,20.69,,
96762,XRMAGXP170BSRD,3,3,0,20.69,,
96763,XRMAGXP170D,0,0,0,20.69,,
96764,XRMAGXP170FFU,2,2,0,20.69,,
96765,XRMAGXP170HWHU,0,0,0,20.69,,
96766,XRMAGXP170MU,0,0,0,20.69,,
96767,DFG50,0,0,0,51.53,,
96768,MFG50,1,1,0,29.01,,
96769,RFFG6,0,0,0,8.83,,
96770,RFFG9,1,1,0,11.41,,
96771,RFFGSC,6,6,0,26.14,,
96772,RHCDS50,2,2,0,33.28,,
96773,RMSPP4,4,4,0,20.80,,
96774,RMSPP6,1,1,0,20.80,,
96775,RMSPP8,4,4,0,23.25,,
96776,SMTH3,6,6,0,19.20,,
96777,630-106G,0,0,0,17.81,,
96778,630-106L,0,0,0,17.81,,
96779,630-110G,2,2,0,17.81,,
96780,630-110L,3,3,0,17.81,,
96781,630-115G,3,3,0,17.81,,
96782,630-115L,1,1,0,17.81,,
96783,630-120G,1,1,0,17.81,,
96784,630-120L,2,2,0,17.81,,
96785,630-130G,1,1,0,17.81,,
96786,630-130L,0,0,0,17.81,,
96787,630-140G,2,2,0,17.81,,
96788,630-140L,0,0,0,17.81,,
96789,630-150G,3,3,0,18.50,,
96790,630-150L,0,0,0,21.38,,
96791,630-165G,0,0,0,21.38,,
96792,630-165L,0,0,0,21.38,,
96793,630-180G,0,0,0,23.41,,
96794,630-180L,0,0,0,23.41,,
96795,630-310G,1,1,0,58.50,,
96796,630-310L,1,1,0,67.77,,
96797,630-315G,2,2,0,60.50,,
96798,630-315L,2,2,0,60.50,,
96799,630-320G,0,0,0,67.77,,
96800,630-320L,2,2,0,58.50,,
96801,630-330G,1,1,0,67.77,,
96802,630-330L,3,3,0,67.77,,
96803,630-340G,2,2,0,67.77,,
96804,630-340L,3,3,0,67.77,,
96805,630-350G,0,0,0,81.90,,
96806,630-350L,1,1,0,72.34,,
96807,630-365G,0,0,0,81.90,,
96808,630-365L,0,0,0,81.90,,
96809,630-380G,0,0,0,85.48,,
96810,630-380L,2,2,0,74.00,,
96811,658-112MC,1,1,0,25.52,,
96812,658-118MC,3,3,0,25.52,,
96813,658-212MC,1,1,0,43.92,,
96814,658-218MC,8,8,0,43.92,,
96815,658-312MC,0,0,0,127.58,,
96816,658-318MC,1,1,0,127.58,,
96817,668-112MC,0,0,0,11.95,,
96818,668-115MC,0,0,0,11.95,,
96819,668-118MC,0,0,0,12.21,,
96820,668-127MC,0,0,0,13.48,,
96821,668-136MC,0,0,0,13.48,,
96822,668-212MC,1,1,0,23.91,,
96823,668-215MC,0,0,0,23.91,,
96824,668-218MC,0,0,0,24.42,,
96825,668-227MC,0,0,0,26.77,,
96826,668-236MC,2,2,0,26.77,,
96827,668-312MC,1,1,0,67.57,,
96828,668-315MC,2,2,0,67.57,,
96829,668-318MC,0,0,0,68.77,,
96830,668-327MC,3,3,0,76.16,,
96831,668-336MC,2,2,0,76.16,,
96832,660-240CC,2,2,0,44.04,,
96833,660-240G,2,2,0,44.04,,
96834,9618,0,0,0,79.56,,
96841,GS-390XL-180,2,2,0,3081.05,,3849.99
96850,ADA010100400,2,2,0,6.89,,8.50
96851,PSC123051095,1,0,1,301.09,,371.45
96852,PSC123053095,4,2,2,323.83,,399.50
96854,PSC125051095,2,1,1,383.77,,473.45
96855,PSC125053095,5,2,3,406.51,,501.50
96856,PSC241651095,4,1,3,301.09,,371.45
96857,PSC242551095,5,5,0,383.77,,473.45
96858,PSC242553095,6,4,2,406.51,,501.50
96859,"RC1212CAP12V   ",0,0,0,3415.50,4554.00,
96865,806-1212,2,1,1,514.03,,
96867,PIN242122500,6,3,3,270.78,,334.05
96868,DX900-ST-0,0,0,0,739.49,,
96871,048-055,0,0,0,2.02,,
96878,1071,0,0,0,116.25,159.99,
96879,1074,0,0,0,116.25,159.99,
96881,1076,0,0,0,116.25,159.99,
96882,1079,0,0,0,191.25,239.99,
96883,1080,0,0,0,191.25,239.99,
96884,1081,0,0,0,191.25,239.99,
96885,1082,0,0,0,191.25,239.99,
96886,1083,0,0,0,191.25,239.99,
96887,1068,0,0,0,166.25,219.99,
96889,1073,0,0,0,166.25,219.99,
96890,1077,0,0,0,166.25,219.99,
96892,1078,0,0,0,166.25,219.99,
96893,1084,0,0,0,166.25,219.99,
96894,1085,0,0,0,166.25,219.99,
96908,GP1500-51,0,0,0,276.35,,
96909,GP1040-54,0,0,0,334.53,,
96910,SCM-ZC-REMOTE,2,1,1,124.00,,177.00
96911,SCM-SCNET-Y,0,0,0,23.95,,29.95
96912,SCM-SCNET-04,0,0,0,23.95,,29.95
96913,S-1805,0,0,0,10.00,,
96916,S-1802BC,2,2,0,65.34,,
96917,S-1802C,0,0,0,52.20,,
96918,5624-6,0,0,0,27.10,,
96919,96635,2,2,0,6.73,9.01,
96920,96637,0,0,0,21.09,28.24,
96921,96631,0,0,0,10.87,12.84,
96922,96636,0,0,0,13.25,15.66,
96923,SEC-1223,0,0,0,114.77,165.70,
96925,M6001,4,3,1,189.99,,
96926,M6002,4,2,2,169.99,,
96927,M3100,0,0,0,27.00,,
96931,252233,4,4,0,1.20,,
96933,242233,7,6,1,14.94,,
96934,244233,5,3,2,49.99,,
96935,252237,0,0,0,3.99,,
96936,252247,0,0,0,3.05,,
96937,242247,0,0,0,8.35,,
96938,252253,1,1,0,2.41,,
96939,242253,0,0,0,22.23,,
96945,2815,5,3,2,122.07,,
96950,BMS300200200,2,2,0,126.78,,156.40
96951,BPP900450120,15,8,7,176.38,,217.60
96952,010-12390-42,0,0,0,22.49,,
96960,50880-1100,0,0,0,227.96,,
96961,31705-0094,2,1,1,198.83,,
96962,242267,10,5,5,17.07,,
96963,252274,0,0,0,3.20,,
96964,242274,0,0,0,31.47,,
96965,244275,0,0,0,100.36,,
96966,242277,0,0,0,18.33,,
96967,252284,0,0,0,3.67,,
96968,242284,2,2,0,36.34,,
96969,242287,2,2,0,19.26,,
96970,252294,0,0,0,4.38,,
96971,242717,0,0,0,20.76,,
96972,244725,0,0,0,219.40,,
96973,244726,0,0,0,219.44,,
96974,R70690,0,0,0,55.39,,
96976,249101,3,0,3,3.60,,
96977,249102,0,0,0,2.53,,
96978,220012,0,0,0,11.58,,
96979,309303,0,0,0,4.10,,
96980,309325,2,1,1,26.47,,
96982,321303,0,0,0,3.90,,
96983,321325,0,0,0,20.57,,
96984,321403,0,0,0,3.90,,
96985,321425,0,0,0,20.57,,
96986,321503,0,0,0,3.90,,
96987,321525,0,0,0,20.57,,
96988,321603,0,0,0,3.90,,
96989,321625,0,0,0,20.57,,
96990,321703,0,0,0,3.90,,
96991,321725,0,0,0,20.57,,
96993,318803,0,0,0,3.36,,
96994,318903,0,0,0,3.36,,
96995,318825,0,0,0,17.74,,
96996,318925,0,0,0,17.74,,
96997,319803,0,0,0,3.36,,
96998,319903,0,0,0,3.36,,
96999,319825,0,0,0,18.72,,
97000,319925,0,0,0,18.72,,
97003,22287,0,0,0,11.71,,
97004,22260,0,0,0,6.64,,
97005,22309,1,0,1,5.49,,
97022,000-191-487-10,0,0,0,59.09,,
97024,GNT-1.0-30-INS-ID,11,1,10,1199.99,,
97025,GNT-1.0-80-INS-IDP,3,2,1,1359.99,,
97027,A-0-WHITE,9,0,9,21.99,,
97028,GNT-1.0-ELITE-30-IDP,2,2,0,1839.99,,
97029,GNT-1.0-ELITE-80-IDP,2,1,1,1999.99,,
97030,GP-MSWR,0,0,0,258.99,,
97031,GP-SD,3,1,2,189.99,,
97032,50124,0,0,0,33.20,,
97033,50136,0,0,0,14.37,,
97034,GMM-IP67-TEMPSENSOR,2,1,1,379.99,,
97035,GMM-IP67-HWS,1,0,1,377.99,,
97036,GA-STROBE-WHITE,3,2,1,265.99,,
97037,GMM-IP67-PULL-25,2,1,1,359.99,,
97038,GMM-IP67-POWEROUT,1,1,0,447.99,,
97039,GMM-IP67-IBS2-SIRENOUT,2,1,1,846.99,,
97040,GAP-TSK5-BLACK,2,1,1,349.99,,
97041,GP-KF25,4,2,2,129.99,,
97043,GA-MINI-SIREN,2,2,0,90.99,,
97044,GWHD-XVR-4G,1,0,1,2899.99,,
97045,GWHD-XVR,0,0,0,1749.99,,
97046,G4G-LTE-WIFI-OCTO-DEUCE,2,1,1,849.99,,
97047,GOST-MINI-BALL-1080P-W,8,2,6,444.49,,
97066,WSO200-01,6,5,1,476.00,,
97083,SCM-DLX-CC-CHR-WH,4,2,2,83.26,,116.00
97088,401-017,0,0,0,51.24,,65.33
97089,401-017-B,0,0,0,51.24,,65.33
97092,PMP122200102,30,5,25,737.92,,910.35
97093,G180124,0,0,0,9.79,,
97094,G180124CASE,0,0,0,39.14,,
97095,KG-1BK-PR,8,4,4,37.33,47.60,
97096,KG-4BK-PR,1,0,1,122.00,155.55,
97097,E6-71-408S-85,0,0,0,46.15,,
97098,E6-71-430S-85,0,0,0,48.58,,
97106,F38-9960,2,0,2,122.17,,
97109,V21-9906WHC60D-1,4,2,2,251.81,,
97110,V21-9906BKA60D-1,1,0,1,253.86,,
97111,V21-9959WHC60D-1,5,2,3,168.47,,
97112,S11-4511P6-1,6,4,2,49.91,,
97113,F16-0200-1,2,2,0,94.85,,
97114,M20-2411,3,1,2,496.74,,
97116,M20-3611,3,2,1,552.33,,
97117,M20-1013E,3,1,2,568.24,,
97118,M20-2413E,4,2,2,729.99,,
97119,M20-3613E,1,0,1,1009.92,,
97121,HTINT60TM,0,0,0,236.25,,
97133,PU105111-04R,6,1,5,191.64,,
97134,PU1051B1-04R,9,3,6,179.95,,
97135,1731321FGK-R,7,5,2,107.26,,
97136,1731521FGK-R,9,5,4,115.06,,
97162,46731,0,0,0,623.44,949.99,
97163,202513,0,0,0,155.46,236.89,
97164,130313,2,0,2,743.53,1132.99,
97165,212113,1,0,1,175.74,267.79,
97166,132313,0,0,0,878.71,1338.99,
97167,910313,0,0,0,223.05,339.89,
97168,931314,1,1,0,675.94,1029.99,
97169,150313,1,1,0,1057.99,1853.99,
97171,544713,0,0,0,377.34,574.99,
97173,230603,3,1,2,526.64,802.49,
97174,110313,2,0,2,297.41,453.19,
97175,CANNS500,0,0,0,549.56,,
97176,60000189SPA,0,0,0,346.39,,
97178,SW31315DG,0,0,0,48.31,,
97180,30470-A,2,0,2,170.48,,
97181,30433,1,1,0,160.65,,
97182,30460,0,0,0,184.68,,
97183,70200,0,0,0,142.33,,
97184,30457,3,1,2,164.99,,
97185,30456,0,0,0,171.55,,
97186,30459,0,0,0,208.12,,
97187,70125,1,1,0,133.37,,
97188,70201,0,0,0,146.87,,
97189,70216,1,0,1,114.99,,
97190,30462,2,1,1,159.99,,
97191,5372,0,0,0,119.95,,
97192,5393,1,0,1,134.88,,
97193,5380,0,0,0,151.33,,
97194,5375,1,0,1,134.99,,
97195,5387,0,0,0,156.60,,
97196,5392,1,0,1,132.99,,
97197,5363,0,0,0,107.21,,
97198,5360,0,0,0,175.51,,
97199,5370,0,0,0,144.36,,
97200,5373,0,0,0,135.77,,
97201,20815,3,3,0,157.99,,
97202,60050,1,1,0,165.47,,
97203,60125,0,0,0,187.68,,
97204,20102,3,1,2,117.99,,
97205,60073,2,1,1,154.99,,
97206,20800,1,1,0,139.99,,
97207,20850,1,1,0,249.99,,
97208,60075,0,0,0,180.16,,
97209,60055,2,1,1,139.99,,
97210,20860,2,2,0,266.41,,
97211,6240,2,0,2,223.12,,
97212,6258,1,0,1,348.00,,
97213,6250,0,0,0,198.89,,
97214,6241,1,1,0,124.99,,
97215,6263,0,0,0,335.41,,
97216,6276,0,0,0,294.89,,
97217,6260,2,2,0,195.72,,
97218,6238,1,0,1,124.99,,
97219,SW058,0,0,0,16.80,,
97220,SW058HD,0,0,0,19.05,,
97221,SW109,1,0,1,19.99,,
97222,SW622,2,0,2,21.99,,
97223,SW054,5,3,2,13.99,,
97224,SW097,0,0,0,27.01,,
97225,MBK450,3,1,2,12.99,,
97226,M525,0,0,0,29.67,,
97227,BK900,1,0,1,12.99,,
97228,M532,0,0,0,35.87,,
97229,R473,0,0,0,13.72,,
97230,R151,5,4,1,7.99,,
97231,R767,0,0,0,98.99,,
97232,MV3555-268-0-216,8,5,3,43.75,,69.99
97243,84-78,2,0,2,50.01,,
97244,1710WB-13WB-KIT,0,0,0,544.29,,
97246,V-420,0,0,0,30.00,,
97247,V-420L,0,0,0,37.00,,
97248,V-200L,0,0,0,82.00,,
97249,V-220L,0,0,0,109.69,,
97250,V-100,5,5,0,33.75,,
97253,0946DP1STS,1,1,0,47.96,,
97254,404605-3,0,0,0,135.85,,
97255,ORI482441110,7,5,2,163.29,,201.45
97256,A10-366-CB-2-IN,2,2,0,189.47,,369.99
97257,A10-366-MR-2-IN,8,2,6,240.00,,369.99
97258,A10-366-JB-2-IN,9,9,0,240.00,,369.99
97262,E6TH009CD,0,0,0,1811.76,,
97263,E6TH009BW,1,0,1,1734.12,,
97264,D3009B,4,0,4,224.75,,
97265,D3009BI,4,0,4,224.75,,
97266,D3009W,4,0,4,224.75,,
97267,D3009WI,4,0,4,224.75,,
97268,MR1308UABK,13,4,9,48.33,,
97292,001-629-020-00,0,0,0,340.91,,
97298,RF45711,0,0,0,69.44,106.25,
97299,RF45711HL,0,0,0,119.44,182.75,
97300,RF45711N,0,0,0,58.84,90.02,
97301,RF46000,0,0,0,58.33,89.25,
97302,RF46330,0,0,0,194.44,297.50,
97303,RF46530,2,0,2,343.89,526.15,
97304,RF48000,0,0,0,13.06,,
97305,RF48000HL,0,0,0,82.78,126.65,
97306,RF48100,0,0,0,23.33,35.70,
97307,RF48109,0,0,0,20.84,31.88,
97308,RF48109HL,0,0,0,104.06,159.21,
97309,RF48120,0,0,0,85.56,130.90,
97310,RF48140,1,0,1,30.00,45.90,
97311,RF48151,0,0,0,34.44,52.70,
97312,RF48200,0,0,0,53.33,81.60,
97313,RF48209,0,0,0,40.62,62.14,
97314,RF48210,1,0,1,58.89,90.10,
97315,RF48300,0,0,0,79.67,121.89,
97316,RF48310,0,0,0,85.00,130.05,
97317,RF48330,0,0,0,138.89,212.50,
97318,RF48400,1,0,1,107.00,163.71,
97319,RF48410,0,0,0,112.33,171.87,
97320,RF48500,0,0,0,121.89,186.49,
97321,RF48510,0,0,0,127.22,194.65,
97322,010-12547-03,14,0,14,22.49,,
97324,"P-10 MASTER",4,2,2,103.33,,
97360,101753,7,4,3,94.49,,
97361,101754,6,3,3,94.49,,
97362,101755,6,3,3,94.49,,
97363,101756,5,5,0,94.49,,
97364,101758,0,0,0,94.49,,
97365,101763,6,6,0,94.49,,
97367,JP-704B,0,0,0,165.80,,
97374,6353L,3,0,3,31.71,,
97400,02994,3,0,3,35.85,56.44,
97427,MJSLT190U,5,5,0,340.06,,
97428,MJSLT220U,5,3,2,382.67,,
97429,APM-48,0,0,0,108.84,134.00,
97431,7090,3,1,2,102.27,126.00,
97434,7094,1,0,1,148.01,182.00,
97436,7095,3,0,3,185.01,227.00,
97441,60-100-DV,1,0,1,561.78,688.00,
97444,60-100-J10,2,0,2,561.78,688.00,
97446,60-100-K6,2,0,2,561.78,688.00,
97447,60-120-DV,1,0,1,625.99,766.00,
97451,604-120-DV,2,0,2,625.99,766.00,
97453,604-120-K6,0,0,0,625.99,766.00,
97455,604-150-K6,2,0,2,738.35,904.00,
97456,60-YP-MC-100-DV,2,0,2,755.69,925.00,
97457,60-YP-MC-100-K6,2,0,2,755.69,925.00,
97458,621-100-DV,2,0,2,561.78,688.00,
97459,621-100-J10,2,0,2,561.78,688.00,
97460,621-100-K6,1,0,1,561.78,688.00,
97461,621-120-J10,2,0,2,625.99,766.00,
97462,60-YP-MC-120-DV,1,0,1,819.08,1003.00,
97463,621-VUP-MC-100-DV,0,0,0,755.69,925.00,
97464,621-VUP-MC-100-J10,2,0,2,755.69,925.00,
97465,621-VUP-MC-100-K6,2,0,2,755.69,925.00,
97467,01-66-036,2,1,1,32.85,,
97468,7060-24,0,0,0,148.01,182.00,
97470,70-AT-200,1,0,1,164.78,202.00,
97471,94LY-12-210-IG,0,0,0,1131.62,1385.00,
97472,9504-12-210-IG,2,0,2,1059.39,1297.00,
97473,SG2-0405,2,0,2,34.09,38.99,
97474,XT-CR-170-J10,1,0,1,803.57,984.00,
97475,XT-CR-170-J10-KIT,2,0,2,997.10,1220.00,
97476,XT-CR-170-K6,3,1,2,803.57,984.00,
97477,XT-CR-170-K6-KIT,2,0,2,997.10,1220.00,
97478,XT-CR-250-K6,2,0,2,986.21,1207.00,
97479,XT-CR-250-K6-KIT,2,0,2,1179.78,1444.00,
97480,XT-DF-250-DV,2,0,2,986.21,1207.00,
97481,XT-DF-250-DV-KIT,2,0,2,1179.78,1444.00,
97482,XT-DF-250-J10,2,0,2,986.21,1207.00,
97483,XT-DF-250-J10-KIT,2,0,2,1179.78,1444.00,
97484,XT-DF-250-K6,2,0,2,986.21,1207.00,
97485,XT-DF4-170-K6,1,0,1,803.57,984.00,
97486,XT-DF4-170-K6-KIT,2,0,2,997.10,1220.00,
97488,SBR-45LI,36,17,19,52.50,,
97533,MJBKT100,2,0,2,29.78,,
97534,MJUFOXL,0,0,0,213.02,,
97535,2000033704,5,5,0,19.38,,
97539,ZDIGPLINK2,2,1,1,224.96,,
97542,T10-504B,0,0,0,90.00,,
97543,T10-527,0,0,0,70.31,,
97545,81-47248-01,0,0,0,157.33,,
97554,B00109901,14,8,6,54.16,65.69,
97556,B285HW,0,0,0,1244.44,,
97557,B117-DT-9N,0,0,0,240.29,,
97564,5101-BLK,15,4,11,65.79,,
97565,5104-BLK,14,4,10,54.81,,
97566,5912-DS-VHF,0,0,0,70.58,,
97567,5912-DS-VHF-W,0,0,0,70.58,,
97568,QC-8-T,15,8,7,76.67,,
97569,QC-4-T,8,0,8,68.57,,
97572,40020256,0,0,0,950.94,,
97573,6187,8,5,3,70.58,,
97580,1089,0,0,0,191.25,239.99,
97581,1087,0,0,0,191.25,239.99,
97582,1086,0,0,0,191.25,239.99,
97584,GS-390BHC,0,0,0,2747.74,,
97585,GS-950BHC,0,0,0,1201.58,,
97587,1721321-R,18,10,8,73.14,,
97588,7141321FGK-R,5,3,2,152.48,,
97589,7401321FGK-R,4,4,0,401.62,,
97590,PU026104-R,9,5,4,97.71,,
97591,PU063104-01R,2,2,0,63.19,,
97592,PU021104-R,6,2,4,86.78,,
97593,PU033104-12,0,0,0,98.95,,
97594,PU043144-12,0,0,0,114.70,,
97595,PU085241,6,3,3,369.42,,
97596,PU081B11,12,6,6,431.79,,
97597,PU301404-44,10,4,6,144.77,,
97598,PU501404,0,0,0,103.94,,
97599,150200-200-080-23,0,0,0,51.49,,
97600,1444DP2ALU,0,0,0,53.48,,
97601,1444DP3ALU,2,0,2,54.71,,
97602,1444DP4ALU,4,1,3,58.19,,
97603,1444DP5ALU,0,0,0,64.37,,
97607,CB131MA600,0,0,0,527.61,,
97608,CB131H600,0,0,0,442.83,,
97609,CB131M1KW,0,0,0,762.39,,
97610,CB131H1KW,0,0,0,645.00,,
97623,ASS030550120,5,2,3,12.40,,15.30
97624,ASS030550220,8,4,4,12.40,,15.30
97628,01206,0,0,0,49.57,78.03,
97629,01207,0,0,0,101.20,159.29,
97630,01215,0,0,0,35.69,56.19,
97631,01225,0,0,0,37.53,59.08,
97632,7700D,2,0,2,334.21,,
97633,01247,0,0,0,137.05,215.73,
97634,01248,0,0,0,229.56,361.34,
97635,01263,0,0,0,21.12,33.24,
97636,01264,0,0,0,32.95,51.85,
97637,01265,0,0,0,52.39,82.45,
97638,01303,0,0,0,17.99,28.31,
97639,01304,0,0,0,25.00,39.36,
97640,01305,0,0,0,40.56,63.84,
97641,01306,0,0,0,67.23,105.83,
97642,01343,0,0,0,20.52,32.30,
97643,01344,0,0,0,29.16,45.90,
97645,01345,0,0,0,44.39,69.87,
97646,01346,0,0,0,71.23,112.12,
97647,N20804W,10,4,6,142.80,,
97648,01394,0,0,0,54.16,85.26,
97649,01395,0,0,0,83.37,131.24,
97650,N20020,14,7,7,87.47,,
97651,02317,2,0,2,51.36,80.84,
97652,02329,0,0,0,143.21,,
97653,02374,0,0,0,71.55,112.63,
97654,02376,0,0,0,89.43,140.76,
97655,02382,0,0,0,60.91,95.88,
97656,02478,0,0,0,133.87,210.72,
97657,02495,0,0,0,71.55,112.63,
97658,02674,0,0,0,86.35,135.92,
97659,02675,0,0,0,107.03,168.47,
97660,02676,0,0,0,138.03,217.26,
97661,02677,0,0,0,214.05,336.94,
97662,02678,2,0,2,358.88,564.91,
97663,02773,0,0,0,76.03,119.68,
97664,02774,0,0,0,93.25,146.80,
97665,02775,0,0,0,113.95,179.35,
97666,02777,0,0,0,227.83,358.62,
97667,02778,0,0,0,379.68,597.64,
97668,06332,0,0,0,14.20,22.36,
97669,06333,0,0,0,14.20,22.36,
97670,06334,0,0,0,14.20,22.36,
97671,WS-200WX,0,0,0,1337.82,,
97672,06342,0,0,0,21.55,33.92,
97673,06344,0,0,0,21.55,33.92,
97674,06345,0,0,0,21.55,33.92,
97675,06352,0,0,0,32.56,51.26,
97676,06355,0,0,0,32.56,51.26,
97677,06356,0,0,0,32.56,51.26,
97678,06363,0,0,0,50.44,79.39,
97679,06366,0,0,0,50.44,79.39,
97680,06367,0,0,0,50.44,79.39,
97681,06368,0,0,0,50.44,79.39,
97682,06495,0,0,0,41.04,64.60,
97683,06497,0,0,0,62.05,97.67,
97684,06511,0,0,0,9.07,,
97685,06512,0,0,0,9.99,,
97686,06513,0,0,0,10.91,,
97687,06514,0,0,0,17.17,,
97688,06515,0,0,0,26.47,,
97689,06516,0,0,0,55.40,,
97690,06523,0,0,0,14.04,,
97691,06524,0,0,0,20.41,,
97693,06525,0,0,0,32.45,,
97694,06526,0,0,0,63.01,,
97695,06564,0,0,0,80.79,127.16,
97696,06565,0,0,0,102.87,161.93,
97697,06566,0,0,0,154.23,242.76,
97698,09201,0,0,0,5.95,9.35,
97699,09202,0,0,0,6.75,10.63,
97700,09203,0,0,0,8.53,13.43,
97701,09204,6,0,6,13.07,20.57,
97702,09205,1,0,1,23.92,37.66,
97703,09211,0,0,0,8.21,12.92,
97704,09212,0,0,0,8.53,13.43,
97705,09222,0,0,0,12.59,19.81,
97706,11207,0,0,0,170.75,268.77,
97707,11208,0,0,0,196.45,309.23,
97708,11209,0,0,0,324.49,510.77,
97709,11215,0,0,0,81.27,127.93,
97710,11240,0,0,0,204.93,322.58,
97711,11244,0,0,0,51.36,80.84,
97712,11245,1,0,1,68.47,107.78,
97713,11246,0,0,0,110.97,174.68,
97714,11247,1,0,1,231.33,364.14,
97715,11248,0,0,0,384.16,604.69,
97716,11249,0,0,0,554.75,873.21,
97717,21104,0,0,0,53.84,,
97718,21105,0,0,0,67.28,,
97719,21106,0,0,0,107.68,,
97720,21223,5,0,5,23.55,,
97721,21224,1,0,1,30.29,,
97723,21225,0,0,0,36.99,,
97725,29944,0,0,0,60.05,,
97728,29955,0,0,0,64.37,,
97730,29966,0,0,0,88.29,,
97731,65321,0,0,0,13.45,,
97732,65331,0,0,0,15.44,,
97733,65341,0,0,0,21.60,,
97734,65351,0,0,0,35.80,,
97735,65361,0,0,0,62.69,,
97736,65441,0,0,0,24.36,,
97737,65451,0,0,0,44.83,,
97738,65461,0,0,0,71.55,,
97739,91432,0,0,0,31.00,,
97740,91433,0,0,0,39.37,,
97741,91434,0,0,0,64.15,,
97742,SP300,0,0,0,249.05,,
97743,SP400,0,0,0,316.39,,
97744,SP992,0,0,0,179.44,,
97746,DS-HD10-BLK,2,2,0,25.29,,
97747,DS-MULTI-P-BLK,10,0,10,25.85,,
97749,SC-CW-11F,13,13,0,79.88,,
97750,SC-USB-03,24,16,8,34.85,,
97752,AV-5001-HV-2XL/3XL,3,3,0,61.88,,
97761,V46B,0,0,0,230.36,,
97762,V46,1,0,1,137.32,,
97763,1503,5,1,4,34.89,,
97764,1503B,7,0,7,34.89,,
97766,"V46 KIT",1,0,1,172.22,,
97767,"V46B KIT",0,0,0,265.14,,
97770,ASS030530218,15,11,4,11.02,,13.60
97771,ASS030530230,16,10,6,12.40,,15.30
97772,ASS030066003,21,10,11,6.20,,7.65
97783,SBV-4000-P,0,0,0,2831.67,,
97791,27647-902,13,0,13,65.39,114.99,
97792,27627-902,9,0,9,61.57,114.99,
97796,27626-902,20,0,20,65.39,114.99,
97797,27620-902,15,0,15,61.57,114.99,
97798,27740-902,7,0,7,88.25,164.99,
97799,FSDP31012008B00,0,0,0,1618.99,,
97800,27760-903,22,1,21,115.53,214.99,
97801,27648-903,17,6,11,110.43,199.99,
97802,27646-903,38,6,32,97.97,174.99,
97803,27640-903,5,1,4,92.80,174.99,
97804,0320,2,0,2,18.41,,
97805,0452,9,9,0,32.30,,
97807,010-12922-00,0,0,0,43.83,,
97810,V351HPU1D,0,0,0,267.33,,
97812,APPT6-MR/DP,0,0,0,24.53,,
97815,01112-1,0,0,0,11.03,,
97816,01112-1AL,0,0,0,12.20,,
97817,01143,0,0,0,11.23,,
97818,01145,0,0,0,12.48,,
97819,01051,0,0,0,5.17,,
97820,TEC-DIVERSD,0,0,0,82.74,,
97821,00734-1,0,0,0,25.26,,
97822,BGW-40,1,1,0,73.07,105.40,
97823,BGW-60,0,0,0,97.50,140.70,
97824,FMB323,11,4,7,9.38,,
97828,845,48,14,34,13.00,,
97829,476S-9OZ,22,0,22,13.80,,
97830,476S-18OZ,42,28,14,21.86,,
97831,915,31,5,26,25.31,,
97833,850-16OZ,111,27,84,9.29,,
97834,850-64OZ,13,8,5,32.60,,
97835,631,51,21,30,13.34,,
97836,520-16OZ,0,0,0,6.49,,
97837,520-64OZ,20,11,9,17.66,,
97838,415,23,9,14,6.94,,
97842,390,71,24,47,9.06,,
97845,855,28,28,0,10.89,,
97846,325,15,3,12,12.06,,
97847,870-16OZ,40,21,19,13.97,,
97848,870-64OZ,7,0,7,41.71,,
97849,885,6,0,6,14.40,,
97850,920-16OZ,99,47,52,6.94,,
97851,920-64OZ,0,0,0,24.20,,
97852,925,88,33,55,13.00,,
97855,001-608-450-00,0,0,0,80.91,,
97857,13-01-001,2,1,1,94.25,,
97858,13-01-002,0,0,0,94.25,,
97859,13-01-003,0,0,0,157.98,,
97860,13-01-004,0,0,0,157.98,,
97861,13-01-005,0,0,0,63.20,,
97862,13-01-006,0,0,0,63.20,,
97863,GP1170-07,0,0,0,385.44,,
97868,P-2BS-24-R,1,1,0,412.50,,
97869,CA-0182,0,0,0,23.56,,
97870,CA-0185,0,0,0,156.48,,
97871,CA-0184,0,0,0,104.32,,
97872,02981028-BP,7,2,5,8.91,,
97873,04980903-BP,0,0,0,5.24,,
97874,04981038-BP,0,0,0,6.80,,
97875,880021-BP,7,2,5,14.12,,
97876,880022-BP,6,2,4,17.10,,
97877,880023-BP,9,5,4,23.01,,
97878,880024-BP,8,3,5,14.12,,
97879,880025-BP,6,3,3,16.85,,
97880,880026-BP,5,1,4,22.73,,
97881,880027-BP,10,6,4,32.73,,
97882,880028-BP,6,1,5,48.43,,
97885,MMC-11R-LDB,0,0,0,95.00,,
97886,SBR-45LIIS,15,8,7,84.00,,
97887,PC170,1,0,1,143.00,,
97888,PC210,3,0,3,80.07,,
97889,PC3410,0,0,0,40.86,,
97890,PC3435,3,0,3,28.61,,
97891,PC3440,3,0,3,28.61,,
97892,PC3450,2,0,2,44.93,,
97893,PC3460,4,0,4,49.04,,
97894,PC3470,6,2,4,57.21,,
97895,PC3660,6,0,6,24.50,,
97896,PC3661,2,0,2,28.61,,
97897,PC3751,2,0,2,40.86,,
97898,PC866,2,0,2,40.86,,
97899,PC891,2,0,2,28.61,,
97900,PC892,2,0,2,28.61,,
97901,PC190,2,0,2,200.21,,
97902,PC3400,0,0,0,53.11,,
97903,PC3405,1,0,1,57.21,,
97904,PC3490,2,0,2,65.36,,
97905,PC3500,2,0,2,57.21,,
97906,PC3505,3,0,3,65.36,,
97907,PC3510,0,0,0,69.47,,
97908,PC3515,0,0,0,73.54,,
97909,PC3580,1,0,1,49.04,,
97910,PC3585,1,0,1,57.21,,
97911,PC550,2,0,2,44.93,,
97912,PC555,2,0,2,53.11,,
97913,PC560,2,0,2,65.36,,
97914,PC600,4,0,4,65.36,,
97915,PC867,2,0,2,53.11,,
97916,PC980,9,0,9,12.26,,
97932,1260/7PK,2,2,0,10.26,,
97933,1217-FT,923,923,0,0.37,,
97939,1742-MW,0,0,0,237.68,,
97942,PMP122305122,1,1,0,906.72,,1118.60
97943,PMP482305102,4,2,2,1032.81,,1274.15
97944,106940,0,0,0,79.82,,
97963,2021014014,1,0,1,205.79,,
97964,2021014013,1,0,1,205.79,,
97965,2021014015,0,0,0,197.87,,
97966,2021014016,0,0,0,197.87,,
97967,2021014019,0,0,0,197.87,,
97968,2021014017,0,0,0,197.87,,
97969,2021014018,3,0,3,205.79,,
97970,941600090,0,0,0,1479.19,,1719.99
97971,941700180,0,0,0,1848.99,,2149.99
97972,41560,173,87,86,10.01,,
97975,08-824P-2,1,0,1,20.88,,
97984,P55750-S,3,2,1,461.20,527.00,
97992,P77712-S,4,3,1,456.10,596.00,
97999,P92001,2,0,2,391.60,450.00,
98002,2000026606,27,27,0,4.68,,
98005,TFR-230-2K,0,0,0,182.66,,
98011,58020-3012,0,0,0,784.80,,
98012,58060-3012,0,0,0,768.67,,
98013,58060-3024,0,0,0,768.67,,
98014,58080-3012,0,0,0,830.11,,
98015,58080-3024,0,0,0,830.11,,
98016,58220-3012,0,0,0,784.80,,
98017,58220-3024,0,0,0,784.80,,
98018,58260-3012,0,0,0,768.67,,
98019,58260-3024,0,0,0,768.67,,
98020,58280-3012,0,0,0,830.11,,
98021,58280-3024,0,0,0,830.11,,
98025,10-24967-02,2,0,2,200.00,,
98026,10-35038-9,0,0,0,197.50,,
98027,35760-0094,3,1,2,237.73,,
98028,10-13599-02,0,0,0,387.50,,
98029,10-24398-01,0,0,0,442.50,,
98030,10-24140-5,0,0,0,365.00,,
98040,60CCM-D5OS,4,2,2,1477.00,1793.50,
98041,SCM-PD4CH,1,1,0,175.00,,249.00
98042,SCM-PWR6,4,2,2,273.99,,389.00
98043,SC3-BW-ALSM,0,0,0,173.99,,249.00
98044,BP150G15,0,0,0,154.20,193.00,
98047,FP5X,4,2,2,83.59,,
98049,SPD-15-W,0,0,0,492.19,,
98050,ACC-FF-1840,0,0,0,32.24,,
98058,WR16/4-100,3,1,2,86.00,,
98059,2000032712,0,0,0,19.71,,
98060,66031-3,7,2,5,21.73,,
98061,66032-3,10,0,10,25.21,,
98063,010-13115-02,3,1,2,18.74,,
98064,010-13116-02,0,0,0,14.99,,
98065,010-13115-10,0,0,0,93.74,,
98066,010-13116-03,0,0,0,14.99,,
98067,010-13115-11,0,0,0,93.74,,
98068,010-13116-04,0,0,0,14.99,,
98069,010-13115-12,2,2,0,93.74,,
98070,42038P,2,2,0,68.25,,
98072,4113,4,4,0,6.06,,
98073,4770-4,2,1,1,102.08,,
98074,5606-7,7,7,0,21.58,,
98075,5608-7,5,3,2,34.32,,
98076,5609-7,4,2,2,29.99,,
98077,5612-7,10,6,4,44.90,,
98078,5613-7,5,3,2,41.96,,
98082,66540-3,0,0,0,15.21,,
98083,66541-3,5,5,0,17.80,,
98084,66542-3,0,0,0,20.86,,
98085,66543-3,0,0,0,24.58,,
98086,66544-3,0,0,0,32.24,,
98087,66545-3,6,3,3,36.77,,
98088,66546-3,5,3,2,17.38,,
98089,66547-3,0,0,0,18.46,,
98090,66548-3,7,6,1,20.74,,
98091,66549-3,1,1,0,24.50,,
98092,66550-3,0,0,0,31.60,,
98093,66551-3,5,3,2,35.69,,
98094,66553-3,17,8,9,59.62,,
98095,150600-200-020-23,0,0,0,39.33,,
98096,150600-200-030-23,0,0,0,39.33,,
98097,150600-200-040-23,0,0,0,39.33,,
98098,150600-200-050-23,0,0,0,39.33,,
98099,3872-3,0,0,0,3.94,,
98100,150600-200-060-23,0,0,0,39.33,,
98101,3873-3,0,0,0,3.70,,
98102,150600-200-070-23,0,0,0,39.33,,
98103,3874-3,4,4,0,6.04,,
98104,150200-200-030-23,0,0,0,51.49,,
98105,3878-3,2,2,0,9.32,,
98106,150200-200-050-23,0,0,0,51.49,,
98107,3877-3,3,3,0,6.14,,
98108,150200-200-110-23,0,0,0,51.49,,
98109,3879-3,4,0,4,9.76,,
98110,3886-3,0,0,0,10.62,,
98111,17211-3,0,0,0,4.57,,
98112,9842-3,9,5,4,9.99,,
98113,7557-7,0,0,0,22.35,,
98114,7526A7,9,3,6,4.50,,
98115,7518A3,0,0,0,8.74,,
98116,7524A7,3,0,3,4.30,,
98117,7520A3,0,0,0,8.88,,
98118,2000033703,5,5,0,19.38,,
98119,7533A7,12,6,6,7.25,,
98120,2000037533,4,2,2,220.43,339.99,
98121,2155785,2,1,1,198.53,289.99,
98122,2155787,0,0,0,101.56,139.99,
98123,2155783,0,0,0,287.19,389.99,
98124,NV6LC1-14BP7,0,0,0,38.89,,
98125,NV6LC2-14BP7,4,0,4,48.75,,
98126,2000036530,0,0,0,175.94,229.99,
98127,2000036528,0,0,0,105.63,149.99,
98128,2155782,0,0,0,168.75,229.99,
98130,2000037516,0,0,0,123.75,159.99,
98131,5092-10-7,0,0,0,22.69,,
98132,5092-14-7,0,0,0,24.95,,
98133,5091-10-7,0,0,0,20.77,,
98134,5091-14-7,0,0,0,25.87,,
98135,5095-10-7,0,0,0,38.38,,
98136,5530-24BP7,4,0,4,45.80,,
98137,2000037514,1,1,0,91.76,129.99,
98138,2154663,1,1,0,59.69,89.99,
98139,2000035800,3,1,2,59.69,89.99,
98140,2154662,1,1,0,84.69,114.99,
98141,2154684,1,1,0,84.69,114.99,
98142,2154640,0,0,0,84.69,114.99,
98143,911339-7,0,0,0,15.89,,
98144,2000036527,1,0,1,142.19,184.99,
98145,2156401,3,2,1,142.19,184.99,
98146,2157342,5,3,2,112.78,169.99,
98147,2000037518,0,0,0,175.94,229.99,
98148,5122-08-7,0,0,0,18.49,,
98157,5940-7,10,6,4,16.29,,
98159,6100-AT-7,0,0,0,339.29,,
98160,6100-LT-7,4,2,2,339.29,,
98161,2000036415,4,2,2,55.63,,
98162,2000032254,2,2,0,150.88,,
98163,FASP093CA2L1A00,0,0,0,82.04,,
98164,2000032253,2,0,2,115.94,,
98165,2000035697,3,2,1,83.44,,
98166,2155788,1,0,1,80.31,,
98167,2156428,0,0,0,173.13,239.99,
98168,2156426,0,0,0,157.50,219.99,
98170,2156418,0,0,0,157.50,209.99,
98171,2156414,0,0,0,141.88,189.99,
98172,2157495,0,0,0,141.88,189.99,
98173,66UW03B-7,2,0,2,134.31,,
98174,66UW06B-7,0,0,0,206.11,,
98175,66UW12B-7,4,2,2,314.01,,
98176,66UW12W-7,1,1,0,249.99,,
98177,2156416,0,0,0,102.50,139.99,
98178,2156427,0,0,0,86.56,119.99,
98179,6350W7,0,0,0,17.19,,
98180,6350B7,3,3,0,17.19,,
98181,2157497,0,0,0,86.56,119.99,
98182,2156421,0,0,0,118.13,159.99,
98183,2156429,0,0,0,102.50,139.99,
98184,2157500,0,0,0,102.50,139.99,
98185,2158287,0,0,0,24.06,32.99,
98186,2158288,0,0,0,24.06,32.99,
98187,2158344,0,0,0,24.06,32.99,
98188,HX320,51,25,26,136.18,,
98189,93038LP7,6,0,6,15.74,,
98190,93516LP7,8,6,2,15.74,,
98191,93014LP7,3,0,3,16.08,,
98192,2000037508,8,5,3,35.94,49.99,
98193,9300FDV7,0,0,0,23.93,,
98194,2157496,0,0,0,79.06,104.99,
98195,2156422,1,1,0,79.06,104.99,
98196,2157499,2,2,0,94.69,129.99,
98198,8838US6,0,0,0,14.88,,
98199,8838HF6,0,0,0,6.93,,
98200,8838TM6,0,0,0,7.16,,
98201,8838HM6,0,0,0,9.75,,
98202,951606ULP7,6,3,3,34.49,,
98203,93806UUS7,2,0,2,36.18,,
98204,93806UUSD7,6,4,2,51.71,,
98205,93812UUS7,0,0,0,53.27,,
98206,93812UUSD7,0,0,0,69.94,,
98207,2000035686,4,4,0,38.00,,
98208,93806ULP7,0,0,0,33.12,,
98209,2000034873,4,2,2,38.00,44.99,
98211,93806UFDV7,0,0,0,57.54,,
98212,93812ULP7,0,0,0,43.65,,
98213,93806MUS7,0,0,0,38.45,,
98214,93806AUS7,2,2,0,38.45,,
98215,93806MUSD7,0,0,0,58.20,,
98216,93806EUS7,0,0,0,38.45,,
98217,93806EUSD7,0,0,0,58.20,,
98218,93806ELP7,0,0,0,40.36,,
98219,93806YLP7,0,0,0,40.36,,
98220,93806HUS7,4,1,3,40.92,,
98221,8873-6,0,0,0,6.63,,
98222,8890LP6,0,0,0,6.39,,
98223,8896LP6,0,0,0,3.87,,
98224,8882-6,0,0,0,9.67,,
98225,14530-6,0,0,0,11.45,,
98226,14532-6,0,0,0,7.29,,
98227,8883-6,0,0,0,6.17,,
98228,88FHE516-6,0,0,0,4.74,,
98229,8889LP6,0,0,0,3.87,,
98230,8897-6,0,0,0,6.80,,
98231,88FHY516-6,5,0,5,3.21,,
98232,8901-6,0,0,0,5.00,,
98233,8902-6,4,4,0,9.66,,
98234,8900-6,0,0,0,5.01,,
98235,14509-6,0,0,0,4.64,,
98236,8884-6,0,0,0,9.41,,
98237,88FTS014-6,0,0,0,10.04,,
98238,8887-6,0,0,0,5.57,,
98239,T91,0,0,0,105.51,,
98240,T93,0,0,0,165.53,,
98241,"ZTF TILLER M2",0,0,0,1774.65,,
98242,904513,0,0,0,137.80,219.99,
98243,"ZTF TILLER S2",0,0,0,1773.81,,
98254,8M0120717,0,0,0,64.15,,
98255,5590-24-7,2,1,1,34.64,,
98256,5590-30-7,6,3,3,29.99,,
98257,5590-36-7,0,0,0,35.36,,
98258,5590-42-7,0,0,0,35.36,,
98259,7800-24-7,0,0,0,48.10,,
98260,LTM-FM-101,0,0,0,9.81,12.99,
98261,7800-36-7,0,0,0,48.45,,
98262,LTM-SA-102,63,27,36,16.41,24.99,
98263,7800-42-7,0,0,0,48.81,,
98264,W6/3-FT,62,62,0,3.89,,
98265,W16/3-FT,87,87,0,0.38,,
98286,6234,0,0,0,274.97,,
98287,SM-ACC3-RCGA-DOME,1,0,1,80.26,,98.79
98290,R509C-LM,0,0,0,4048.30,,
98292,E70660,0,0,0,479.99,,
98303,44050-1000,0,0,0,29.14,,
98306,T70581,1,0,1,1063.99,,
98308,A80703,2,2,0,479.99,,
98309,A80704,2,1,1,1283.99,,
98310,T70543,0,0,0,1999.99,,
98311,T70544,1,0,1,1999.99,,
98314,125,0,0,0,9.64,,
98316,127,7,7,0,9.64,,
98317,128,9,6,3,9.64,,
98318,131,12,8,4,9.64,,
98320,132,4,1,3,9.64,,
98322,400,15,4,11,7.80,,
98323,11595-2,3,1,2,17.96,,
98324,5614-7,5,5,0,45.12,,
98325,88FBM101-6,0,0,0,2.89,,
98326,14540-6,0,0,0,5.43,,
98327,88FBMA102-6,0,0,0,3.54,,
98328,88FAS014-6,0,0,0,8.29,,
98329,88FAS038-6,0,0,0,15.38,,
98330,11822-6,0,0,0,3.14,,
98334,99DFCCSZ1S,5,4,1,51.81,,
98335,99DFCCSS1S,2,2,0,57.30,,
98336,99DFCCAB1S,1,0,1,39.12,,
98337,99DFCCAZ1S,1,0,1,51.81,,
98338,99DFCCAS1S,6,3,3,57.30,,
98339,1670-3,0,0,0,10.93,,
98340,66419-3,13,7,6,9.95,,
98341,1674-6,8,5,3,27.42,,
98343,30SCM-D5OS,0,0,0,682.50,828.75,
98344,14-01-018,2,2,0,190.28,,
98345,14-02-026,3,1,2,279.88,,
98349,99CC045-1S,0,0,0,75.76,,
98350,99CC085-1S,3,0,3,83.99,,
98351,99CC085HSA1S,0,0,0,103.51,,
98352,99CC150-1S,0,0,0,128.63,,
98354,99DFPVSS1S,9,0,9,83.65,,
98355,99DFPVAB1S,0,0,0,61.44,,
98356,99DFPVAS1S,4,2,2,83.65,,
98357,12820-5,4,2,2,6.11,,
98358,11526-3,2,2,0,8.05,,
98359,11512-3,9,5,4,9.41,,
98360,88TC06-7,3,3,0,17.44,,
98362,11840-7,11,3,8,34.90,,
98363,11841-4,6,2,4,10.62,,
98364,12562-6,42,16,26,2.92,,
98365,11820-7,3,2,1,9.96,,
98366,11873-1,8,5,3,4.29,,
98367,9400-7,7,2,5,24.33,,
98368,9401-7,14,7,7,20.49,,
98371,11891D7,2,2,0,6.87,,
98372,66406-5,0,0,0,27.49,,
98373,66074-3,11,1,10,18.14,,
98374,1607-3,0,0,0,6.82,,
98375,8803LP2,7,3,4,40.65,,
98376,8803LPG2,3,2,1,45.90,,
98377,8812LP2,1,0,1,91.50,,
98378,8812LPG2,0,0,0,99.74,,
98379,8812LLP2,0,0,0,92.58,,
98380,8812LLPG2,7,3,4,98.95,,
98381,69045,9,9,0,22.66,,
98384,13700-7,0,0,0,6.63,,
98385,13702-4,0,0,0,10.45,,
98386,11575-3,12,6,6,6.33,,
98387,11952-7,7,3,4,8.00,,
98388,010-13177-00,0,0,0,74.99,,
98394,GOST-UCU-S,0,0,0,1999.99,,
98395,6242,15,8,7,473.86,,
98396,6252,2,2,0,678.41,,
98397,6253,4,2,2,869.32,,
98398,6262,4,2,2,1073.86,,
98399,6263,2,0,2,1261.36,,
98401,G230524,6,4,2,10.07,,
98402,G230416,0,0,0,12.12,,
98403,G230316,0,0,0,12.13,,
98417,TYN-08BLUSP,12,0,12,4.17,,
98418,3000004255,5,5,0,81.25,,
98422,S10,4,2,2,265.36,,
98430,AAI-KIT,2,0,2,829.99,,
98431,WVI-KIT,0,0,0,2642.35,,
98432,S6HD-KIT,1,0,1,2329.99,,
98433,F4-A250-R,0,0,0,6388.89,8396.00,
98434,F4-A250-S,0,0,0,6055.56,7996.00,
98435,F4-A500-R,0,0,0,11444.44,13040.00,
98436,F4-A500-S,0,0,0,11111.11,12640.00,
98438,400715-3,6,6,0,48.24,,
98439,401840-3,9,5,4,98.24,,
98440,404939-3,0,0,0,65.09,,
98441,422730-1,6,3,3,31.73,,
98442,WR16/2DC-100,8,4,4,47.00,,
98444,WR16/2DC-250,2,0,2,105.00,,
98445,WR16/2DC-500,4,0,4,190.00,,
98446,WR14/2DC-100,4,4,0,55.00,,
98447,WR14/2DC-250,3,0,3,127.50,,
98448,422732-1,5,2,3,21.76,,
98449,WR14/2DC-500,4,2,2,235.00,,
98450,WR12/2DC-100,6,4,2,79.00,,
98451,426514-1,30,30,0,20.18,,
98452,426516-1,10,0,10,17.38,,
98453,WR12/2DC-250,3,0,3,217.50,,
98454,WR12/2DC-500,2,0,2,340.00,,
98455,WR10/2DC-100,5,3,2,126.00,,
98456,WR10/2DC-250,4,0,4,295.00,,
98457,WR10/2DC-500,0,0,0,545.00,,
98458,WR16/3-100,1,0,1,63.00,,
98459,426518-1,4,4,0,24.11,,
98460,426519-1,8,6,2,28.05,,
98461,426521-1,4,0,4,20.18,,
98462,426522-1,4,0,4,40.95,,
98463,WR16/3-250,3,0,3,142.50,,
98464,S00-01140-00,0,0,0,8.55,,
98467,HT1821AW,0,0,0,187.71,,
98468,WR16/3-500,0,0,0,250.00,,
98469,WR14/3-250,1,0,1,170.00,,
98470,WR14/3-500,2,0,2,325.00,,
98471,WR14/3-1000,0,0,0,580.00,,
98472,WR12/3-100,7,4,3,104.00,,
98473,WR12/3-250,2,0,2,260.00,,
98474,WR12/3-500,4,0,4,500.00,,
98475,WR10/3-100,3,2,1,163.00,,
98482,ZDIGELINK,2,1,1,209.96,,
98483,WR10/3-250,0,0,0,385.00,,
98484,WR10/3-500,0,0,0,725.00,,
98485,WR14/3-100,4,1,3,73.00,,
98486,WR16/4-250,1,0,1,197.50,,
98487,WR16/4-500,1,0,1,380.00,,
98488,WR14/4-100,7,3,4,115.00,,
98489,WR14/4-250,0,0,0,308.65,,
98490,WR14/4-1000,0,0,0,940.00,,
98491,WR12/4-100,5,1,4,156.00,,
98492,WR12/4-250,1,0,1,380.00,,
98493,WR12/4-500,0,0,0,773.08,,
98494,WR10/4-100,2,1,1,219.00,,
98495,WR10/4-250,0,0,0,614.42,,
98496,WR10/4-500,1,0,1,1165.00,,
98497,WR14/4-500,0,0,0,505.00,,
98498,WR16/6-100,2,2,0,206.00,,
98499,WR16/6-250,4,1,3,500.00,,
98500,WR16/6-500,0,0,0,1050.00,,
98501,WR14/6-100,4,1,3,263.00,,
98502,WR14/6-250,0,0,0,735.58,,
98503,WR14/6-500,0,0,0,1401.92,,
98508,101829,5,3,2,109.05,,
98514,MA6007-267-XS-267,0,0,0,28.13,,44.99
98515,MA6007-267-S-267,0,0,0,28.13,,44.99
98516,MA6007-267-M-267,0,0,0,28.13,,44.99
98517,MA6007-267-L-267,0,0,0,28.13,,44.99
98518,MA6007-267-XL-267,0,0,0,28.13,,44.99
98519,BS-22,3,1,2,65.00,,
98520,BS-23,3,2,1,78.33,,
98521,BS-24,1,1,0,96.11,,
98522,BS-25,3,0,3,96.11,,
98527,FW-40PROA-GN,1,1,0,175.50,,
98528,FW-40PROA-HV,0,0,0,175.50,,
98529,FW-40PROHA-OB,0,0,0,210.38,,
98531,AV-1000-BK-XS/S,0,0,0,157.50,,
98532,AV-1000-BK-M/L,2,2,0,157.50,,
98533,AV-1000-BK-XL/XXL,1,1,0,157.50,,
98534,AV-1000-GN-XS/S,0,0,0,157.50,,
98535,AV-1000-GN-M/L,0,0,0,157.50,,
98536,AV-1000-GN-XL/XXL,0,0,0,157.50,,
98537,BCF-AV1000,0,0,0,12.94,,
98540,W0004,0,0,0,5.49,,
98547,AV-5001-OB-S/M,0,0,0,61.88,,
98548,AV-5001-OB-L/XL,0,0,0,61.88,,
98549,AV-5001-OB-2XL/3XL,0,0,0,61.88,,
98550,701-MDVS-D,0,0,0,160.90,,
98551,010-13305-00,1,0,1,91.17,,
98553,010-13269-12,3,1,2,26.59,,
98554,AV-800-OB-S/M,0,0,0,75.94,,
98555,AV-800-OB-L/XL,0,0,0,75.94,,
98556,AV-800-OB-2XL/3XL,0,0,0,75.94,,
98557,AS-1100-OB-S,0,0,0,409.50,,
98558,AS-1100-OB-M,0,0,0,409.50,,
98559,AS-1100-OB-L,0,0,0,409.50,,
98560,AS-1100-OB-XL,0,0,0,409.50,,
98561,AS-1100-OB-2XL,0,0,0,409.50,,
98562,AS-1100-OB-3XL,0,0,0,433.13,,
98564,FRS-900-HV-S/M,0,0,0,365.63,,
98565,FRS-900-HV-L/XL,0,0,0,365.63,,
98566,FRS-900-HV-2XL/3XL,0,0,0,365.63,,
98567,FRP-800-BK-S/M,0,0,0,169.88,,
98568,010-C1351-40,0,0,0,187.49,,
98569,FRP-800-BK-L/XL,2,2,0,169.88,,
98570,FRP-800-BK-2XL/3XL,0,0,0,169.88,,
98583,491108-1,6,1,5,8.69,,
98584,422768-1,9,6,3,61.37,,
98591,FG250RV,0,0,0,18.75,,
98603,1029,90,69,21,23.24,,
98604,1082,24,11,13,26.01,,
98605,1054,6,2,4,24.90,,
98606,1086,23,13,10,27.87,,
98607,1160,3,3,0,34.99,,
98608,1139,9,4,5,34.99,,
98609,1092,36,14,22,46.82,,
98611,1027,22,18,4,14.23,,
98614,1090,8,4,4,22.53,,
98615,1091,6,0,6,14.23,,
98616,1011,102,32,70,52.17,,
98617,1022,122,68,54,52.17,,
98618,1014,0,0,0,52.17,,
98619,1009,821,454,367,14.23,,
98620,1006,137,123,14,22.53,,
98621,1001,0,0,0,22.53,,
98622,1005,0,0,0,22.53,,
98623,1104,14,4,10,16.60,,
98624,1023,9,5,4,13.43,,
98625,010-12504-00,0,0,0,14.99,,
98632,1050,72,70,2,10.99,,
98634,1132,14,0,14,20.00,,
98635,1133,9,0,9,20.00,,
98636,1134,17,8,9,20.00,,
98637,1076,37,26,11,15.66,,
98638,1075,8,5,3,15.66,,
98639,1077,8,4,4,15.66,,
98643,1119,0,0,0,34.99,,
98645,1122,33,21,12,58.10,,
98648,OMHD-04-DB-R,6,4,2,93.75,,
98649,OMSD-01-DB-R,4,0,4,106.25,,
98650,BPP900462050,2,0,2,13.78,,17.00
98651,BPP900462070,3,1,2,13.78,,17.00
98667,SC3-CC-BZSM,6,4,2,249.00,,349.00
98668,SC3-BW-BZSM,0,0,0,224.00,,319.00
98669,SC3-BB-BZSM,4,2,2,224.00,,319.00
98670,SC3-GW-BZSM,0,0,0,224.00,,319.00
98673,010-12117-04,0,0,0,59.99,,
98686,21043,0,0,0,69.99,,
98687,B00129201,0,0,0,759.88,1019.69,
98691,367654252,0,0,0,155.34,,
98692,CIP136060010,10,5,5,11.71,,14.45
98693,CIP136080010,9,9,0,11.71,,14.45
98694,CIP136100010,3,1,2,11.71,,14.45
98695,CIP136125010,5,2,3,11.71,,14.45
98696,CIP136150010,8,4,4,11.71,,14.45
98700,425-0012,4,2,2,1505.56,,1951.00
98701,430-0001,2,2,0,442.36,,573.00
98702,430-0003,22,11,11,648.61,,841.00
98703,430-0005,11,6,5,575.69,,746.00
98704,430-0007,15,8,7,825.69,,1070.00
98705,430-0009,17,8,9,531.25,,689.00
98706,430-0011,21,10,11,738.19,,957.00
98707,430-0013,6,1,5,663.89,,860.00
98708,430-0015,14,8,6,915.28,,1186.00
98709,429-0007,4,2,2,974.31,,1070.00
98710,413-0060,10,5,5,252.78,,328.00
98712,304-0055,6,5,1,75.00,,
98713,409-0018,0,0,0,442.36,,573.00
98714,UC168-1,0,0,0,411.62,,
98721,36123,1,0,1,249.99,399.99,
98722,36210,0,0,0,387.49,619.99,
98723,906705,2,2,0,268.20,469.99,
98724,922314,0,0,0,393.74,629.99,
98725,932314,0,0,0,590.62,944.99,
98726,262214,0,0,0,237.50,379.99,
98727,20252,0,0,0,143.74,229.99,
98728,300514,2,2,0,269.91,472.99,
98729,300515,0,0,0,456.24,729.99,
98730,110223,1,1,0,251.08,439.99,
98731,244293,2,2,0,311.58,545.99,
98733,001-512-680-00,0,0,0,311.11,,
98738,S1950,0,0,0,1047.06,,
98739,ZDIG4GXWL,2,1,1,374.96,,
98741,VR600,12,6,6,107.44,,
98745,TW2V61500,1,1,0,33.86,,
98746,TW4B25400,2,2,0,36.55,,
98747,TW4B25500,0,0,0,36.55,,
98748,TW4B25800,0,0,0,33.33,,
98749,TW4B26300,0,0,0,34.94,,
98750,TW4B26500,5,5,0,34.94,,
98751,708082,0,0,0,12.86,,
98752,TW5M19600,2,2,0,29.56,,
98753,TW5M19700,2,2,0,29.56,,
98754,TW4B27100,3,2,1,40.85,,
98755,0493DP999R,0,0,0,25.55,,
98756,TW4B28000,0,0,0,31.18,,
98757,TW5M49400,0,0,0,37.63,,
98758,TW5M49500,2,2,0,37.63,,
98759,TW5M55200,2,2,0,32.25,,
98760,TW5M55500,0,0,0,32.25,,
98761,TW5M55600,0,0,0,27.95,,
98762,TW5M55800,2,2,0,27.95,,
98764,68000363,0,0,0,327.15,,
98767,14141-7,14,10,4,7.62,,
98768,14142-7,17,10,7,7.62,,
98769,6123AEPAWV,1,0,1,66.04,,
98770,14060-7,9,6,3,24.52,,
98772,14063-7,8,5,3,33.44,,
98773,14065-7,5,1,4,46.57,,
98774,14064-7,9,6,3,53.57,,
98775,11149-4,13,5,8,40.01,,
98777,103200-999-004-12,0,0,0,66.25,,
98779,11195-4,7,3,4,48.26,,
98781,1698,0,0,0,40.67,,
98784,MAG5151SL,0,0,0,497.40,622.00,
98785,MAG2626SL,0,0,0,264.60,331.00,
98786,MAG6363SL,0,0,0,632.40,791.00,
98787,ALT5151SL,0,0,0,435.00,544.00,
98788,ALT2626SL,0,0,0,238.20,298.00,
98789,148-1006,5,3,2,102.14,,
98790,148-1126,1,0,1,150.59,,
98791,149-0346,6,2,4,74.79,,
98792,149-1186,0,0,0,114.43,,
98793,149-1126,6,3,3,162.79,,
98794,147-0346,3,0,3,73.60,,
98795,147-1186,3,0,3,99.06,,
98796,365-0386,5,3,2,106.09,,
98797,365-0566,2,0,2,106.09,,
98798,317-0586,4,4,0,133.39,,
98799,305-0386,0,0,0,101.40,,
98800,305-0566,0,0,0,93.80,,
98801,165-0126,3,1,2,42.19,,
98802,38163225,0,0,0,246.68,,
98803,166-0126,4,2,2,42.19,,
98804,166-0586,4,4,0,44.90,,
98805,165-0586,3,1,2,44.90,,
98806,165-0346,3,0,3,59.86,,
98808,166-0346,9,9,0,59.86,,
98809,161-1006,3,3,0,86.74,,
98810,250-1126,0,0,0,431.43,,
98811,325626-1,3,3,0,48.89,,
98812,100-1146,0,0,0,354.29,,
98813,102-1126,0,0,0,502.86,,
98814,100-0346,0,0,0,304.29,,
98815,100-1006,4,4,0,335.71,,
98816,705-0381,0,0,0,12.89,,
98818,705-0561,4,2,2,12.43,,
98820,705-0121,2,0,2,13.64,,
98821,705-0141,5,2,3,12.13,,
98822,705-0581,3,1,2,13.94,,
98826,705-1001,3,1,2,15.46,,
98827,710-0121,0,0,0,18.34,,
98828,710-0341,0,0,0,19.86,,
98829,710-0581,0,0,0,18.50,,
98830,710-1001,3,0,3,20.61,,
98831,710-1121,0,0,0,26.60,,
98832,710-1141,3,0,3,25.71,,
98833,710-1381,2,0,2,17.49,,
98834,710-2001,0,0,0,29.36,,
98835,720-1001,0,0,0,63.27,,
98836,720-1121,0,0,0,66.16,,
98837,720-2001,0,0,0,68.07,,
98838,720-2121,0,0,0,73.51,,
98839,720-3001,0,0,0,77.21,,
98840,11127-4,7,3,4,39.36,,
98841,11126-4,2,1,1,55.74,,
98842,720-3121,0,0,0,79.46,,
98843,720-4001,0,0,0,81.70,,
98844,720-4001L,0,0,0,82.01,,
98845,11247-1,15,9,6,18.68,,
98846,720-5001,0,0,0,86.17,,
98847,720-5001L,0,0,0,87.46,,
98848,720-6001,0,0,0,88.73,,
98849,720-6001L,0,0,0,90.01,,
98850,15232-7,18,0,18,11.84,,
98851,720-8001,0,0,0,92.57,,
98852,15221-7,12,5,7,15.15,,
98853,720-8001L,0,0,0,96.41,,
98854,GFELGF-BK-DP,0,0,0,44.99,,
98855,GFEL-GF-R-DP,0,0,0,44.99,,
98856,GFEL-LG-BK-DP,0,0,0,44.99,,
98857,GFEL-LG-R-DP,0,0,0,44.99,,
98858,11108-7,13,7,6,11.32,,
98859,11730-7,6,4,2,14.49,,
98860,11732-7,11,5,6,8.76,,
98861,11792-6,0,0,0,5.16,,
98862,SP-1002,13,7,6,14.33,,
98863,90720,4,2,2,17.86,,
98864,91320,0,0,0,19.36,,
98865,91320-ADJ,0,0,0,32.30,,
98867,EBL-1-DP,0,0,0,242.70,,
98869,JBLR4500,0,0,0,317.95,449.95,
98873,2158135,7,5,2,25.71,,
98874,2158119,5,2,3,25.71,,
98875,2158133,4,3,1,30.71,,
98876,2158118,5,3,2,30.71,,
98877,2158117,5,3,2,35.71,,
98878,2158132,4,2,2,35.71,,
98879,2158136,4,2,2,47.81,,
98880,2158120,4,2,2,47.81,,
98881,2158131,6,2,4,22.14,,
98882,2158134,9,4,5,22.14,,
98884,GDI000016000,1,1,0,88.19,,108.80
98886,98391GNMX,4,2,2,62.92,,
98887,98391GY,8,6,2,55.86,,
98888,98395CAMO,8,4,4,55.51,,
98889,98395GY,9,4,5,41.68,,
98890,98395WH,0,0,0,43.27,,
98892,A2C59514202,2,0,2,24.99,54.89,
98903,202-255,0,0,0,193.75,248.00,
98922,TS001,10,5,5,51.99,,
98923,IG001,12,6,6,45.96,,
98924,IG002,7,4,3,21.99,,
98925,IG003,9,6,3,17.99,,
98926,IG004,10,4,6,19.99,,
98927,IG005,0,0,0,59.20,,
98928,IG006,1,0,1,69.99,,
98929,IG007,12,6,6,43.84,,
98930,IG008,12,6,6,73.99,,
98931,IG009,12,6,6,58.49,,
98932,IG010,2,2,0,59.99,,
98933,IG011,11,5,6,61.99,,
98934,IG012,11,7,4,54.99,,
98935,IG013,3,0,3,21.99,,
98936,DR001,3,1,2,4.49,,
98937,DR002,10,4,6,6.79,,
98938,DR003,12,6,6,8.16,,
98939,DR004,12,6,6,14.79,,
98940,DC001,12,6,6,25.63,,
98941,DC003,12,6,6,40.44,,
98942,317-0580-FT,200,200,0,4.35,,
98943,365-0560-FT,207,207,0,3.40,,
98945,DC004,12,6,6,47.43,,
98946,DC006,12,6,6,17.08,,
98947,DC007,12,6,6,18.76,,
98948,TP001,12,6,6,60.00,,
98951,SUN-COV-175,0,0,0,53.33,,
98953,327-1126,0,0,0,422.86,,
98954,327-2006,0,0,0,671.43,,
98957,481-3000,6,3,3,197.86,,
98963,G7516,0,0,0,10.79,,
98964,GP1040-43,0,0,0,334.53,,
98965,G7164,0,0,0,10.93,,
98970,110513,0,0,0,297.40,453.19,
98971,1110,5,0,5,29.97,,
98972,1111,0,0,0,29.97,,
98973,000-10614-001,0,0,0,19.88,,
98981,S65,4,4,0,399.00,,
98982,1100531-L1,0,0,0,84.96,,
98983,1100521-L1,6,6,0,87.91,,
98984,3433,6,3,3,329.99,,
98985,6259,6,4,2,204.99,,
98986,6247,1,0,1,97.99,,
98987,60060,5,4,1,154.99,,
98988,6275,6,3,3,359.99,,
98989,6279,1,1,0,159.99,,
98990,3432,5,3,2,299.99,,
98991,2171000,0,0,0,10.60,,
98992,5399,6,3,3,109.99,,
98993,6220,8,4,4,106.71,,
98994,6218,3,0,3,109.99,,
98995,SW064,4,2,2,22.21,,
98996,SW595,0,0,0,25.41,,
98997,20810,7,3,4,139.99,,
98998,5358,3,0,3,115.47,,
98999,SW275,2,2,0,15.49,,
99000,6267,7,4,3,204.99,,
99001,6232,8,4,4,109.65,,
99002,SW774,2,1,1,19.99,,
99003,SW099,3,2,1,20.99,,
99004,1690106,4,2,2,134.21,,
99006,FRBBA230,1,1,0,142.30,,
99010,88451,3,0,3,143.74,199.99,
99011,88452,4,1,3,181.24,249.99,
99018,PT-0-5000PSI-01,0,0,0,168.00,,
99019,KITOBBHBR-06',0,0,0,145.07,,
99025,1660230,4,4,0,364.63,,
99026,89700924,13,0,13,499.99,,
99027,SW08HOG,0,0,0,8.29,,
99029,SW08HP,0,0,0,8.29,,
99030,SW08GRMU,0,0,0,8.29,,
99031,SW08HBNC,0,0,0,8.29,,
99032,W14/2DC-FT,80,80,0,0.33,,
99038,301-0132,3,1,2,30.69,,
99047,20-586-01,0,0,0,323.00,,
99049,544313,1,1,0,521.71,794.99,
99053,1127RA0WHT,0,0,0,195.77,,
99054,1127GA0WHT,0,0,0,195.77,,
99057,03-1104-10PK,0,0,0,6.10,,
99058,03-1108-2PK,0,0,0,8.54,,
99061,99DFPVSB1S,3,1,2,61.44,,
99062,09-812BT-1,0,0,0,34.00,,
99070,1250300,5,3,2,221.85,,
99072,1240748-MLNS,1,0,1,79.35,,
99073,12730,0,0,0,1.50,,
99077,SXV300M1-3,4,0,4,181.29,,
99083,2159352,6,6,0,22.81,,
99084,2158920,7,3,4,22.81,,
99085,225T-TM904,1,1,0,577.78,,
99086,225T-PR904,0,0,0,1511.11,,
99087,1780250,3,2,1,68.47,,
99088,1780245,4,4,0,52.97,,
99089,WP-800-900,3,1,2,22.44,,
99090,1690107,9,4,5,129.10,,
99093,"07-30M-134R    ",0,0,0,69.38,88.80,
99094,"07-SRC-30M     ",0,0,0,31.25,40.00,
99095,"07-141-8NPSMPLUG     ",0,0,0,26.88,34.40,
99097,N07170,4,4,0,95.14,,
99098,N03130,0,0,0,16.44,,
99100,32301,4,1,3,52.51,,
99101,64914,0,0,0,18.72,,
99102,64913,0,0,0,16.03,,
99103,81586,0,0,0,82.56,,
99109,81585,0,0,0,72.90,,
99110,81686B,0,0,0,100.76,,
99111,81685B,0,0,0,88.14,,
99112,81684B,0,0,0,74.64,,
99113,81683B,0,0,0,60.26,,
99114,81682B,2,1,1,44.33,,
99115,81686,0,0,0,97.40,,
99116,81684,0,0,0,71.08,,
99117,81682,0,0,0,42.22,,
99118,41201,28,5,23,199.99,,
99119,60150,0,0,0,28.03,,
99120,41200,31,8,23,189.99,,
99121,N03591,0,0,0,63.76,,
99122,N02130,1,0,1,14.96,,
99134,N01130,0,0,0,13.32,,
99135,05900,2,2,0,275.94,,
99136,N03430,0,0,0,27.56,,
99137,64804,0,0,0,1.67,,
99138,N03631,0,0,0,61.85,,
99139,N02631,0,0,0,54.15,,
99140,N02430,0,0,0,22.03,,
99141,N02290,0,0,0,28.60,,
99142,N02190,0,0,0,20.83,,
99143,N02160,0,0,0,15.15,,
99144,N02150,1,1,0,19.06,,
99145,N00110,0,0,0,6.14,,
99146,42400,3,1,2,9.80,,
99147,42358,0,0,0,4.03,,
99148,43601,0,0,0,5.77,,
99149,42357,3,3,0,3.77,,
99150,81550,1,0,1,76.84,,
99151,81584,0,0,0,61.96,,
99152,42336,2,2,0,48.62,,
99153,42335,4,0,4,72.72,,
99154,42334,5,3,2,65.49,,
99155,21053,1,0,1,14.36,,
99156,42300,8,5,3,131.25,,
99157,90301,0,0,0,86.67,,
99158,70300,3,3,0,26.69,,
99159,60001,2,2,0,20.11,,
99160,52111,0,0,0,12.64,,
99161,52110,0,0,0,12.64,,
99162,52100,2,2,0,16.89,,
99163,52001,2,2,0,13.15,,
99164,52000,12,0,12,13.15,,
99165,51253,4,3,1,41.18,,
99166,32100,0,0,0,110.90,,
99167,25100,1,1,0,78.01,,
99168,22100,0,0,0,51.88,,
99169,21644,2,0,2,86.81,,
99170,21643,3,1,2,83.28,,
99171,21642,4,1,3,79.17,,
99172,21641,6,3,3,68.78,,
99175,PMP242305102,4,2,2,906.72,,1118.60
99176,PU031104-12,5,2,3,103.77,,
99180,55505,2,2,0,571.27,,699.99
99181,55363,5,4,1,427.12,,529.99
99183,W14/3-FT,9,9,0,0.49,,
99194,221127,19,10,9,11.32,,
99196,TAE1/0-12R-10,15,6,9,16.06,,
99201,TAE1-12R-10,19,10,9,15.29,,
99206,TAE2/0-12R-10,14,4,10,14.48,,
99210,TAE2/0-38R-2,5,5,0,3.87,,
99212,TAE2-12R-10,10,0,10,14.24,,
99214,A22112,0,0,0,299.99,,
99218,TAE3/0-12R-10,20,10,10,18.01,,
99220,TAE3/0-38R-10,20,10,10,18.18,,
99222,TAE3/0-56R-10,20,10,10,17.83,,
99224,TAE4/0-12R-10,20,10,10,24.57,,
99226,TAE4/0-38-R-10,10,3,7,24.57,,
99232,TAE4/0-56R-10,14,6,8,24.57,,
99237,TAE4-12R-10,18,10,8,11.76,,
99242,TAE6-10R-2,17,0,17,1.88,,
99244,TAE6-12R-10,16,6,10,7.49,,
99246,TAE6-14R-2,7,7,0,2.22,,
99247,TAE6-38R-2,6,6,0,2.22,,
99250,TAE8-12R-10,16,6,10,12.09,,
99255,TBSE18-3,6,6,0,2.08,,
99256,TBSE18-25,10,4,6,12.26,,
99257,TBSE18-100,13,4,9,24.82,,
99258,TBSE14-3,10,10,0,2.12,,
99259,TBSE14-25,10,4,6,12.26,,
99260,TBSE14-100,35,17,18,24.82,,
99261,TBSE10-3,10,10,0,2.64,,
99262,TBSE10-25,11,5,6,16.92,,
99263,TBSE10-100,21,7,14,34.27,,
99265,TBSE8-25,11,0,11,23.44,,
99266,TE18-8R-3,10,10,0,2.06,,
99267,TE18-8R-25,11,5,6,12.26,,
99268,TE18-8R-100,29,15,14,25.08,,
99269,TE18-10R-3,10,10,0,2.02,,
99270,TE18-10R-25,8,2,6,12.02,,
99271,TE18-10R-100,36,21,15,24.61,,
99272,TE18-14R-3,10,10,0,1.96,,
99273,TE18-14R-25,11,5,6,11.61,,
99274,TE18-14R-100,30,15,15,23.76,,
99275,TE18-56R-3,9,9,0,1.96,,
99276,TE1856R-25,11,4,7,11.61,,
99277,TE18-56R-100,29,14,15,23.76,,
99278,TE18-38R-3,10,10,0,1.96,,
99279,TE18-38R-25,11,5,6,11.61,,
99280,TE18-38R-100,29,14,15,23.76,,
99281,TE14-8R-3,10,10,0,2.00,,
99282,TE14-8R-25,14,10,4,11.90,,
99283,TE14-8R-100,22,11,11,24.37,,
99284,TE14-10R-3,10,10,0,2.00,,
99285,TE14-10R-25,17,6,11,11.90,,
99286,TE14-10R-100,17,11,6,24.37,,
99287,TE14-14R-3,10,10,0,2.00,,
99288,CMP122200102,6,2,4,773.75,,954.55
99289,TE14-14R-25,10,4,6,11.90,,
99290,TE14-14R-100,28,13,15,26.28,,
99291,TE14-56R-3,10,10,0,2.00,,
99292,TE14-56R-25,12,6,6,11.90,,
99300,TE14-56R-100,22,10,12,25.08,,
99301,TE14-38R-3,10,10,0,2.00,,
99302,TE14-38R-25,10,5,5,11.90,,
99303,TE14-38R-100,24,10,14,24.37,,
99304,TE10-8R-3,10,10,0,2.52,,
99305,TE10-8R-25,0,0,0,21.11,,
99306,TE10-8R-100,22,10,12,33.58,,
99307,TE10-10R-3,8,8,0,2.52,,
99308,TE10-10R-25,14,8,6,16.42,,
99309,TE10-10R-100,44,18,26,33.58,,
99310,TE10-14R-3,7,7,0,2.52,,
99311,TE10-14R-25,8,2,6,16.42,,
99312,TE10-14R-100,26,11,15,33.58,,
99313,TE10-56R-3,9,9,0,2.52,,
99314,TE10-56R-25,9,3,6,16.42,,
99315,TE10-56R-100,25,10,15,33.58,,
99317,TE10-38R-3,9,9,0,2.52,,
99319,TE10-38R-25,4,0,4,16.42,,
99321,TE10-38R-100,25,11,14,33.58,,
99323,TE18-8SLF-3,7,7,0,1.96,,
99325,TE18-8SLF-25,12,6,6,13.74,,
99327,TE18-8SLF-100,30,15,15,28.13,,
99330,TE14-8SLF-3,7,7,0,1.96,,
99332,TE14-8SLF-25,12,6,6,14.29,,
99333,TE14-8SLF-100,29,14,15,29.20,,
99337,TE14-10SLF-25,12,6,6,13.61,,
99338,TE14-10SLF-100,30,15,15,27.84,,
99339,TE10-8SLF-3,10,10,0,2.47,,
99342,TE10-8SLF-25,12,6,6,18.57,,
99344,TE10-8SLF-100,29,14,15,38.04,,
99345,TE10-10SLF-3,10,10,0,2.47,,
99346,TE10-10SLF-25,11,5,6,18.57,,
99347,TE10-10SLF-100,30,15,15,38.04,,
99348,TDE18-250FI-3,9,9,0,3.13,,
99349,TDE18-250FI-25,9,3,6,10.16,,
99350,TDE18-250M-3,9,9,0,2.58,,
99351,TDE18-250M-25,11,5,6,19.52,,
99352,TDE18-250M-100,29,14,15,39.93,,
99354,TE8-10R-25,14,12,2,18.57,,
99356,TE8-14R-25,18,12,6,18.57,,
99357,TE8-56R-25,12,7,5,18.57,,
99358,TE8-38R-3,7,7,0,2.87,,
99359,TE8-38-25,7,2,5,18.58,,
99360,TE8-12R-3,7,7,0,2.87,,
99361,TE8-12R-25,10,5,5,19.46,,
99362,TDE18-250FI-100,24,10,14,40.60,,
99363,TDE14-250FI-3,8,8,0,4.26,,
99364,TDE14-250FI-25,13,9,4,32.81,,
99365,TDE14-250FI-100,26,12,14,67.12,,
99366,TDE14-250M-3,9,9,0,2.58,,
99367,TDE14-250M-25,11,5,6,19.52,,
99368,TDE14-250M-100,27,13,14,39.93,,
99369,TBRE18-156-3,8,8,0,2.47,,
99370,TBRE18-156-25,11,6,5,16.02,,
99371,TBRE18-156-100,30,15,15,32.79,,
99372,TBPE18-156-3,8,8,0,2.47,,
99373,TBPE18-156-25,11,6,5,16.02,,
99374,TBPE18-156-100,30,15,15,32.79,,
99375,TBRE14-156-3,10,10,0,2.47,,
99376,TBRE14-156-25,15,9,6,16.91,,
99377,TBRE14-156-100,30,15,15,34.57,,
99378,TBPE14-156-3,10,10,0,2.47,,
99379,TBPE14-156-25,15,10,5,16.91,,
99380,TBPE14-156-100,29,15,14,34.57,,
99382,001-554-920-00,0,0,0,163.64,,
99397,MV325003-277-0-216,34,21,13,47.51,,69.99
99400,MV355502-277-0-216,3,3,0,47.51,,69.99
99401,MV356002-277-0-216,4,2,2,47.51,,69.99
99402,0P22100,4,0,4,4.68,,
99406,1229,0,0,0,311.32,,
99407,3093,0,0,0,286.01,,
99408,6152SPP-12SC,0,0,0,361.95,,
99412,1066,214,105,109,7.87,,
99413,1088,56,26,30,11.56,,
99416,B00143501,1,1,0,219.87,267.29,
99417,B00143601,0,0,0,203.64,247.49,
99418,B00143502,1,0,1,369.99,504.89,
99420,325032-1,15,5,10,12.67,,
99421,325033-1,14,4,10,12.67,,
99422,325034-1,5,0,5,12.81,,
99423,PM111C-LH,0,0,0,2461.72,,
99429,RGP6,11,11,0,6.82,,
99430,RIRP,8,8,0,10.76,,
99431,M135C-M-9N,0,0,0,674.72,,
99439,30239,20,14,6,23.54,31.99,
99440,30243,15,8,7,11.78,15.99,
99441,30240,20,6,14,20.62,27.99,
99442,PMP482505110,16,5,11,1386.96,,1711.05
99444,BGW-200,0,0,0,193.52,279.40,
99447,SCM-DLXS-BB-WH,5,3,2,47.50,,69.99
99448,SCM-DLXS-WW-WH,6,3,3,42.70,,69.99
99449,SCM-DLXS-GW-WH,4,2,2,42.70,,69.99
99450,41910,0,0,0,19.44,,
99451,41912,0,0,0,25.77,,
99452,41914,0,0,0,30.83,,
99453,41916,0,0,0,39.49,,
99454,41920,0,0,0,23.13,,
99455,41922,5,5,0,17.44,,
99456,41924,5,5,0,17.29,,
99457,41926,0,0,0,15.63,,
99458,92922111,1,0,1,19.21,,
99459,NAN012PW/TSFT/NA,2,1,1,708.74,,
99464,GS-380-LE,37,18,19,1749.99,,
99467,30Y-S5OS,2,0,2,493.50,599.25,
99468,89300053,0,0,0,2833.20,,
99469,39660050,1,0,1,790.99,,
99470,2021133086,0,0,0,1233.55,1659.00,
99471,2021133087,0,0,0,1233.55,1659.00,
99472,2021133088,0,0,0,1233.55,1659.00,
99473,2021133089,0,0,0,1233.55,1659.00,
99476,T-NAN012PW/E/NA,2,0,2,480.01,,
99477,T-NAN024PW/E/NA,0,0,0,483.34,,
99478,T-NAN024PW/TSFT/NA,0,0,0,720.51,,
99479,HEP25K,2,2,0,27.26,,
99480,HEP50K,3,2,1,33.32,,
99481,HEP75K,4,2,2,39.38,,
99482,ZDIGNS5,2,1,1,127.46,,
99488,C998-30,0,0,0,86.33,,
99493,010-12530-25,0,0,0,19.99,,
99494,E70643,13,7,6,252.70,,
99497,6293,1,0,1,332.00,,
99498,6294,2,2,0,332.00,,
99499,6295,0,0,0,365.33,,
99504,2021133090,1,0,1,1233.55,1659.00,
99505,2021133091,0,0,0,1233.55,1659.00,
99506,2021133092,0,0,0,1233.55,1659.00,
99507,2021133093,0,0,0,1233.55,1659.00,
99508,2021133094,0,0,0,1233.55,1659.00,
99509,2021133095,0,0,0,1233.55,1659.00,
99510,2021133096,0,0,0,1233.55,1659.00,
99511,2021133097,0,0,0,1233.55,1659.00,
99512,2021133098,0,0,0,1233.55,1659.00,
99513,2021133099,0,0,0,1233.55,1659.00,
99516,SBR-23LI,0,0,0,30.00,,
99520,435,27,16,11,10.29,,
99523,F153180,2,0,2,88.64,,
99527,HA4-25WHA-7-0000-0-0,0,0,0,1951.50,,
99529,TW2R425009J,1,1,0,33.33,,
99532,ORIONC,0,0,0,1259.30,,
99533,ORIONCF,0,0,0,1329.30,,
99534,74318OR,0,0,0,502.78,,
99535,109600,0,0,0,948.61,,
99537,106107,0,0,0,86.03,,
99538,106106,0,0,0,78.30,,
99539,106108,0,0,0,95.16,,
99540,106112,0,0,0,107.85,,
99541,106110,0,0,0,102.88,,
99542,106114,0,0,0,115.36,,
99543,106116,0,0,0,122.20,,
99544,106118,0,0,0,129.71,,
99545,106120,0,0,0,137.22,,
99546,106122,0,0,0,146.79,,
99547,106124,0,0,0,156.35,,
99548,100205,0,0,0,9.60,,
99555,167401,0,0,0,65.12,119.97,
99556,167432,27,7,20,24.49,44.97,
99557,167501,6,2,4,74.28,131.97,
99558,167532,22,12,10,26.77,51.97,
99559,2166923,0,0,0,250.29,,
99560,92921111,4,2,2,19.21,,
99561,010-12022-00,0,0,0,6.99,,
99568,B00059201,2,0,2,77.99,99.89,
99570,250-1126-FT,145,145,0,12.08,,
99571,100-1146-FT,150,150,0,9.92,,
99572,102-1126-FT,133,133,0,14.08,,
99573,100-0346-FT,36,36,0,8.52,,
99574,100-1006-FT,60,60,0,9.40,,
99575,481-3000-FT,44,44,0,6.93,,
99577,998-35,0,0,0,67.20,,
99578,1139,6,6,0,9.41,,
99579,1014,7,7,0,18.30,,
99580,1157,11,11,0,3.41,,
99585,O4ID2,0,0,0,256.25,,
99586,O4D9,0,0,0,256.25,,
99587,O4B9,0,0,0,155.00,,
99595,24832JU,22,9,13,2525.85,,
99596,24831GU,0,0,0,2352.53,,
99597,165-0126-FT,0,0,0,1.48,,
99598,166-0126-FT,26,26,0,1.48,,
99599,166-0586-FT,50,50,0,1.58,,
99600,165-0586-FT,39,39,0,1.58,,
99601,165-0346-FT,47,47,0,2.10,,
99602,161-1006-FT,10,10,0,3.03,,
99605,148-1006-FT,6,6,0,3.58,,
99606,148-1126-FT,0,0,0,5.28,,
99607,149-0346-FT,34,34,0,2.63,,
99608,149-1186-FT,43,43,0,4.00,,
99609,149-1126-FT,27,27,0,5.70,,
99610,147-0346-FT,16,16,0,2.58,,
99611,147-1186-FT,29,29,0,3.48,,
99612,365-0386-FT,0,0,0,3.73,,
99613,365-0566-FT,28,28,0,3.73,,
99614,317-0586-FT,4,4,0,4.68,,
99615,305-0386-FT,50,50,0,3.55,,
99616,305-0566-FT,19,19,0,3.28,,
99617,327-1126-FT,100,100,0,11.84,,
99618,327-2006-FT,37,37,0,18.80,,
99623,ME70BTW8505W,8,2,6,133.33,,
99624,ME70BTWMA8505B,0,0,0,139.99,,
99628,IRIS-S460-18,11,0,11,366.30,,
99629,IRIS-S460-28,1,0,1,366.30,,
99630,IRIS-S460-36,9,0,9,366.30,,
99631,IRIS-S060,6,0,6,366.30,,
99632,IRIS-S076,5,0,5,481.00,,
99633,IRIS-S476,4,0,4,481.00,,
99634,IRIS490,10,0,10,736.30,,
99635,IRIS735,6,0,6,312.05,,
99642,IRIS106,1,0,1,1145.50,,
99643,IRIS4106,4,0,4,1185.00,,
99644,BRK106,2,0,2,290.50,,
99645,CMAC-INT001,1,0,1,567.00,,
99646,CMAC-INT002,1,0,1,567.00,,
99647,POE1,3,0,3,94.80,,
99648,CMAC-NVR-1TB-G,4,0,4,1181.05,,
99649,CMAC-NVR-1TB-X,1,0,1,908.50,,
99650,CMAC-HVR-1TB-X,2,0,2,1003.30,,
99651,POE4V2,5,0,5,211.70,,
99652,CMAC-HVR-1TB-G,2,0,2,1186.50,,
99659,166-0346-FT,49,49,0,2.10,,
99663,ZDIGISSPK1,4,2,2,629.96,,
99665,61005,0,0,0,27.25,,
99666,61003,2,2,0,9.99,,
99670,010-12697-01,0,0,0,7.49,,
99677,30399,11,3,8,48.08,67.99,
99679,RA6201,6,2,4,534.47,649.00,
99680,RA6302,4,3,1,748.59,909.00,
99681,RA6402,6,2,4,896.82,1089.00,
99682,RA000710052,0,0,0,45.62,,
99697,010-10851-30,0,0,0,23.99,,
99701,C260,0,0,0,507.35,,
99703,861675,0,0,0,429.01,,
99705,ES-5000-V,0,0,0,331.25,,
99712,BPP900480100,10,0,10,506.41,,624.75
99715,0965DP0STS,3,0,3,38.87,,
99719,SB44B,0,0,0,19.40,,
99724,90500,5,2,3,68.68,,
99728,272V8000-S/S,5,2,3,191.86,,
99729,272V6000-S/S,0,0,0,158.43,,
99730,270V6000-S/S,4,1,3,158.07,,
99731,270V8000-S/S,1,1,0,164.64,,
99732,270V4000-S/S,5,2,3,106.91,,
99733,240V6000-S/S,1,1,0,148.14,,
99734,6635,0,0,0,45.85,,
99735,6644,2,0,2,17.71,,
99736,6645,1,0,1,23.87,,
99737,6646,0,0,0,32.72,,
99738,6654,4,0,4,17.71,,
99739,240V80000-S/S,1,1,0,253.99,,
99740,6655,1,0,1,23.87,,
99741,6656,2,0,2,32.72,,
99742,6684,0,0,0,29.37,46.24,
99743,290V3000-S/S,5,2,3,103.51,,
99744,20120,2,0,2,16.80,,
99745,20220,1,0,1,53.84,,
99746,21120,1,0,1,23.55,,
99747,30125,2,0,2,34.35,,
99748,34500,2,0,2,169.03,,
99749,290V4000-S/S,2,2,0,142.66,,
99750,35500,2,0,2,264.39,,
99751,"FRX6 / 20705",0,0,0,9.45,,
99752,"FRX10 / 21008",0,0,0,10.77,,
99753,290V6000-S/S,4,1,3,195.41,,
99754,"FRX15 / 21510",0,0,0,11.80,,
99755,"FRX20 / 22014",1,0,1,16.84,,
99756,"FRX25 / 22517",2,0,2,23.19,,
99757,7485,1,0,1,74.04,116.54,
99758,TFK-10,3,0,3,57.37,,
99759,TFK-4,5,2,3,24.74,,
99760,TFK-10W,5,2,3,44.36,,
99761,TFK-4W,5,2,3,19.56,,
99762,SB37BT,0,0,0,219.05,,369.95
99763,517526-1,0,0,0,12.31,,
99770,BPC240845102,14,6,8,102.66,,126.65
99771,BPC241245102,18,4,14,126.09,,155.55
99772,BPC241647102,18,10,8,150.89,,186.15
99773,BPC241648102,13,2,11,171.56,,211.65
99774,910-057,0,0,0,693.75,888.00,
99775,03-200-234,2,0,2,523.75,670.40,
99782,BAM010700100,3,0,3,250.80,,532.95
99783,BAM030710100,9,0,9,262.80,,558.45
99803,DV11,2,2,0,60.98,,
99804,KO2,1,1,0,146.34,,
99805,163000,1,0,1,36.88,,
99806,RWS5B,2,0,2,18.75,,
99807,RPA,0,0,0,97.56,,
99810,ELS-3510-02,0,0,0,343.75,,
99816,413-0058,7,0,7,210.14,,
99817,417-0077,2,1,1,515.90,,669.00
99828,MD4041-191-0-202,35,18,17,97.49,,129.99
99829,MD4041-4-0-202,12,10,2,97.49,,129.99
99832,M-121-BP,5,5,0,9.99,,
99833,M-115-BP,4,4,0,16.64,,
99850,GP1500-43,0,0,0,276.35,,
99856,010-02590-35,0,0,0,439.99,,
99857,010-02684-35,0,0,0,719.99,,
99858,010-02688-30,0,0,0,2279.98,,
99859,010-02688-35,0,0,0,2639.99,,
99860,020-00332-00,0,0,0,3759.99,,
99861,73123,276,23,253,4.77,,
99863,SEA2306,18,2,16,215.29,,
99864,SEA2307,12,1,11,264.71,,
99865,PMP242200102,2,0,2,786.15,,969.85
99868,ORI241270030,6,4,2,100.59,,124.10
99869,BUBBLEBUSTER,0,0,0,847.55,,
99871,950700,4,2,2,50.90,,
99872,950800,0,0,0,57.34,,
99873,98096,0,0,0,117.92,,
99874,98098,0,0,0,137.63,,
99875,98099,0,0,0,156.86,,
99881,1368890,4,0,4,2469.30,,2999.99
99883,1368892,11,5,6,2551.61,,3099.99
99884,AZL19979,1,1,0,237.50,,
99885,1368891,6,3,3,2551.61,,3099.99
99886,1368893,2,0,2,2633.92,,3199.99
99887,1368895,3,2,1,2633.92,,3199.99
99888,1368897,2,2,0,2716.23,,3299.99
99889,1368896,3,2,1,2716.23,,3299.99
99890,1368898,0,0,0,2798.54,,3399.99
99891,1368894,3,2,1,2798.54,,3399.99
99892,1368899,1,1,0,2880.85,,3499.99
99893,1368900,0,0,0,3045.47,,3699.99
99894,1368920,6,6,0,3292.40,,3999.99
99895,1368901,15,0,15,3127.78,,3799.99
99896,1368921,2,0,2,3374.71,,4099.99
99897,1368902,0,0,0,3210.09,,3899.99
99898,1368922,3,3,0,3457.02,,4199.99
99899,1368667,4,1,3,1275.80,,1549.99
99900,1368668,1,0,1,1316.95,,1599.99
99901,1368677,0,0,0,1440.43,,1749.99
99902,1358441,11,5,6,725.05,,
99903,1358453,6,6,0,795.48,,
99904,1358450,1,1,0,869.86,,
99905,1358451,23,0,23,1035.55,,
99906,1358452,0,0,0,1118.39,,
99907,1358473,6,4,2,937.83,,
99908,1358470,3,1,2,1010.70,,
99909,1358471,4,2,2,1325.51,,
99910,1358472,4,0,4,1408.36,,
99911,1358455,0,0,0,861.00,,
99912,1358475,0,0,0,1015.07,,
99913,1368715M,20,14,6,363.02,,
99914,1368716M,0,0,0,371.67,,
99915,1368730M,3,0,3,544.54,,
99916,1352145M,0,0,0,242.01,,
99917,1352155M,0,0,0,276.59,,
99918,1352156M,0,0,0,285.23,,
99919,1352270M,9,5,4,122.29,,
99920,1352272M,9,0,9,174.70,,
99921,1352274M,10,0,10,218.38,,
99922,1352278,8,7,1,227.11,,
99923,1363575,14,1,13,1333.79,,
99924,1363576,14,1,13,1532.62,,
99925,1363585,12,2,10,1582.32,,
99926,1363586,9,1,8,1781.15,,
99929,010-13336-00,0,0,0,224.99,,
99931,1358350,16,7,9,1384.56,,1649.99
99932,1358355,24,10,14,1594.36,,1899.99
99933,1358356,0,0,0,1636.31,,1949.99
99934,1358380,0,0,0,1678.26,,1999.99
99935,1358381,13,6,7,1846.09,,2199.99
99936,1358385,3,1,2,1930.01,,2299.99
99937,1358382,20,13,7,1930.01,,2299.99
99938,1358386,4,3,1,2013.92,,2399.99
99939,1358383,0,0,0,2181.75,,2599.99
99940,1358310,2,2,0,2097.84,,2499.99
99941,1358315,1,0,1,2181.75,,2599.99
99942,1358311,8,5,3,2349.57,,2799.99
99943,1358316,1,1,0,2433.49,,2899.99
99944,1358200,17,5,12,2685.23,,3199.99
99945,1358210,4,4,0,2936.98,,3499.99
99946,1358201,24,14,10,2769.15,,3299.99
99947,1358211,6,2,4,3020.89,,3599.99
99948,1358202,4,4,0,3020.89,,3599.99
99949,1358212,4,3,1,3272.63,,3899.99
99950,1358975,0,0,0,2364.54,,2799.99
99951,1358970,0,0,0,2448.99,,2899.99
99952,1358976,30,19,11,2448.99,,2899.99
99953,1358971,2,1,1,2533.44,,2999.99
99954,1358945,2,0,2,2617.89,,3099.99
99955,1358940,1,0,1,2702.33,,3199.99
99956,1358540,5,1,4,3209.02,,3799.99
99957,1358541,3,0,3,3293.47,,3899.99
99958,1358542,0,0,0,3546.82,,4199.99
99959,1358501,4,4,0,3462.37,,4099.99
99960,1358502,0,0,0,3546.82,,4199.99
99961,1358503,0,0,0,3800.16,,4499.99
99962,1363770,7,0,7,2055.87,,2449.99
99963,1363771,8,0,8,2097.84,,2499.99
99964,1363785,4,0,4,2307.62,,2749.99
99965,1363786,7,0,7,2349.57,,2799.99
99966,1363787,11,7,4,2601.32,,3099.99
99967,1363790,15,0,15,2517.40,,2999.99
99968,1363791,11,5,6,2769.15,,3299.99
99969,1363900,22,16,6,3188.71,,3799.99
99970,1363901,14,6,8,3440.46,,4099.99
99971,1363902,17,10,7,3888.36,,4849.99
99972,1363903,7,4,3,4615.25,,5499.99
99973,1358560,18,0,18,3715.71,,4399.99
99974,1358580,9,4,5,3715.71,,4399.99
99975,1358561,17,17,0,3969.06,,4699.99
99976,1358581,3,0,3,3969.06,,4699.99
99977,1358562,6,2,4,4602.43,,5449.99
99978,1358582,1,1,0,4602.43,,5449.99
99979,1358563,0,0,0,5151.33,,6099.99
99980,1358583,0,0,0,5151.33,,6099.99
99981,1852077,2,2,0,25.41,,
99982,1852078,0,0,0,25.41,,
99983,1852079,5,2,3,25.41,,
99984,1852081,6,4,2,25.41,,
99985,1852082,0,0,0,25.41,,
99986,1865039,4,4,0,36.32,,
99987,1865040,2,0,2,36.32,,
99988,1866077,27,19,8,167.08,,
99989,1866081,13,5,8,167.08,,
99990,1866082,10,3,7,163.24,,
99991,151400-200-050-23,0,0,0,62.63,,
99992,88B515-1,9,4,5,1139.02,,
99993,1866078,4,2,2,163.24,,
99994,1866561,16,8,8,84.90,,
99995,1866655,11,7,4,217.93,,
99996,1866675,10,6,4,25.41,,
99997,1865130,11,6,5,62.58,,
100000,1854055,10,7,3,290.58,,
100003,1854056,8,2,6,290.58,,
100004,1854057,6,0,6,363.22,,
100005,1854058,7,1,6,195.58,,
100006,1854062,48,18,30,167.08,,
100007,1862042,12,6,6,140.81,,
100008,1862052,14,12,2,156.46,,
100009,1854064,3,0,3,167.08,,
100010,1862060,38,0,38,58.11,,
100011,1854070,1,0,1,72.64,,
100012,1854071,0,0,0,72.64,,
100013,1854072,2,0,2,72.64,,
100014,1854073,7,3,4,72.64,,
100015,1854074,2,2,0,72.64,,
100016,010-12832-55,23,9,14,74.99,,
100017,010-12832-60,24,8,16,89.99,,
100018,010-12832-61,0,0,0,89.99,,
100019,010-12832-70,19,9,10,97.49,,
100025,SEA2380,10,0,10,26.25,,
100028,LRS-2-DP,0,0,0,10.75,,
100029,32287,7,7,0,58.81,,99.95
100030,76174,27,17,10,58.81,,99.95
100031,87154,18,10,8,58.81,,99.95
100032,19243,12,9,3,58.81,,99.95
100036,SS16,0,0,0,16.07,,
100037,SS32,67,33,34,24.43,,
100038,GBC16,68,34,34,16.07,,
100039,GBC32,60,25,35,25.71,,
100041,C2113-14-00600,0,0,0,634.60,,
100042,ORI242440140,6,3,3,174.32,,215.05
100043,010-12163-03,0,0,0,29.98,,
100045,PMP122305110,13,5,8,835.80,,1184.05
100049,HP24,0,0,0,35.00,,
100050,010-02867-00,2,2,0,299.99,,
100051,010-02867-01,5,2,3,299.99,,
100052,010-02867-02,3,2,1,299.99,,
100055,19052P,13,9,4,46.44,,
100056,19053P,8,5,3,41.59,,
100057,41290P,10,10,0,19.84,,
100058,41291P,2,2,0,19.84,,
100059,41320P,6,4,2,14.85,,
100060,41321P,6,2,4,14.85,,
100061,41322P,5,3,2,50.38,,
100062,41323P,8,4,4,59.74,,
100063,41339P,10,6,4,9.63,,
100064,41343P,1,0,1,51.64,,
100065,41346P,8,4,4,15.19,,
100066,41347P,4,0,4,15.19,,
100067,41360P,0,0,0,9.63,,
100068,KITOBDBR-03',0,0,0,110.37,,
100073,JTV3223DCS,17,10,7,337.23,,
100074,MI-0065-AS,0,0,0,220.68,,
100075,05-01-071,2,1,1,201.14,,
100076,05-01-072,2,1,1,201.14,,
100077,05-01-073,1,1,0,164.13,,
100078,05-01-074,1,1,0,174.85,,
100079,05-93-071,0,0,0,107.07,,
100081,41365P,6,4,2,37.71,,
100082,41373P,2,2,0,19.24,,
100083,41388P,0,0,0,45.56,,
100084,41389P,6,0,6,69.86,,
100085,41416P,2,0,2,48.10,,
100086,41440P,6,2,4,47.09,,
100087,41445P,4,0,4,36.20,,
100088,41461P,4,3,1,24.05,,
100089,FBD-2-R,0,0,0,462.50,,
100090,VP1139,7,3,4,15.40,,
100091,SC-MULTI-F1,17,10,7,43.85,,
100092,SC-MULTI-F2,2,0,2,41.04,,
100093,SC-USB-F3,0,0,0,34.29,,
100105,BP5012,3,1,2,71.26,,
100109,33084W,0,0,0,57.76,,
100110,33086W,2,0,2,71.19,,
100113,41462P,9,4,5,24.05,,
100114,41480P,7,2,5,32.91,,
100115,41590P,19,4,15,34.94,,
100116,41593P,29,25,4,184.79,,
100117,41598P,6,2,4,45.06,,
100118,41640P,0,0,0,8.61,,
100119,41641P,4,2,2,8.61,,
100120,41644P,13,9,4,12.15,,
100121,41645P,8,4,4,12.15,,
100122,41650P,8,4,4,17.98,,
100123,41651P,10,0,10,26.33,,
100125,41652P,10,2,8,29.88,,
100126,41741P,5,4,1,22.79,,
100127,41746P,4,0,4,23.29,,
100128,10014P,11,0,11,12.38,,
100129,10029P,5,3,2,12.38,,
100130,10180P,6,3,3,82.53,,
100131,QUA242305130,3,1,2,1175.43,,1450.10
100132,QUA122305130,0,0,0,1175.43,,1450.10
100133,AT22-BK,0,0,0,26.37,36.99,
100135,10182P,4,2,2,84.55,,
100136,10187P,1,1,0,68.35,,
100137,10262P,4,2,2,12.38,,
100138,10401P,4,2,2,56.70,,
100139,10474P,4,2,2,124.54,,
100141,10500P,9,4,5,87.08,,
100142,10617P,7,2,5,82.53,,
100148,04-04-013,4,2,2,172.97,,
100149,04-04-014,0,0,0,172.97,,
100154,12104P,10,0,10,14.06,,
100155,12124P,2,2,0,103.28,,
100157,12127,6,3,3,121.00,,
100158,12131,3,2,1,102.26,,
100159,12134,1,1,0,103.79,,
100160,16000,4,2,2,274.39,,
100161,16114,6,6,0,507.26,,
100162,16201,6,4,2,104.29,,
100163,RODE57,0,0,0,411.60,,
100166,30250,20,11,9,48.02,,
100167,1124DP2CHR,0,0,0,81.61,,
100168,12738/30X8HOT,0,0,0,219.51,,
100169,12729-L,0,0,0,11.25,,
100170,12729-S,0,0,0,11.25,,
100174,2146,2,2,0,19.11,27.95,
100179,16216,2,1,1,210.60,,
100180,74125,4,2,2,60.75,,
100181,10050P,6,0,6,53.16,,
100182,10055P,0,0,0,61.26,,
100183,10056P,4,2,2,43.54,,
100184,10172P,3,1,2,73.41,,
100185,10175P,7,3,4,66.83,,
100186,10191P,7,2,5,59.74,,
100187,10196P,7,3,4,32.40,,
100188,10410P,3,2,1,128.09,,
100189,10422P,5,3,2,117.96,,
100190,12106P,5,0,5,65.81,,
100191,12107P,6,2,4,40.00,,
100192,46011P,4,2,2,225.79,,
100193,10201,4,2,2,78.48,,
100194,10202,1,0,1,72.40,,
100195,10241,4,2,2,102.26,,
100196,10242,2,0,2,79.99,,
100197,10280,4,2,2,78.48,,
100198,10281,3,2,1,68.85,,
100199,10923,4,2,2,58.23,,
100200,10924,4,2,2,55.19,,
100201,10306P,9,5,4,16.20,,
100202,19006P,3,1,2,19.24,,
100203,99215,3,2,1,251.16,,
100204,99225,2,1,1,323.60,,
100205,99030,4,2,2,519.54,,
100206,99050,3,1,2,605.04,,
100207,99501,4,1,3,1030.16,,
100208,99041,4,2,2,650.16,,
100209,99503,3,0,3,1005.23,,
100210,99505,4,1,3,1393.54,,
100211,99504,6,1,5,1754.54,,
100212,3100531-L1,0,0,0,58.54,,
100265,21405HP,48,0,48,16.67,,
100300,325123-1,11,6,5,6.71,,
100301,325166-1,16,8,8,6.15,,
100302,422737-3,2,1,1,123.00,,
100303,423037-1,0,0,0,25.71,,
100304,426510-1,1,1,0,12.49,,
100305,426535-1,20,10,10,18.50,,
100307,426692-3,23,20,3,21.67,,
100308,426693-3,0,0,0,20.61,,
100309,672560-1,0,0,0,10.87,,
100314,00.01CRD,2,0,2,10.12,,
100315,00.03CRD,2,0,2,9.51,,
100316,00.05CRD,2,0,2,9.51,,
100317,00.07CRD,2,0,2,12.48,,
100318,200-5156,7,7,0,69.07,,99.99
100320,100-4869,6,6,0,359.76,,429.99
100321,100-4883,4,4,0,388.89,,499.99
100322,100-4838,5,5,0,252.94,,299.99
100323,200-5170,2,2,0,429.41,,499.99
100324,200-5163,2,2,0,879.76,,999.99
100325,200-7533,1,1,0,1144.05,,1299.99
100328,3437,2,1,1,331.59,,
100329,3436,2,0,2,404.73,,
100330,3434,2,1,1,343.71,,
100331,3431,3,2,1,329.99,,
100332,77040000,2,2,0,6.53,,
100408,00.08CRD,2,0,2,15.21,,
100411,00.11CRD,2,0,2,16.19,,
100416,00.13CRD,2,0,2,21.08,,
100418,00.21CRD,2,0,2,21.89,,
100424,00.23CRD,2,0,2,26.67,,
100426,00.25CRD,2,0,2,31.27,,
100427,00.31CRD,2,0,2,31.01,,
100430,00.32CRD,2,0,2,33.20,,
100431,00.35CRD,2,0,2,37.13,,
100433,02.01CRD,2,0,2,9.61,,
100436,04.59CRD,2,0,2,6.49,,
100438,04.61CRD,0,0,0,5.17,,
100440,05.23CRD,2,0,2,3.71,,
100441,05.24CRD,2,0,2,6.12,,
100442,05.31CRD,2,0,2,4.07,,
100443,05.96CRD,0,0,0,4.09,,
100444,08.05CRD,0,0,0,36.57,,
100445,16.05CRD,2,0,2,14.19,,
100446,16.17CRD,2,0,2,16.73,,
100447,18.14CRD,2,0,2,35.35,,
100448,19.27,2,0,2,54.60,,
100449,23.00CRD,2,0,2,16.29,,
100450,23.04CRD,2,0,2,35.87,,
100451,23.08CRD,2,0,2,22.89,,
100452,23.13CRD,2,0,2,16.19,,
100453,23.14CRD,2,0,2,11.85,,
100454,23.35,2,0,2,137.41,,
100455,23.72,0,0,0,91.21,,
100456,25.05CRD,0,0,0,7.25,,
100457,25.07CRD,2,0,2,9.27,,
100458,25.15CRD,0,0,0,6.07,,
100459,25.17CRD,2,0,2,4.49,,
100460,25.18CRD,2,0,2,4.49,,
100462,25.42CRD,2,0,2,15.87,,
100463,36.05.25CRD,2,0,2,22.39,,
100464,36.05.40CRD,2,0,2,22.39,,
100465,36.06.40CRD,2,0,2,24.17,,
100466,36.06.50CRD,2,0,2,24.17,,
100467,36.06.70CRD,2,0,2,24.41,,
100468,36.08.20CRD,2,0,2,24.76,,
100469,36.08.30CRD,2,0,2,24.76,,
100470,36.08.40CRD,2,0,2,24.76,,
100471,36.08.50CRD,2,0,2,25.07,,
100472,36.08.60CRD,2,0,2,25.07,,
100473,36.08.70CRD,2,0,2,25.07,,
100474,36.08.80CRD,2,0,2,25.33,,
100475,SS3,2,0,2,7.36,,
100476,SS4,2,0,2,10.61,,
100477,SS5,2,0,2,15.37,,
100478,SS6,2,0,2,20.00,,
100479,07.90RG,0,0,0,21.95,,
100480,GSM100200400,2,0,2,179.83,,221.85
100481,GSM900200100,5,2,3,24.11,,29.75
100482,GSM900100400,6,3,3,24.11,,29.75
100486,660-450CC,1,1,0,230.63,,
100494,SC-12V-F1,18,10,8,14.06,,
100557,MV325003-268-0-216,7,3,4,47.51,,69.99
100558,MV356002-268-0-216,8,6,2,47.51,,69.99
100559,041115-1,0,0,0,23.26,,
100560,041125-1,0,0,0,23.26,,
100561,041135-1,0,0,0,24.84,,
100562,041136-1,0,0,0,38.61,,
100563,426501,17,10,7,2.82,,
100564,46200-0002,6,4,2,15.73,,
100566,30705,24,12,12,17.79,20.79,
100569,200-4845,2,2,0,466.67,,599.99
100570,25.20,0,0,0,21.95,,
100571,426504-1,10,5,5,22.20,,
100572,421616-1,9,5,4,21.14,,
100573,421618-1,0,0,0,13.20,,
100574,421636-1,9,4,5,20.09,,
100575,426013-1,16,6,10,6.21,,
100576,426053-1,20,10,10,12.14,,
100577,426115-1,13,5,8,6.21,,
100578,426127-1,9,4,5,5.54,,
100579,426531-1,0,0,0,18.50,,
100580,426106-1,9,5,4,2.51,,
100581,426101-1,8,3,5,3.67,,
100582,426103-1,9,4,5,6.49,,
100583,426104-1,10,5,5,6.49,,
100597,WDV-1-DP,13,7,6,27.47,,
100598,WDV-1CP-DP,17,4,13,28.99,,
100599,FS-T01-S-R,0,0,0,93.75,,
100601,DST810-BV-N2,0,0,0,404.83,,
100613,2000032831,0,0,0,278.62,319.99,
100614,ZDIGVEKVT,3,2,1,157.46,,
100615,ZDIGISSBM100,2,1,1,299.96,,
100617,589801,0,0,0,30.54,,
100619,589805,0,0,0,92.41,,
100620,589803,0,0,0,51.44,,
100629,RS4,2,0,2,276.05,,
100635,QUAD-NOD-BK,1,0,1,52.74,72.99,
100636,3000004257,2,0,2,79.69,,
100637,30605,8,4,4,248.99,305.00,
100638,30805,8,4,4,296.58,365.00,
100639,31008,5,4,1,479.10,590.00,
100640,31010,4,2,2,536.19,660.00,
100641,38805,6,3,3,435.74,535.00,
100642,38810,6,2,4,670.34,825.00,
100643,38081,1,0,1,337.31,500.00,
100644,38080,7,3,4,518.94,640.00,
100645,38100,5,2,3,651.31,800.00,
100646,38150,8,4,4,493.94,610.00,
100647,38180,4,2,2,656.94,810.00,
100648,36108,1,1,0,596.58,735.00,
100649,38175,4,2,2,680.34,835.00,
100651,36194,0,0,0,323.98,400.00,
100652,34120,0,0,0,291.51,340.00,
100654,35125,0,0,0,321.34,395.00,
100655,35596,3,2,1,273.85,335.00,
100658,36134,0,0,0,380.59,470.00,
100659,36116,0,0,0,405.58,500.00,
100660,35180,0,0,0,670.41,825.00,
100662,35000,0,0,0,37.08,55.00,
100663,35005,0,0,0,57.14,85.00,
100664,35123,6,6,0,10.95,15.00,
100665,35990,12,6,6,15.34,20.00,
100666,35995,0,0,0,19.13,30.00,
100667,36124,5,5,0,11.24,20.00,
100668,44224,4,2,2,145.43,180.00,
100669,46018,4,2,2,124.61,155.00,
100670,40331,0,0,0,10.98,20.00,
100671,33248,1,0,1,154.31,225.00,
100672,33424,3,2,1,123.01,160.00,
100673,33250,1,1,0,172.66,250.00,
100675,19133,0,0,0,73.98,110.00,
100676,19135,0,0,0,34.25,50.00,
100677,19105AC,0,0,0,9.23,15.00,
100678,19120AC,0,0,0,12.33,20.00,
100679,19125AC,9,4,5,16.28,25.00,
100680,19150,6,2,4,12.44,20.00,
100681,19170,7,3,4,124.41,180.00,
100682,19177,0,0,0,92.44,135.00,
100683,19200,5,3,2,30.51,45.00,
100684,19000AC,0,0,0,18.93,30.00,
100685,20087,12,6,6,8.23,15.00,
100686,20088,11,5,6,8.23,15.00,
100687,30002,0,0,0,6.58,10.00,
100688,39954020,1,1,0,573.11,,
100690,411920-1,34,34,0,477.05,,
100691,411930-1,5,5,0,650.53,,
100693,411950-1CHO,0,0,0,1151.76,,1299.99
100694,411950-1,18,18,0,1417.55,,1599.99
100695,411960-1CHO,0,0,0,1594.75,,1799.99
100696,411960-1,0,0,0,1860.54,,2099.99
100697,411970-1CHO,3,3,0,2126.33,,2399.99
100698,411970-1,8,7,1,2392.13,,2699.99
100708,29615,0,0,0,434.56,535.00,
100709,29625,0,0,0,530.61,655.00,
100710,29635,2,1,1,406.81,500.00,
100713,29750,0,0,0,597.86,850.00,
100725,010-02706-20,0,0,0,959.99,,1199.99
100726,ARG-1001-C,1,1,0,80.56,,
100727,29900,0,0,0,130.89,160.00,
100728,29601,0,0,0,43.94,65.00,
100729,29501,0,0,0,33.19,50.00,
100730,29504,0,0,0,34.56,50.00,
100731,29901,0,0,0,13.11,20.00,
100732,31400,0,0,0,136.81,170.00,
100733,31600,0,0,0,177.99,220.00,
100734,30201,0,0,0,44.01,65.00,
100735,30300,0,0,0,47.18,70.00,
100736,30301,0,0,0,59.11,85.00,
100737,30400,0,0,0,69.55,100.00,
100738,30401,0,0,0,78.13,115.00,
100739,30800,0,0,0,93.66,135.00,
100740,29250,0,0,0,19.15,30.00,
100741,29251,0,0,0,32.50,45.00,
100742,29350,0,0,0,27.04,40.00,
100743,29351,0,0,0,38.08,55.00,
100744,30050,0,0,0,49.81,70.00,
100745,19510,4,0,4,19.59,30.00,
100746,19500,0,0,0,10.36,20.00,
100747,22301,0,0,0,181.09,220.00,
100748,22302,0,0,0,180.36,220.00,
100749,22005,0,0,0,59.13,85.00,
100750,22202,0,0,0,98.46,145.00,
100751,19671,0,0,0,107.18,155.00,
100752,17004,0,0,0,89.34,130.00,
100753,17006,0,0,0,114.55,165.00,
100754,17001,0,0,0,21.69,30.00,
100755,17002,0,0,0,40.34,60.00,
100756,17003,0,0,0,64.23,95.00,
100757,17031ST,2,2,0,16.13,25.00,
100758,17035ST,0,0,0,19.03,30.00,
100759,17075ST,0,0,0,36.89,55.00,
100760,16154,0,0,0,40.38,60.00,
100761,17021ST,4,0,4,9.39,15.00,
100762,17039,0,0,0,11.65,20.00,
100763,17048,4,0,4,14.38,20.00,
100764,17139,5,0,5,11.65,20.00,
100765,17148,0,0,0,14.38,20.00,
100766,15000,6,2,4,19.94,30.00,
100767,15601,0,0,0,22.06,30.00,
100768,15602,2,0,2,29.63,45.00,
100769,16152,0,0,0,49.78,70.00,
100770,16156,0,0,0,26.83,40.00,
100771,17016,0,0,0,10.25,20.00,
100772,15030R,0,0,0,59.46,85.00,
100773,15120DC,2,2,0,32.44,45.00,
100774,15135HR,0,0,0,118.05,160.00,
100776,15181SF,0,0,0,52.05,75.00,
100777,15184SF,0,0,0,51.48,75.00,
100778,15185SF,0,0,0,11.50,20.00,
100779,16000DC,0,0,0,40.60,60.00,
100780,16141SF,0,0,0,40.66,60.00,
100781,16145SF,4,0,4,9.73,15.00,
100782,16151SF,5,0,5,21.55,30.00,
100783,16140SF,0,0,0,30.10,45.00,
100784,673ST-KIT,0,0,0,53.25,,
100792,JTV2423DCS,7,3,4,331.20,,
100795,SP212-K,0,0,0,436.35,,
100796,SP212-H,0,0,0,363.62,,
100797,BSA6,1,1,0,15.00,,
100798,GPT12,10,10,0,30.00,,
100806,WVSXP70,5,2,3,374.88,431.90,
100807,WVSXS70,0,0,0,374.88,431.90,
100808,WVSXP43,1,1,0,312.38,359.90,
100809,WVSXS43,1,1,0,312.38,359.90,
100811,167-15,1,0,1,19.33,,
100812,167-25,4,2,2,23.00,,
100813,167-50,4,2,2,32.07,,
100815,38045-4192RSP,1,0,1,695.88,,
100816,38045-4194RSP,0,0,0,695.88,,
100817,38245-4192RSP,1,0,1,695.88,,
100818,38245-4194RSP,0,0,0,695.88,,
100819,99901,74,20,54,45.43,,
100820,99880,9,0,9,12.18,,
100821,99855,2,0,2,13.80,,
100822,0131,0,0,0,59.81,,
100823,0134,9,4,5,28.19,,
100824,0139,0,0,0,35.13,,
100825,TRL-345-S/S,4,1,3,65.23,,
100826,400-222,0,0,0,183.20,,233.58
100827,TRL-3545-S/S,5,2,3,73.43,,
100828,TRL-445-S/S,2,2,0,69.61,,
100829,TRL-545-S/S,2,2,0,85.83,,
100830,TRL-645-S/S,4,2,2,85.57,,
100831,SBH-49,1,1,0,15.00,,
100832,TRL-845-S/S,2,2,0,176.36,,
100833,TRL-390-S/S,2,2,0,58.89,,
100834,TRL-490-S/S,5,3,2,86.16,,
100835,TRL-690-S/S,0,0,0,91.34,,
100836,SHB-110,3,2,1,18.75,,
100837,1420-0011,2,2,0,207.54,,
100838,SAD-27B,2,1,1,13.50,,
100839,1420-0017,2,2,0,201.70,,
100840,1420-0022,2,2,0,211.84,,
100841,TMPROANGLER,21,16,5,294.87,,
100842,TMPROANGLERREM,4,2,2,126.60,,
100845,720-1000,0,0,0,7.30,,
100846,720-1120,0,0,0,7.59,,
100848,720-2000,0,0,0,7.79,,
100849,720-2120,0,0,0,8.34,,
100850,720-3000,0,0,0,9.49,,
100851,XHEAT-400,0,0,0,273.81,369.00,
100852,720-3120,0,0,0,9.71,,
100853,XXHEAT-600,0,0,0,312.55,419.00,
100854,720-4000,0,0,0,9.94,,
100855,XXXHEAT-800,0,0,0,351.19,469.00,
100856,720-4000L,0,0,0,9.97,,
100857,720-5000,0,0,0,10.40,,
100858,720-5000L,0,0,0,10.53,,
100859,XTRCAB,0,0,0,105.05,129.00,
100860,720-6000,0,0,0,10.66,,
100861,720-6000L,0,0,0,10.79,,
100862,720-8000,0,0,0,11.06,,
100863,720-8000L,0,0,0,11.44,,
100864,02-45M-314,0,0,0,390.63,500.00,
100872,587329,5,0,5,56.87,,
100874,SRT/PHT-AC-PWR,0,0,0,37.50,,
100875,88B515-2,0,0,0,1189.02,,
100876,8WD15,6,0,6,27.44,,
100877,8WD2000-2,1,0,1,41.72,,
100878,8WD14,1,0,1,47.21,,
100879,8WD7SQR,0,0,0,26.89,,
100880,8WD2000-1,5,0,5,25.28,,
100881,8WD3003,3,0,3,113.48,,
100882,8WD3002,3,0,3,124.33,,
100885,XTRAD-011,0,0,0,24.44,29.00,
100886,XTRAD-012,0,0,0,24.44,29.00,
100887,XTRAD-013,0,0,0,27.40,34.00,
100888,8WD2002,6,0,6,118.40,,
100889,8WP95,4,0,4,44.04,,
100890,8WD7S,0,0,0,11.45,,
100891,8WD112BP-717,1,0,1,24.95,,
100892,8WD112BP-720,2,0,2,24.95,,
100893,8WD1251,5,0,5,24.96,,
100895,XTRFS,7,7,0,9.59,14.99,
100898,30111,1,0,1,4.66,,
100899,652009,0,0,0,13.24,,
100900,8WD1500,4,0,4,97.33,,
100901,8WD2000,5,0,5,81.09,,
100902,8WD2003,12,0,12,108.08,,
100906,8WD1250,4,0,4,33.64,,
100907,8WD112BP-710,2,0,2,24.95,,
100908,8WD3000,4,0,4,89.20,,
100909,8WD112BP-728,2,0,2,25.24,,
100910,8WD112BP-731,0,0,0,25.24,,
100911,8WD112BP-733,1,0,1,25.24,,
100912,8WD135LS-717,6,0,6,102.17,,
100913,8WD734PLS-664,6,0,6,59.73,,
100914,8WD640PLS-664,1,0,1,103.00,,
100915,8WD640PLS-660,2,0,2,103.00,,
100916,8WD3000-2,5,0,5,43.80,,
100917,3313-710,6,0,6,57.61,,
100918,8WD588PLS-710,6,0,6,76.92,,
100919,3313-717,4,0,4,57.61,,
100920,8WD944,4,0,4,161.01,,
100921,8WP144,6,0,6,301.35,,
100922,8WD374,6,0,6,92.89,,
100927,PP4400-17,0,0,0,269.08,,
100928,202053,12,8,4,187.50,299.99,
100929,682053,0,0,0,187.50,299.99,
100930,682153,4,4,0,187.50,299.99,
100931,322053,6,2,4,281.25,449.99,
100932,210053,2,2,0,206.25,329.99,
100933,220053,0,0,0,312.50,499.99,
100934,230053,2,2,0,406.25,649.99,
100935,240053,0,0,0,468.75,749.99,
100936,250053,0,0,0,593.75,949.99,
100937,320053,2,0,2,500.00,799.99,
100938,330053,2,0,2,625.00,999.99,
100939,340053,2,2,0,812.50,1299.99,
100940,350053,2,0,2,937.50,1499.99,
100965,PIN482122500,4,0,4,262.92,,334.05
100985,"G-1-CLASSIC REDWO",0,0,0,13.46,,
100988,"G-2-CLASSIC REDWO",0,0,0,15.73,,
100989,"G-3-CLASSIC REDWO",0,0,0,18.94,,
100991,"G-4-CLASSIC REDWO",0,0,0,28.71,,
100994,"G-5-CLASSIC REDWO",0,0,0,55.39,,
100996,"G-6-CLASSIC REDWO",0,0,0,73.13,,
101024,151400-200-070-23,5,5,0,62.63,,
101025,LLB-63BB-F0-01,0,0,0,43.90,,
101026,LLB-63RB-E0-01,2,2,0,38.99,,
101028,426105-1,10,5,5,2.64,,
101029,N20803S,0,0,0,146.48,,
101030,N20803W,8,4,4,138.87,,
101061,97-49,0,0,0,18.44,,
101072,P000110,3,3,0,32.14,,
101073,PLASE604,0,0,0,32.14,,
101074,651010,0,0,0,16.19,,
101075,PLABI360,0,0,0,69.22,,
101089,WUL12GN-25,8,4,4,7.63,,
101090,SXR08EC,3,3,0,9.04,,
101091,SXR08PRCH,1,1,0,9.04,,
101092,SXR10EC,2,2,0,9.04,,
101093,SXR10PRCH,1,1,0,9.04,,
101094,SXR12EC,3,3,0,12.08,,
101095,SXR12PRCH,1,1,0,12.08,,
101096,SXR14EC,1,1,0,13.59,,
101097,SXR14PRCH,1,1,0,13.59,,
101098,SXRL12HPU,2,2,0,13.59,,
101099,SXRL14HPU,3,3,0,13.59,,
101100,XRMAGXT160HDBSRD,3,3,0,17.46,,
101101,XRMAGXT160HDD,2,2,0,17.46,,
101102,XRMAGXT160HDWHU,3,3,0,17.46,,
101103,SXRT10EC,3,3,0,9.13,,
101104,SXRT10PRCH,0,0,0,9.13,,
101105,SXRTM06EC,1,1,0,9.13,,
101106,SXRTM06HP,3,3,0,9.13,,
101107,SXRTM06PRCH,3,3,0,9.13,,
101108,SXRTM08EC,2,2,0,9.13,,
101109,SXRTM08HP,2,2,0,9.13,,
101110,SXRTM08PRCH,1,1,0,9.13,,
101111,RSRS,3,3,0,13.46,,
101112,RTT3600,11,11,0,8.09,,
101113,RTT3600OF,7,7,0,8.09,,
101114,RTT3700,18,18,0,10.11,,
101115,RTT3700D,20,20,0,13.46,,
101116,RTT3700DO,3,3,0,13.46,,
101117,KSJ120SPZ,0,0,0,12.03,,
101118,KSJ120UVCGZ,4,4,0,12.03,,
101119,KSJ120UVGSZ,4,4,0,12.03,,
101120,KSJ120UVSI,5,5,0,12.03,,
101121,KSJ170SPZ,4,4,0,13.00,,
101122,KSJ170UVCGZ,4,4,0,13.00,,
101123,KSJ170UVGSZ,4,4,0,13.00,,
101124,KSJ170UVSI,4,4,0,13.00,,
101125,KSJ220SPZ,2,2,0,13.70,,
101126,KSJ220UVCGZ,4,4,0,13.70,,
101127,KSJ220UVGSZ,4,4,0,13.70,,
101128,KSJ220UVSI,4,4,0,13.70,,
101129,KSJ280SPZ,3,3,0,14.38,,
101130,KSJ280UVCGZ,4,4,0,14.38,,
101131,KSJ280UVGSZ,4,4,0,14.38,,
101132,KSJ280UVSI,3,3,0,14.38,,
101133,KKJ150AJI,0,0,0,11.33,,
101134,KKJ150BPB,4,4,0,11.33,,
101135,KKJ150SPP,4,4,0,11.33,,
101136,KKJ150UVSB,2,2,0,11.33,,
101137,KKJ200AJI,4,4,0,12.55,,
101138,KKJ200BPB,3,3,0,12.55,,
101139,KKJ200SPP,4,4,0,12.55,,
101140,KKJ200UVSB,4,4,0,12.55,,
101141,VSJ150BLK,4,4,0,12.93,,
101142,VSJ150BLKPRPL,4,4,0,12.93,,
101143,VSJ150BM,4,4,0,12.93,,
101144,VSJ150SRD,4,4,0,12.93,,
101145,VSJ200BLK,4,4,0,15.04,,
101146,VSJ200BLKPRPL,4,4,0,15.04,,
101147,VSJ200BM,2,2,0,15.04,,
101148,VSJ200SRD,4,4,0,15.04,,
101149,VSJ300BLK,4,4,0,19.30,,
101150,VSJ300BM,4,4,0,19.30,,
101152,"CLASS T-200",1,1,0,26.59,38.30,
101153,"CLASS T-400",0,0,0,97.50,140.70,
101154,SBC-2-DC,0,0,0,43.98,63.50,
101155,MSK-20A,1,1,0,59.09,85.30,
101159,JLC-11,2,0,2,305.04,392.70,
101160,001-266-020-00,1,1,0,204.44,,
101175,B00005302,4,2,2,27.99,36.89,
101176,B00006302,3,2,1,27.99,36.89,
101177,05-01-046,0,0,0,168.58,,
101180,69933,0,0,0,23.32,,
101182,300-114G2-PRO-I,0,0,0,939.03,,1197.26
101184,300-138-PRO-I,0,0,0,2382.35,,3037.50
101185,301-108ST-PRO-I,0,0,0,1493.92,,1904.74
101186,301-109ST-PRO-I,0,0,0,1493.92,,1904.74
101187,300-112G2-PRO-I,0,0,0,939.03,,1197.26
101194,X-23BU,2,1,1,46.60,,
101198,MU0225NVC-F,0,0,0,868.75,,
101215,2022002187,1,0,1,225.29,,
101216,2021013744,0,0,0,225.29,,
101217,2022002186,2,0,2,225.29,,
101218,2022002189,2,0,2,225.29,,
101223,X-23BB,2,1,1,46.60,,
101224,X-23WW,3,1,2,46.60,,
101226,E2002B,2,0,2,792.00,,
101227,E2002W,2,0,2,792.00,,
101228,E2009B,2,0,2,792.00,,
101229,E2009W,2,0,2,792.00,,
101230,46-465,2,0,2,82.30,,
101231,46-465-5,2,0,2,37.16,,
101232,46-475,0,0,0,140.33,,
101233,46-475-5,1,0,1,59.80,,
101240,5058-12-00015,0,0,0,36.10,,
101241,5058-12-00025,6,6,0,41.80,,
101242,5058-16-00015,0,0,0,41.80,,
101243,5058-16-00025,6,6,0,54.15,,
101244,5058-16-00035,0,0,0,67.45,,
101251,5058-20-00015,0,0,0,54.15,,
101252,5058-20-00025,6,6,0,72.20,,
101253,5058-20-00035,0,0,0,95.00,,
101254,5058-24-00025,6,6,0,103.55,,
101255,5058-24-00035,0,0,0,126.35,,
101259,SL26-50-1,4,4,0,17.51,,
101260,411850-1,11,11,0,227.28,,
101261,411830-1,18,11,7,1064.18,,
101262,740222-1,0,0,0,1435.61,,1699.99
101263,740223-1,0,0,0,86.42,,
101264,740224-1,0,0,0,136.36,,
101265,720120-1,10,10,0,30.62,,
101266,T10-4000-1,0,0,0,388.97,,529.99
101267,T10-4000-2,0,0,0,391.47,,529.99
101272,04-03-015,0,0,0,151.52,,
101275,BP297,0,0,0,23.51,,
101278,CANVWRC,0,0,0,527.06,,
101279,5253-4,1,1,0,38.51,,
101280,5640-4,7,0,7,26.31,,
101281,5643-4,4,2,2,28.26,,
101282,5644-4,8,4,4,29.76,,
101288,5650-4,0,0,0,32.68,,
101289,5653-4,4,2,2,33.40,,
101290,5654-4,4,3,1,35.71,,
101291,5660-4,5,4,1,40.17,,
101292,5663-4,5,3,2,42.83,,
101293,5664-4,4,2,2,41.67,,
101295,SS75C-12-H-9N,0,0,0,717.90,,
101298,A80709,0,0,0,68.17,,
101299,A80753,0,0,0,85.22,,
101300,A80754,0,0,0,127.83,,
101301,A80710,2,2,0,37.49,,
101302,A80747,0,0,0,63.91,,
101303,A80711,0,0,0,120.82,,
101304,A80712,1,1,0,204.16,,
101305,A80713,0,0,0,154.16,,
101306,A80714,0,0,0,162.49,,
101307,A80715,0,0,0,245.82,,
101308,A80716,0,0,0,195.82,,
101311,R70529,2,2,0,76.69,,
101314,010-13142-00,0,0,0,26.24,,
101315,010-11425-15,0,0,0,22.49,,
101316,010-12528-11,16,8,8,14.99,,
101317,010-12528-30,11,0,11,26.24,,
101318,010-12528-31,25,0,25,37.49,,
101319,010-12528-12,0,0,0,262.49,,
101320,010-12528-20,0,0,0,37.49,,
101321,010-12531-02,26,6,20,22.49,,
101322,010-13210-00,0,0,0,22.49,,
101323,010-13210-01,0,0,0,26.24,,
101324,010-13210-02,0,0,0,29.98,,
101325,010-13210-03,0,0,0,33.74,,
101326,010-13209-00,0,0,0,97.49,,
101327,010-13209-01,0,0,0,104.99,,
101328,010-13209-02,0,0,0,112.49,,
101329,010-13209-03,0,0,0,119.99,,
101330,010-12390-12,2,0,2,14.99,,
101331,010-12390-13,4,2,2,14.99,,
101332,010-12390-22,2,0,2,52.49,,
101333,010-12390-14,1,0,1,14.99,,
101338,68880,0,0,0,108.63,,
101341,958340021,4,0,4,94.94,,
101342,WM1984B,2,2,0,66.61,,
101345,T10-4000-3,4,2,2,450.77,,579.99
101346,T10-4000-4,4,2,2,453.27,,579.99
101347,T10-4000-5,0,0,0,434.50,,579.99
101348,T10-4000-6,3,0,3,438.00,,579.99
101349,T10-4000-16,2,2,0,431.65,,579.99
101350,T10-4000-17,4,2,2,454.36,,579.99
101351,T10-4000-18,4,2,2,457.55,,579.99
101352,T10-4000-19,4,2,2,460.06,,579.99
101353,T10-4000-7,0,0,0,73.62,,
101354,T10-4000-8,0,0,0,49.00,,
101355,T10-4000-9,0,0,0,51.18,,
101356,T10-4000-15,0,0,0,69.18,,
101357,T10-4000-10,0,0,0,50.54,,
101358,T10-4000-11,0,0,0,51.79,,
101359,T10-4000-12,0,0,0,58.54,,
101360,T10-4000-13,0,0,0,69.28,,
101361,T10-4000-14,0,0,0,75.44,,
101367,IRID-GO-EXEC,0,0,0,2016.13,,
101368,IRID-GO-EXEC-INST-K,0,0,0,727.99,,
101370,MR500UAB,6,6,0,49.94,,
101371,MCBK634B.64,0,0,0,91.66,,
101373,MCK500WB.6,0,0,0,72.22,,
101376,MG150T.4,0,0,0,123.04,,
101377,MG150W.6,0,0,0,83.28,,
101378,MG250W.64,2,0,2,127.72,,
101379,MGR150B,0,0,0,55.50,,
101380,MGR250B,8,8,0,72.17,,
101381,BVCP9700A-MR,0,0,0,199.44,349.99,
101382,UTV4BRGB,0,0,0,99.94,,
101420,0800017331,0,0,0,59.09,,
101427,9630,1,0,1,39.99,,
101428,816,0,0,0,59.21,,
101448,101832,3,3,0,145.52,,
101450,101833,3,1,2,151.55,,
101452,83001,4,2,2,12.34,16.50,
101454,1715,0,0,0,9.97,,14.98
101455,2431,0,0,0,17.34,,22.98
101456,2432,0,0,0,17.34,,22.98
101458,2451,0,0,0,18.51,,24.98
101459,2452,0,0,0,18.51,,24.98
101466,115,0,0,0,38.56,,48.98
101467,116,0,0,0,44.99,,58.98
101481,17721,21,11,10,12.67,,
101516,28512-24V,0,0,0,35.00,,
101522,0625DP0STS,0,0,0,81.61,,
101523,0626DP0STS,0,0,0,140.86,,
101524,0647DP0CHR,0,0,0,78.59,,
101525,0648DP0CHR,0,0,0,144.21,,
101527,IRID-DC-0901,0,0,0,45.56,,
101528,IRID-INT-PLUG,0,0,0,29.35,,
101529,1659DP0ALU,0,0,0,50.12,,
101530,1665DP6ALU,0,0,0,97.12,,
101531,1670DP0ALU,0,0,0,53.49,,
101532,1670DP2ALU,0,0,0,56.80,,
101534,1672DP0ALU,5,0,5,56.79,,
101535,0904DP0STS,0,0,0,57.38,,
101536,0945DP0STS,0,0,0,35.09,,
101537,31542310,0,0,0,423.23,,
101538,31542410,0,0,0,423.23,,
101539,31542510,0,0,0,423.23,,
101540,CA-SS15-LGR,4,2,2,172.53,,
101541,CA-SS30-LGR,6,2,4,172.53,,
101542,CA-SS00-LGR,0,0,0,172.53,,
101543,CA-SS00-SMF,2,2,0,120.37,,
101544,CA-SS15-SMF,0,0,0,120.37,,
101545,CA-SS30-SMF,1,1,0,120.37,,
101546,CA-SS00-LGF,4,2,2,140.43,,
101547,CA-SS15-LGF,4,2,2,140.43,,
101548,CA-SS30-LGF,3,2,1,140.43,,
101549,CA-SS00-SMR,4,2,2,152.47,,
101550,CA-SS15-SMR,6,2,4,152.47,,
101551,CA-SS30-SMR,2,0,2,152.47,,
101553,IRID-BAT-9555,0,0,0,88.89,,
101554,IRID-BAT-9575,0,0,0,89.13,,
101555,BCA1550-32,0,0,0,1653.94,,
101556,BCA1550W-12,0,0,0,2182.02,,
101557,BCA1550W-24,0,0,0,2182.02,,
101558,BCA1550W-32,0,0,0,2232.04,,
101559,BCA1550W-36,0,0,0,2232.04,,
101560,33111,22,12,10,20.78,,
101561,33112,24,12,12,21.43,,
101562,33114,23,12,11,23.12,,
101563,33116,23,12,11,24.68,,
101564,33118,21,12,9,26.23,,
101565,33120,22,12,10,27.92,,
101566,33122,24,12,12,29.48,,
101567,33124,24,12,12,31.04,,
101568,1363792,0,0,0,3272.63,,3899.99
101569,1363910,2,2,0,3046.54,,3799.99
101570,1363911,7,4,3,3287.06,,4099.99
101571,1363912,16,8,8,3888.36,,4849.99
101572,1363913,4,2,2,4409.47,,5499.99
101575,WR16/6-FT,170,170,0,2.06,,
101577,F16-0800C-1,0,0,0,77.62,,
101581,MD4041-268-0-202,3,1,2,97.49,,129.99
101582,MD4042-191-0-202,3,1,2,103.12,,149.99
101583,MD4042-268-0-202,0,0,0,103.12,,149.99
101584,MD4042-4-0-202,10,6,4,103.12,,149.99
101585,MD2020-191-0-202,5,2,3,140.41,,189.99
101586,MD2020-4-0-202,3,2,1,140.41,,189.99
101587,MD2030-191-0-202,7,6,1,122.51,,169.99
101588,MD2030-4-0-202,9,7,2,122.51,,169.99
101589,MD2030CM-261-0-202,7,4,3,122.51,,169.99
101590,MA4041-0-0-101,7,3,4,20.63,,
101591,MA2030-0-0-101,0,0,0,20.63,,
101592,MD3800-191-0-202,0,0,0,106.55,,154.99
101593,MD3800-193-0-202,0,0,0,106.55,,154.99
101594,MD3800-4-0-202,0,0,0,106.55,,154.99
101601,GNT-EVOLUTION-SM-IDP-HW-110ACPWROUT,4,2,2,3749.99,,
101602,GNT-EVOLUTION-SM-IDP-HW-OB,1,1,0,3749.99,,
101603,5004,10,6,4,15.66,,
101604,5005,17,12,5,15.66,,
101605,5006,20,10,10,15.66,,
101606,5014,25,10,15,15.66,,
101607,5015,15,11,4,15.66,,
101608,5017,19,11,8,15.66,,
101609,62-542-TR-WT-M,6,6,0,52.44,,
101610,EVO-30AB,0,0,0,82.95,119.70,
101612,010-C1354-30,0,0,0,149.99,,
101613,010-C1307-30,0,0,0,149.99,,
101630,BA2-25WHT,2,0,2,801.28,,
101631,BA2-25WHT-BLK,0,0,0,801.28,,
101632,BA225WHT-GRY,0,0,0,801.28,,
101633,BA2-25GRY-BLK,0,0,0,801.28,,
101634,BA1-25WHT,2,0,2,865.38,,
101635,BA1-25WHT-BLK,0,0,0,865.38,,
101636,BA1-25WHT-GRY,0,0,0,865.38,,
101638,BA1-25GRY-BLK,0,0,0,865.38,,
101640,010-C1459-30,1,0,1,74.99,,
101641,010-C1460-30,0,0,0,74.99,,
101642,010-C1461-30,3,0,3,74.99,,
101643,010-C1462-30,0,0,0,74.99,,
101644,010-C1459-40,0,0,0,112.49,,
101645,010-C1460-40,0,0,0,112.49,,
101646,010-C1461-40,0,0,0,112.49,,
101647,010-C1462-40,0,0,0,112.49,,
101648,6296,0,0,0,180.00,,
101649,6297,0,0,0,172.00,,
101650,3448,0,0,0,302.67,,
101651,3449,0,0,0,189.33,,
101652,3450,0,0,0,288.00,,
101653,3451,0,0,0,626.67,,
101654,3452,0,0,0,200.00,,
101655,3453,0,0,0,186.67,,
101656,3456,0,0,0,246.67,,
101657,6800,0,0,0,773.33,,
101661,T10-424,0,0,0,108.00,,
101662,HF25K,3,3,0,21.20,,
101663,HF50K,3,3,0,30.29,,
101664,HF75K,0,0,0,42.41,,
101667,WH100022,0,0,0,26.06,,
101668,A80732,0,0,0,806.44,,
101680,SC-AOB-A2,34,18,16,293.53,,
101681,PL40,0,0,0,6.67,9.99,
101682,PFC,0,0,0,14.00,20.99,
101683,ELC,0,0,0,18.67,27.99,
101684,CPL24,8,5,3,7.33,10.99,
101685,01-0055,1,0,1,10.00,14.99,
101686,BPL36B-H,0,0,0,10.67,15.99,
101687,01-0083,1,1,0,10.00,14.99,
101688,01-0082,0,0,0,10.00,14.99,
101689,AB1,6,4,2,16.67,24.99,
101690,AB3,6,2,4,18.67,27.99,
101691,ACK1,0,0,0,4.67,6.99,
101692,AK1,10,0,10,23.33,34.99,
101693,ZZCK1,6,1,5,6.00,8.99,
101694,01-0010-01B,8,3,5,11.33,16.99,
101696,DK1,0,0,0,12.67,18.99,
101697,DPK,0,0,0,6.67,9.99,
101698,HAND,7,1,6,8.67,12.99,
101699,HANDC,0,0,0,6.67,9.99,
101700,MPC,0,0,0,9.33,13.99,
101701,MPC34,0,0,0,6.67,9.99,
101702,SCUP4,12,6,6,8.67,12.99,
101703,01-0096,0,0,0,116.67,174.99,
101704,01-0062,4,0,4,156.67,234.99,
101705,01-0026-01,0,0,0,28.46,34.99,
101707,RF3-YK,6,4,2,7.33,10.99,
101708,01-9004-LG,0,0,0,22.00,32.99,
101709,01-9004-Y,4,2,2,22.00,32.99,
101710,01-9004-SO,0,0,0,22.00,32.99,
101711,TTAG-SNG,0,0,0,4.67,5.99,
101712,01-0129,0,0,0,23.33,34.99,
101713,TQL1,0,0,0,8.67,12.99,
101714,TDSTP1,5,0,5,9.33,13.99,
101715,ABB,1,0,1,8.67,12.99,
101716,PK1,0,0,0,10.67,15.99,
101717,DRIPK,0,0,0,3.33,4.99,
101741,PTS-0-1.5PSI-02,2,2,0,236.80,,
101742,BM3A01,15,0,15,99.00,,
101743,628009-001,1,0,1,6516.85,,
101744,628019-001,0,0,0,6590.91,,
101745,628002-001,0,0,0,9354.55,,
101746,628004-001,0,0,0,13936.36,,
101747,358-101-10,12,8,4,141.79,,
101751,114-887030,0,0,0,121.67,139.99,
101752,15600,1,0,1,568.75,,
101753,15610,2,0,2,337.50,,
101754,15630,2,0,2,318.75,,
101777,9059-1113-1,18,0,18,36.85,,
101778,9059-2113-1,13,0,13,36.85,,
101779,9059-2123-1,18,0,18,36.85,,
101780,9059-3113-1,14,0,14,36.85,,
101781,9059-3114-1,14,0,14,37.48,,
101787,104530SDP,0,0,0,28.00,,
101790,L006UCL040ABC,0,0,0,2294.44,,
101792,1064,44,0,44,29.67,,
101795,B00042502,0,0,0,208.83,241.19,
101811,49100M,0,0,0,32.33,,
101816,72-1048,3,0,3,2899.99,,
101817,72-1048-SV5,3,0,3,3193.99,,
101818,72-1048-SV10,3,0,3,3232.99,,
101819,72-1048-SV16,1,0,1,3263.99,,
101820,72-1048-SV24,0,0,0,3329.99,,
101821,72-1048-SV36,0,0,0,3399.99,,
101822,110213,0,0,0,276.66,453.19,
101824,37038-2012,6,0,6,117.21,,
101828,1710WB-14WB-KIT,0,0,0,566.43,,
101829,1810633/PAIR,1,0,1,3127.76,,4179.99
101830,1810632/PAIR,5,2,3,3127.76,,4179.99
101831,1810631/PAIR,0,0,0,3127.76,,4179.99
101832,1810630/PAIR,6,3,3,3127.76,,4179.99
101833,1810623/PAIR,3,0,3,2837.64,,3779.99
101834,1810622/PAIR,3,0,3,2837.64,,3779.99
101835,1810621/PAIR,3,0,3,2837.64,,3779.99
101836,1810620/PAIR,4,2,2,2837.68,,3779.99
101837,1810601/PAIR,0,0,0,2529.14,,3379.99
101838,1810600/PAIR,4,1,3,2529.14,,3379.99
101841,010-13352-00,0,0,0,22.49,,
101842,010-13352-01,0,0,0,22.49,,
101843,010-13352-02,0,0,0,149.99,,
101844,010-13353-03,0,0,0,149.99,,
101845,010-02316-20,5,1,4,273.74,,
101846,70200,0,0,0,22.86,,
101847,70305,0,0,0,7.79,,
101848,70205,0,0,0,6.63,,
101851,BPC900500014,15,7,8,32.38,,39.95
101852,BPC900520014,11,6,5,32.38,,39.95
101853,BPC120134124R,16,7,9,42.72,,52.70
101854,LYN020102010,17,8,9,137.80,,170.00
101855,LYN034170210,9,4,5,1012.83,,1249.50
101856,LYN060102010,13,12,1,188.79,,232.90
101857,CIP140325000,4,1,3,44.78,,55.25
101862,RA0458800,2,0,2,0.36,,
101863,69020,0,0,0,230.58,,
101865,MIL-RF9BL-UART,0,0,0,75.89,,
101870,016830001,8,4,4,424.05,,
101871,016831001,12,8,4,462.03,,
101872,958140511,4,2,2,259.49,,
101873,958140531,4,2,2,259.49,,
101875,996098501,0,0,0,63.29,,
101877,996098511,0,0,0,79.75,,
101878,6080.44,2,2,0,736.13,,
101879,6080.60,4,2,2,934.24,,
101880,6080.45,0,0,0,274.34,,
101881,6080.61,0,0,0,348.53,,
101882,6080.63,3,1,2,458.71,,
101883,4265.07K,1,1,0,264.04,,
101884,4265.07,0,0,0,247.09,,
101885,4265.08K,2,0,2,328.00,,
101886,4265.08,4,2,2,281.33,,
101890,43700,0,0,0,117.33,,
101891,43701,0,0,0,139.33,,
101892,43702,0,0,0,117.33,,
101893,43703,0,0,0,117.33,,
101894,43710,0,0,0,132.67,,
101895,43711,0,0,0,145.33,,
101896,43712,0,0,0,132.67,,
101897,43713,0,0,0,132.67,,
101899,WS20HD0200,0,0,0,42.19,,
101902,010-C1279-00,0,0,0,187.49,,
101903,010-C1270-00,8,8,0,187.49,,
101904,010-C1271-00,8,8,0,187.49,,
101905,010-C1272-00,8,8,0,187.49,,
101906,010-C1273-00,8,8,0,187.49,,
101907,010-C1274-00,8,8,0,187.49,,
101908,010-C1275-00,8,8,0,187.49,,
101909,010-C1276-00,8,8,0,187.49,,
101913,BE-HA-54380-DP,0,0,0,16.60,,
101916,151600-700-040-23,0,0,0,65.64,,
101924,9057-1113-1,0,0,0,31.85,,
101925,9057-2113-1,0,0,0,31.85,,
101926,9057-2123-1,0,0,0,31.85,,
101927,9057-3113-1,0,0,0,31.85,,
101928,9057-3114-1,0,0,0,32.48,,
102058,N09411,0,0,0,77.33,,
102059,N09421,0,0,0,112.00,,
102141,DS-LP-16-BLK,12,12,0,26.41,,
102142,DS-LP-16-S,12,6,6,32.04,,
102143,DS-LP-21A-BLK,7,4,3,30.91,,
102144,DS-LP-21A-S,9,8,1,37.10,,
102145,DS-LP-30-BLK,11,5,6,37.66,,
102146,DS-LP-30-S,11,5,6,43.85,,
102147,DS-LP-MULTI-BLK,12,8,4,63.00,,
102148,DS-LP-MULTI-S,3,3,0,79.88,,
102149,"A-1 GREY",0,0,0,40.26,,
102150,DS-LP-21B-BLK,7,1,6,30.91,,
102151,DS-LP-21B-S,14,6,8,37.10,,
102155,SSC-750,0,0,0,93.33,,
102156,SSC-1000,0,0,0,102.78,,
102157,SSC-1250,0,0,0,117.78,,
102158,SSC-1500,0,0,0,131.11,,
102159,SSC-2000,0,0,0,157.22,,
102160,SSC-2500,0,0,0,201.11,,
102161,BSA-750,0,0,0,118.33,,
102162,BSA-1000,0,0,0,127.78,,
102163,BSA-1250,0,0,0,148.89,,
102164,BSA-1500,0,0,0,161.67,,
102165,BSA-2000,0,0,0,348.89,,
102166,BSA-2500,0,0,0,390.56,,
102169,11072,0,0,0,70.64,,
102170,11073,0,0,0,88.30,,
102171,12072,0,0,0,122.75,,
102172,12073,0,0,0,152.28,,
102173,11132,0,0,0,99.45,,
102174,11133,0,0,0,129.19,,
102175,12132,0,0,0,204.23,,
102176,12133,0,0,0,295.86,,
102177,1066-12,17,8,9,154.73,,
102193,ORI121217040,0,0,0,265.95,,328.10
102194,BPC122531124,10,5,5,163.29,,201.45
102216,KITMD2,0,0,0,151.07,199.00,
102235,APT-150-SL-01,0,0,0,270.00,,
102236,SC-SL-01,0,0,0,174.38,,
102237,GOST-MAXLINK,0,0,0,1087.49,,
102238,LD2000,10,10,0,84.35,,
102241,LD4000,6,6,0,41.34,,
102242,LD4002,24,10,14,47.07,,
102244,E70670,0,0,0,708.32,,
102249,5540-020-1503,6,6,0,7.80,,
102250,5540-020-1507,6,6,0,7.80,,
102251,5540-020-2500,6,6,0,7.80,,
102252,5540-020-2501,6,6,0,7.80,,
102253,5540-020-2502,5,5,0,7.80,,
102254,5540-020-2503,1,1,0,7.80,,
102255,5540-030-1503,6,6,0,8.29,,
102256,5540-030-1507,6,6,0,8.29,,
102257,5540-030-2500,6,6,0,8.29,,
102258,5540-030-2501,6,6,0,8.29,,
102259,5540-030-2502,4,4,0,8.29,,
102260,5540-030-2503,0,0,0,8.29,,
102261,5560-030-2506,4,4,0,7.19,,
102262,5560-030-2507,4,4,0,7.19,,
102263,5560-030-2508,4,4,0,7.19,,
102264,5560-030-2509,6,6,0,7.19,,
102265,5560-030-2510,5,5,0,7.19,,
102266,5560-030-2511,5,5,0,7.19,,
102267,5560-000-2506,6,6,0,12.53,,
102268,5560-000-2507,4,4,0,12.53,,
102269,5560-000-2508,5,5,0,12.53,,
102270,5560-000-2509,5,5,0,12.53,,
102271,5560-000-2510,6,6,0,12.53,,
102272,5560-000-2511,5,5,0,12.53,,
102273,5560-001-2506,2,2,0,13.98,,
102274,5560-001-2507,1,1,0,13.98,,
102275,5560-001-2508,2,2,0,13.98,,
102276,5560-001-2509,3,3,0,13.98,,
102277,5560-001-2510,3,3,0,13.98,,
102278,5560-001-2511,3,3,0,13.98,,
102279,5540-040-2503,6,6,0,8.98,,
102280,010-13350-02,2,2,0,89.99,,
102284,GP1692,0,0,0,28.02,,
102286,115-12-20A,2,0,2,883.33,,
102287,115-12-35CD,4,2,2,1291.70,,
102288,115-12-8,4,2,2,404.99,,
102289,115-24-10,6,5,1,877.69,,
102290,115-24-18CD,4,2,2,1375.19,,
102291,115-24-35CD,3,1,2,2027.25,,
102292,1-2-120,1,0,1,139.89,,
102293,12-12-35I,0,0,0,1264.63,,
102294,12-12-3I,2,1,1,171.48,,
102295,12-12-6I,2,1,1,266.24,,
102296,2-3-120,1,1,0,360.94,,
102297,1-3-70,0,0,0,155.31,,
102298,1-3-165,0,0,0,260.60,,
102299,2-3-70,5,2,3,200.80,,
102303,32-12-15,4,2,2,418.53,,
102304,32-12-25,0,0,0,588.89,,
102305,32-12-35,4,2,2,788.56,,
102306,32-12-50,2,1,1,907.01,,
102307,ACCY-IBX,2,1,1,97.15,,
102308,ACCY-IX,2,1,1,179.35,,
102309,AC-II,0,0,0,107.16,,
102310,AC-IX,2,1,1,225.63,,
102311,BI-100,2,1,1,155.69,,
102312,BI-200,0,0,0,278.65,,
102313,GI-30-FS,10,4,6,282.04,,
102314,GI-60-FS,6,3,3,377.93,,
102315,NP-12,0,0,0,503.15,,
102316,NP-24,0,0,0,544.88,,
102317,NGX-1-ISO,0,0,0,208.22,,
102318,NGX-1-USB,5,3,2,222.41,,
102320,NS-12-20,5,3,2,222.88,,
102321,PA30/20,7,4,3,46.25,,
102322,PA40/30,6,2,4,66.55,,
102323,PA60/40,4,3,1,209.83,,
102324,POWER-PAC14AH,2,1,1,727.64,,
102325,POWER-PAC7AH,6,3,3,610.31,,
102326,PT-7,1,1,0,242.55,,
102327,PT-14W,4,2,2,480.59,,
102328,PT-24-13W,0,0,0,588.89,,
102329,PT-24-20U,5,2,3,947.63,,
102330,PT-24-45U,9,2,7,1522.98,,
102332,PT-24-8W,0,0,0,500.89,,
102333,PT-24-95U,3,3,0,2352.14,,
102334,PT-25W,0,0,0,588.89,,
102335,PT-40U,0,0,0,951.01,,
102336,PT-80,4,3,1,1546.60,,
102339,PTM-24-22,0,0,0,1032.24,,
102341,BX-1,4,4,0,39.26,,
102342,BX-2,2,2,0,46.25,,
102343,BX-3,2,2,0,66.03,,
102344,GS-2-100,0,0,0,352.01,,
102345,GS-2-25,2,1,1,89.04,,
102346,GS-2-50,2,1,1,177.29,,
102347,PC-10,5,2,3,64.30,,
102348,PC-25,16,8,8,97.03,,
102350,S51100,26,16,10,64.29,,
102351,S51110,0,0,0,121.43,,
102352,S51102,15,14,1,64.29,,
102353,S51112,0,0,0,121.43,,
102354,S51104,32,16,16,64.29,,
102355,S51114,0,0,0,121.43,,
102356,S51106,30,14,16,64.29,,
102357,S51116,0,0,0,121.43,,
102358,S51108,31,17,14,64.29,,
102359,S51118,0,0,0,121.43,,
102360,S51200,30,15,15,21.43,,
102361,S51202,30,15,15,21.43,,
102362,S51204,28,15,13,21.43,,
102363,S51206,30,15,15,21.43,,
102364,S51208,30,15,15,21.43,,
102365,S51390,20,10,10,22.86,,
102366,958126201,2,0,2,15.19,,
102373,SCM-LC-N2K-PLUS-V2,3,2,1,665.41,,749.00
102380,44010,12,12,0,89.99,,
102381,100-5194,7,7,0,255.73,,
102383,100-5187,8,8,0,250.00,399.99,
102386,100-4807,6,6,0,480.00,599.99,
102388,DS-HD10,0,0,0,25.29,,
102389,DS-HD6,0,0,0,19.10,,
102390,DS-H-MULTI-BLK,6,6,0,32.04,,
102397,ST30-60-5,0,0,0,18.79,,
102398,S00-02027-00,0,0,0,3.75,,
102399,010-12864-08,0,0,0,199.99,,
102402,SC-CW-10FT,0,0,0,88.31,,
102403,SC-CW-12F,0,0,0,100.69,,
102409,SC-USB-F4,0,0,0,32.04,,
102412,APS-70,0,0,0,109.43,,
102413,APS-160,0,0,0,298.95,,
102414,PX-1,2,0,2,28.20,,
102415,PX-2,4,2,2,33.85,,
102416,PX-3,1,1,0,47.39,,
102417,CCX-R,0,0,0,48.50,,
102418,CCX-S,0,0,0,40.61,,
102419,CCX-T,3,2,1,40.61,,
102420,BB-2,2,1,1,40.61,,
102421,BB-2/8,1,1,0,67.69,,
102422,BB-5,2,1,1,75.60,,
102423,BB-8,3,1,2,75.60,,
102424,BPP900451100,23,15,8,270.09,,333.20
102425,"SS SWITCH15",4,3,1,313.63,,
102426,"SS SWITCH3",3,0,3,106.05,,
102427,"SS SWITCH7.5",2,1,1,153.43,,
102428,"SS SWITCH7.5INV",2,1,1,199.68,,
102429,SCREEN-25,0,0,0,497.50,,
102431,CG0225NVC-F,0,0,0,818.75,,
102440,CG0175NVC-F,0,0,0,687.50,,
102446,010-02868-00,0,0,0,599.99,,
102447,010-02868-01,7,3,4,599.99,,
102448,010-02868-02,6,2,4,599.99,,
102450,010-13350-00,0,0,0,29.98,,
102451,AQL4046HB,9,6,3,27.22,,
102452,010-02277-10,1,1,0,599.99,,
102453,010-12832-23,0,0,0,59.99,,
102454,020-00301-00,0,0,0,59.99,,
102455,010-12832-26,0,0,0,29.98,,
102456,010-12832-41,0,0,0,29.98,,
102457,010-12832-42,0,0,0,29.98,,
102458,010-12832-40,0,0,0,52.49,,
102459,010-12832-19,1,0,1,18.74,,
102460,ERC-12-15,3,2,1,122.96,,
102461,ERC-12-35,1,0,1,181.63,,
102462,0834008PLB,0,0,0,390.79,,
102463,ES-1,1,1,0,1113.46,,
102464,ES-7D,2,1,1,586.63,,
102488,BMBS700,87,39,48,409.00,,499.00
102489,BSEC6M,11,5,6,30.00,,40.00
102490,FWBH-WH-S/M,2,2,0,55.13,,
102491,FWBH-WH-L/XL,4,4,0,55.13,,
102495,TDT04F-2RP,10,0,10,2.16,,
102496,TDT04F-3RP,8,0,8,2.56,,
102497,TDT04F-4RP,5,0,5,3.06,,
102498,TDT04F-6RP,6,0,6,3.62,,
102499,TDT04F-8RP,4,0,4,4.70,,
102500,TDT04F-12RP,7,0,7,3.76,,
102501,TDT06F-2RS,10,0,10,2.46,,
102502,TDT06F-3RS,8,0,8,3.88,,
102503,TDT06F-4RS,4,0,4,4.00,,
102504,TDT06F-6RS,6,0,6,6.20,,
102505,TDT06F-8RS,4,0,4,6.60,,
102506,TDT06F-12RS,7,0,7,7.39,,
102510,ZDIGISSPK2,2,1,1,1121.25,,
102511,T14DT-P-25,6,0,6,6.99,,
102512,T14DT-S-25,3,0,3,9.74,,
102513,RS-1005-HV-M,5,5,0,662.50,,
102517,PTS-0-3PSI-02,2,1,1,327.60,,
102518,SEA2322,1,0,1,128.05,,
102519,SEA2323,6,0,6,140.24,,
102520,SEA2324,2,0,2,142.68,,
102521,SEA2325,10,0,10,146.34,,
102522,101849,3,2,1,150.14,,
102524,101839,3,2,1,150.14,,
102526,010-12832-21,0,0,0,52.49,,
102535,CB101D600CW,0,0,0,179.35,,
102536,BT70L300-00,0,0,0,423.26,,
102537,BT70L300-12,0,0,0,423.26,,
102538,BT70L300-18,0,0,0,423.26,,
102539,BT70MB300-00,0,0,0,279.78,,
102540,BT70MB300-12,0,0,0,279.78,,
102541,BT70MB300-18,0,0,0,279.78,,
102542,BT70MA600-00,0,0,0,442.83,,
102543,BT70MA600-12,2,1,1,442.83,,
102544,BT70MA600-18,2,1,1,442.83,,
102545,BT70H600-00,0,0,0,442.83,,
102546,BT70H600-12,2,1,1,442.83,,
102547,BT70H600-18,2,1,1,442.83,,
102548,BT70D600CW-00,0,0,0,192.39,,
102549,BT70D600CW-12,0,0,0,192.39,,
102550,BT70D600CW-18,0,0,0,192.39,,
102551,BT87M1KW-00,0,0,0,762.39,,
102552,BT87M1KW-12,0,0,0,762.39,,
102553,BT87M1KW-18,0,0,0,762.39,,
102554,BT87H1KW-00,0,0,0,645.00,,
102555,BT87H1KW-12,0,0,0,645.00,,
102556,BT87H1KW-18,0,0,0,645.00,,
102557,CBCCMS0501,4,2,2,37.50,,
102558,CBCCMS0503,4,2,2,37.50,,
102559,CBCCMS0502,4,2,2,37.50,,
102560,6313,3,2,1,336.65,,
102561,38045-3092RSP,0,0,0,685.15,,
102562,38045-3094RSP,0,0,0,685.15,,
102563,38245-3092RSP,0,0,0,685.15,,
102564,38245-3094RSP,0,0,0,685.15,,
102565,53676C,0,0,0,79.40,179.99,
102566,53677C,0,0,0,79.40,179.99,
102567,53678C,0,0,0,79.40,179.99,
102568,53686C,0,0,0,113.15,209.99,
102569,53687C,0,0,0,113.15,209.99,
102570,53688C,0,0,0,113.15,209.99,
102571,53686S,0,0,0,136.18,229.99,
102572,53687S,0,0,0,136.18,229.99,
102575,536700,0,0,0,47.68,99.99,
102576,536710,0,0,0,47.68,99.99,
102577,536720,0,0,0,47.68,99.99,
102578,536700C,0,0,0,54.06,107.99,
102579,536710C,0,0,0,54.06,107.99,
102580,536720C,0,0,0,54.06,107.99,
102581,536800C,0,0,0,90.74,164.99,
102582,536820C,0,0,0,90.74,164.99,
102583,0006-7360,7,0,7,6.85,,10.99
102584,1506-7024,0,0,0,31.38,,
102589,333-93500,0,0,0,83.57,,
102590,013201,3,0,3,412.18,,
102591,013202,2,0,2,46.12,,
102592,013203,2,0,2,65.88,,
102593,013204,2,0,2,293.59,,
102594,013205,0,0,0,217.00,,
102595,011045,0,0,0,36.24,,
102596,011046,0,0,0,47.62,,
102597,011047,0,0,0,72.47,,
102598,011048,0,0,0,93.18,,
102599,011049,0,0,0,113.88,,
102602,SCM-CLX-RGBW-SS,4,2,2,29.95,,39.95
102605,SC2-CC-BZSM,2,0,2,173.75,,264.00
102606,SC2-BB-BZSM,0,0,0,148.75,,229.00
102607,SC2-GW-BZSM,0,0,0,148.75,,229.00
102608,SC2-CC-CSM,0,0,0,165.00,,249.00
102609,SC2-BB-CSM,0,0,0,140.00,,216.00
102610,SC2-GW-CSM,0,0,0,140.00,,216.00
102613,FBV-2500,0,0,0,297.78,,
102614,ZDIGNMD2,1,0,1,712.46,,
102621,11828-1,1,1,0,13.88,,
102626,10-13626-01,6,2,4,23.70,,
102627,10-13626-05,4,0,4,31.20,,
102628,10-13635-01,0,0,0,61.20,,
102629,10-13636-01,0,0,0,67.45,,
102630,10-13637-01,0,0,0,63.13,,
102631,10-13637-02,0,0,0,69.38,,
102632,10-13626-03,0,0,0,66.14,,
102633,10-13626-07,0,0,0,75.00,,
102634,10-13642-01,0,0,0,36.25,,
102635,10-13643-01,0,0,0,39.38,,
102636,10-13649-01,0,0,0,36.25,,
102637,10-13650-01,0,0,0,38.75,,
102638,09-36336-01,4,2,2,19.38,,
102639,09-36336-06,3,2,1,26.25,,
102640,09-36336-04,0,0,0,50.00,,
102641,09-36336-10,0,0,0,58.75,,
102642,SVS-760CF+,0,0,0,839.30,,
102643,SVS-880CF+,0,0,0,979.30,,
102644,SVS-760C+,0,0,0,699.30,,
102645,SVS-880C+,0,0,0,839.30,,
102646,SVS-880CE+,2,1,1,909.30,,
102647,SVS-880CFE+,0,0,0,1049.30,,
102653,010-C1466-30,0,0,0,74.99,,
102654,010-C1467-30,0,0,0,74.99,,
102655,010-C1466-40,0,0,0,112.49,,
102656,010-C1467-40,0,0,0,112.49,,
102659,81205105,4,2,2,399.70,,
102660,81205205,4,2,2,399.70,,
102661,81205305,3,2,1,399.70,,
102662,81205405,4,2,2,399.70,,
102663,S-845,16,8,8,9.71,,
102666,010-C1451-20,14,0,14,74.99,,
102667,010-C1451-00,0,0,0,112.49,,
102668,010-C1452-20,14,0,14,74.99,,
102669,010-C1452-00,0,0,0,112.49,,
102670,010-C1453-20,14,0,14,74.99,,
102671,010-C1453-00,0,0,0,112.49,,
102672,010-C1454-20,0,0,0,74.99,,
102673,010-C1454-00,0,0,0,112.49,,
102675,7385BN#8/0B,0,0,0,16.18,,
102676,7385BN#9/0B,0,0,0,19.22,,
102677,19-1240-02,4,2,2,247.06,,
102682,010-C1484-20,14,0,14,74.99,,
102683,010-C1484-00,0,0,0,112.49,,
102684,010-C1485-20,14,0,14,74.99,,
102685,010-C1485-00,0,0,0,112.49,,
102717,491034-1,0,0,0,37.47,,
102718,491036-1,10,10,0,53.74,,
102721,445097-1,0,0,0,5.41,,
102722,445197-1,5,5,0,6.03,,
102724,563311-1,2,2,0,4.21,,
102725,431050-3,2,2,0,68.79,,
102730,33-541-01,0,0,0,223.22,,
102731,904113,0,0,0,137.50,219.99,
102739,200-014G2-PRO-I,0,0,0,708.36,,
102740,201-013-PRO,0,0,0,459.93,,
102741,200-014G2-PRO,0,0,0,459.93,,
102744,TFRL24-6MM-25,0,0,0,2.80,,
102745,TFRL22-6MM-25,0,0,0,2.80,,
102746,TFRL20-6MM-25,0,0,0,2.80,,
102747,TFRL18-6MM-25,0,0,0,2.80,,
102748,TFRL16-8MM-25,8,5,3,2.36,,
102749,TFRL14-8MM-25,5,5,0,2.58,,
102750,TFRL12-10MM-25,0,0,0,3.11,,
102751,TFRL10-12MM-25,15,2,13,3.86,,
102752,TFRL8-12MM-10,0,0,0,5.00,,
102753,TFRL6-12MM-10,0,0,0,5.33,,
102754,TFRL4-16MM-10,3,3,0,4.67,,
102756,TFRL2-16MM-10,0,0,0,6.80,,
102779,WUL16BR-9-1000,0,0,0,97.00,,
102781,22484,2,2,0,4.80,,
102786,151800-200-040-23,0,0,0,163.65,,
102787,151800-200-050-23,0,0,0,163.65,,
102788,151800-200-060-23,0,0,0,163.65,,
102789,151800-200-070-23,0,0,0,163.65,,
102790,151400-200-030-23,0,0,0,62.63,,
102791,151600-700-060-23,0,0,0,65.64,,
102792,151000-200-040-24,0,0,0,75.35,,
102793,151000-200-050-24,0,0,0,75.35,,
102794,151000-200-060-24,0,0,0,75.35,,
102795,151000-200-020-24,0,0,0,75.35,,
102798,T70590,0,0,0,4208.31,,
102799,22733,11,11,0,15.36,,
102800,22743,12,12,0,7.86,,
102801,22753,11,11,0,20.29,,
102802,E150-12-5,1,0,1,16.06,,
102803,E200-12-5,1,0,1,16.46,,
102806,H25-0023R,1,0,1,432.38,,
102810,SDTG2400302,2,0,2,886.07,,
102824,KSJCOAX,0,0,0,10.96,15.30,
102825,KSJUSBC,0,0,0,10.96,15.30,
102826,KSJUSB,0,0,0,10.96,15.30,
102827,KSJHDMI,0,0,0,10.96,15.30,
102828,KSJETH,0,0,0,10.96,15.30,
102834,43410700945,0,0,0,873.71,,
102835,43410701545,0,0,0,1206.33,,
102836,43410702545,0,0,0,1765.59,,
102837,43410704545,0,0,0,3107.14,,
102838,43410707045,0,0,0,5355.23,,
102839,43230000940,0,0,0,383.78,,
102840,43230001540,0,0,0,415.99,,
102841,43230002540,0,0,0,502.40,,
102842,43230004540,0,0,0,675.98,,
102843,43230007040,0,0,0,1555.66,,
102844,43354320153,0,0,0,68.23,,
102845,43354320253,0,0,0,85.03,,
102846,43354320453,0,0,0,130.26,,
102847,43354320543,0,0,0,201.59,,
102848,25200010051,0,0,0,36.56,,
102849,25200010112,0,0,0,33.46,,
102851,25200010055,0,0,0,61.61,,
102867,PMP121500100,20,10,10,301.09,,371.45
102876,41030,0,0,0,370.13,520.51,
102880,SG1982B,1,0,1,78.06,,
102882,19-1240-01,4,2,2,61.76,,
102883,72-1056-01,2,1,1,1296.18,,
102888,010-11203-10,0,0,0,202.49,,
102889,JBLMA754AM,1,0,1,224.34,319.95,
102899,FVSGEL185L05A00,0,0,0,39.60,,
102900,FVSGANBTQ18AA00,0,0,0,63.36,,
102904,523101,0,0,0,14.13,,
102909,B00171101,0,0,0,235.45,286.19,
102913,81203205,0,0,0,496.43,,
102914,44636,5,5,0,4.09,,
102915,53246,0,0,0,16.96,,
102916,22999,0,0,0,12.75,,
102917,40325,11,11,0,4.97,,
102918,53097,5,5,0,10.59,,
102919,48473,2,2,0,35.36,,
102920,44105,5,5,0,5.96,,
102928,784-9115S-01,0,0,0,367.06,,
102940,SEA-HDM,0,0,0,939.76,,1099.00
102941,010-12989-03,0,0,0,22.49,,
102943,010-01628-02,2,2,0,153.99,,
102952,ASS030140030,9,5,4,48.23,,59.50
102959,7461321FGK-CFN,10,5,5,871.53,,
102960,7461321FG-CFN,0,0,0,817.06,,
102971,0200MABW01,0,0,0,182.63,,
102975,170002,3,1,2,26.55,,
102976,170010,4,2,2,101.37,,
102977,170025,0,0,0,232.34,,
102987,SCM-EAGLE-RAY-WH,0,0,0,1198.99,,1799.00
102988,SCM-EAGLE-RAY-BK,0,0,0,1198.99,,1799.00
102995,MCU006,0,0,0,404.49,,
102996,010-13350-01,0,0,0,52.49,,
102997,200-012G2-PRO,0,0,0,459.93,,
103000,9057-3114-4,0,0,0,38.73,,
103024,47806,0,0,0,29.34,,
103025,43633,66,0,66,19.83,,
103026,39390,0,0,0,32.66,,
103032,B75C-12-HW-MM,0,0,0,750.28,,
103033,B75C-20-HW-MM,1,0,1,750.28,,
103035,53673A,89,49,40,17.76,,
103036,53683A,20,2,18,20.51,,
103037,53670CA,27,8,19,53.94,,
103038,53672CA,12,4,8,54.06,,
103040,RLS-508-405,6,6,0,84.47,,
103053,784-9115-01,0,0,0,367.06,,
103055,XC2M12,2,1,1,774.44,,
103056,RTME12D,2,1,1,312.50,,
103057,2210024,4,2,2,262.50,,
103058,STC548W,4,2,2,221.88,,
103059,872021,3,2,1,156.25,,
103060,221012,4,2,2,137.50,,
103061,R109C-LHW,0,0,0,2941.76,,
103062,FVSGEL140R05A00,0,0,0,38.48,,
103065,HM15H300PXS,0,0,0,915.32,,
103066,HM15H300P12X,0,0,0,631.59,,
103069,9057-3113-4,0,0,0,36.85,,
103070,69000338,2,2,0,344.52,,
103071,HM15H150PX,2,2,0,343.62,,
103072,HM15H300PX,0,0,0,846.98,,
103073,HM20H300PX,0,0,0,592.15,,
103074,9057-2123-4,0,0,0,36.85,,
103075,HM15H200PX,0,0,0,605.89,,
103076,9057-2113-4,0,0,0,36.85,,
103077,9057-1113-4,0,0,0,36.85,,
103090,WUL10WH-20,0,0,0,10.24,,
103091,WUL10GY-20,0,0,0,10.24,,
103092,WUL10VI-20,0,0,0,10.24,,
103093,WUL10BL-20,0,0,0,10.24,,
103094,WUL10GN-20,0,0,0,10.24,,
103095,WUL10YL-20,0,0,0,10.24,,
103096,WUL10OR-20,0,0,0,10.24,,
103097,WUL10RD-20,0,0,0,10.24,,
103098,WUL10BR-20,0,0,0,10.24,,
103099,WUL10BK-20,2,2,0,10.24,,
103102,90752,0,0,0,1660.71,,
103103,010-12982-10,0,0,0,63.99,,
103104,7210,3,2,1,183.24,,
103105,30-442-P-WT,0,0,0,41.38,,
103106,30-442-P-BL,0,0,0,41.38,,
103109,RH-4646,0,0,0,14.64,,
103110,5009W4,0,0,0,15.24,,
103113,12772-2,0,0,0,7.97,,
103114,12773-2,0,0,0,12.41,,
103115,12774-2,0,0,0,20.50,,
103118,"580-0200-7 B1",0,0,0,119.87,,
103120,5060-3,0,0,0,7.50,,
103121,5061-3,0,0,0,12.14,,
103122,5062-3,0,0,0,12.14,,
103123,5063-3,0,0,0,12.86,,
103124,5071-3,0,0,0,4.17,,
103125,5072-7,0,0,0,4.17,,
103126,5074-3,0,0,0,5.12,,
103130,8315-4,0,0,0,31.20,,
103131,200-014G2+012G2,0,0,0,950.55,,
103132,PIN122510510,0,0,0,76.48,,94.35
103133,PIN122510500,0,0,0,78.55,,96.90
103134,PIN123750510,0,0,0,93.01,,114.75
103135,PIN121800510,0,0,0,199.12,,245.65
103141,SXV300M1-6,2,0,2,362.58,,
103142,010-02251-10,7,1,6,97.49,,
103143,710306-1,0,0,0,166.67,,
103144,SS6X9GRY,4,0,4,681.94,,825.00
103145,SS6X9BLU,0,0,0,681.94,,825.00
103146,SS6X9BLK,2,0,2,681.94,,825.00
103147,SS6X9SFM,5,0,5,681.94,,825.00
103148,SS6X9CAM,0,0,0,681.94,,825.00
103149,SS6X9WHT,5,0,5,681.94,,825.00
103150,SS8X12GRY,0,0,0,1033.33,,1250.00
103151,SS8X12BLU,0,0,0,1033.33,,1250.00
103152,SS8X12BLK,0,0,0,1033.33,,1250.00
103153,SS8X12SFM,0,0,0,1033.33,,1250.00
103154,SS8X12CAM,0,0,0,1033.33,,1250.00
103155,SS8X12WHT,0,0,0,1033.33,,1250.00
103158,400-405,0,0,0,98.48,,
103174,FVSGANBTQ14AA00,0,0,0,35.57,,
103176,FVSGANBTQ25AA00,0,0,0,63.36,,
103177,FASP3432X02CA00,0,0,0,47.91,,
103178,FNTCD2042000C00,0,0,0,281.68,,
103180,FPHRC1004000C00,3,0,3,163.35,,
103181,FPHRC1004L00D00,1,0,1,217.80,,
103182,FASP2492X12CD00,0,0,0,103.08,,
103207,101873,2,2,0,174.38,,
103224,42520,0,0,0,360.00,,
103225,2184,0,0,0,38.57,58.73,
103226,44015,0,0,0,124.99,,
